Affrica	アフリカ
Iapan	日本
Sūðamerica	南アメリカ
Norþweg	ノルウェー
Englaland	イングランド
Scotland	スコットランド
Wēalas	ウェールズ
Norðerne Īrland	北アイルランド
Īrland Cynewīse	アイルランド
Ungerland	ハンガリー
Spēonland	スペイン
Geānedu Rīcu American	アメリカ合衆国
Belgice	ベルギー
Letseburg	ルクセンブルク
Eorðe	地球
Līf	生命
George Washington	ジョージ・ワシントン
Finnland	フィンランド
Swēoland	スウェーデン
Denemearc	デンマーク
Polaland	ポーランド
Liþþuania	リトアニア
Italia	イタリア
Swissland	スイス
Ēastrīce	オーストリア
Grēcland	ギリシャ
Turcland	トルコ
Bēor	ビール
Portugal	ポルトガル
Europe	ヨーロッパ
Asia	アジア
Norðamerica	北アメリカ
Antarctica	南極大陸
Wikipǣdia	ウィキペディア
Niðerland	オランダ
Nīweoforwīcburg	ニューヨーク
Hwæsingatūn, D.C.	ワシントンD.C.
Berlin	ベルリン
Los Angeles	ロサンゼルス
Spearctelle	コンピュータ
Genf	ジュネーヴ
Betweoxnett	インターネット
Barack Obama	バラク・オバマ
Uruguay	ウルグアイ
Lunden	ロンドン
Æppel	リンゴ
Paris	パリ
Abraham Lincoln	エイブラハム・リンカーン
Android	Android
Google	Google
Mexico	メキシコ
Atlantisc Gārsecg	大西洋
Sericus Gārsecg	太平洋
California	カリフォルニア州
Mōnandæg	月曜日
Æfterra Gēola	1月
Solmōnaþ	2月
Hrēþmōnaþ	3月
Tīw (tungol)	火星
Cenia	ケニア
Sigelhearwenaland	エチオピア
Ēastermōnaþ	4月
Þrimilcemōnaþ	5月
Sēremōnaþ	6月
Mǣdmōnaþ	7月
Wēodmōnaþ	8月
Hāligmōnaþ	9月
Winterfylleþ	10月
Blōtmōnaþ	11月
Gēolmōnaþ	12月
Tīwesdæg	火曜日
Wēdnesdæg	水曜日
Þunresdæg	木曜日
Frīgedæg	金曜日
Sæternesdæg	土曜日
Sunnandæg	日曜日
Lēo	ライオン
Francland	フランス
Esperanto	エスペラント
Geāned Cynerīce	イギリス
Catte	ネコ
Cīnan Folclicu Cynewīse	中華人民共和国
Frencisc sprǣc	フランス語
Fisc	魚類
Brasil	ブラジル
Russland	ロシア
Eoferwicscīr	ヨークシャー
Sǣ	海
Euxinus	黒海
Toronto	トロント
Alabama	アラバマ州
São Paulo	サンパウロ
São Paulo (rīce)	サンパウロ州
Quebec	ケベック州
Piza	ピザ
Þēodscland	ドイツ
Hwītrussland	ベラルーシ
Þēodsc sprǣc	ドイツ語
Īsland	アイスランド
God	神
Estland	エストニア
Sætern (tungol)	土星
Ceocōlāte	チョコレート
2 (getæl)	2
Þrīe	3
Fēower	4
Fīf	5
George W. Bush	ジョージ・W・ブッシュ
Lettland	ラトビア
Ucrægna	ウクライナ
Cecland	チェコ
Slofacia	スロバキア
Slofenia	スロベニア
Vilnius	ヴィリニュス
Moldofa	モルドバ
Rumǣnia	ルーマニア
Pulgaraland	ブルガリア
Rōm	ローマ
Macedonia Cynewīse	マケドニア共和国
Albania	アルバニア
Grēneland	グリーンランド
Croatia	クロアチア
Bosnia and Herzegofina	ボスニア・ヘルツェゴビナ
Godhopa	ヌーク
Azerbaijan	アゼルバイジャン
Andorra	アンドラ
Cipros	キプロス
Georgia (land)	グルジア
Casahstan	カザフスタン
Melita	マルタ
Flandras	フランドル
Monaco	モナコ
Sweartbeorg	モンテネグロ
Faticanburg	バチカン
San Marino	サンマリノ
Brysel	ブリュッセル市
Cūba	キューバ
Barbados	バルバドス
Cǣgbord (spearctellend)	キーボード (コンピュータ)
Indonesia	インドネシア
Wolfgang Amadeus Mozart	ヴォルフガング・アマデウス・モーツァルト
Ludwig van Beethoven	ルートヴィヒ・ヴァン・ベートーヴェン
Sūðaffrica	南アフリカ共和国
Algeria	アルジェリア
Usbecastan	ウズベキスタン
Warsaw	ワルシャワ
Wīn (drinc)	ワイン
Wæter	水
Holt	木材
Feorrsīen	テレビ
Īslendisc sprǣc	アイスランド語
Cile	チリ
Iesus	イエス・キリスト
Elvis Presley	エルヴィス・プレスリー
Wōden (tungol)	水星
Stǣr	歴史
Apple Inc.	アップル インコーポレイテッド
Frig (tungol)	金星
Sprǣc	言語
Lufu	愛
Þunor (tungol)	木星
Uranus	天王星
Neptune (planēta)	海王星
Tungolcræft	天文学
Witancræft	科学
Pluto	冥王星
Montreal	モントリオール
Lēohtenstān	リヒテンシュタイン
Plega	スポーツ
Grantanbrycg	ケンブリッジ
Adolf Hitler	アドルフ・ヒトラー
Fyrst Woruldgūþ	第一次世界大戦
Ōðru Woruldgūþ	第二次世界大戦
Wikibēc	ウィキブックス
Augusto Pinochet	アウグスト・ピノチェト
Geanca Cupala	ヤンカ・クパーラ
Ubuntu	Ubuntu
Stettin	シュチェチン
Rīmcræft	数学
U2	U2
Lǣden	ラテン語
Bahrain	バーレーン
Armenia	アルメニア
Serbia	セルビア
Mōna	月
Constantinopolis	イスタンブル
Australia	オーストラリア
Bob Marley	ボブ・マーリー
Argentina	アルゼンチン
Peru	ペルー
Norþcorēa	朝鮮民主主義人民共和国
Cambodia	カンボジア
Kuiperes gyrtel	エッジワース・カイパーベルト
Curān	クルアーン
Alladōm	イスラム教
Lech Wałęsa	レフ・ヴァウェンサ
Europisce Gesamnung	欧州連合
Woruldwīd Webb	World Wide Web
Wīf	女性
Wætertyge	水道橋
Don Quijote	ドン・キホーテ
Megelan	ミラノ
Burg	都市
Napoleon I Francena Cāsere	ナポレオン・ボナパルト
Uesuuius	ヴェスヴィオ
Sunne	太陽
Lēohtgēar	光年
Sunnlicu Endebyrdnes	太陽系
Ostsǣ	バルト海
Wisle	ヴィスワ川
Tōþ	歯
Wætertimber	水素
Wikimedia Commons	ウィキメディア・コモンズ
Dæg	日
Ēasttimor	東ティモール
Niht	夜
Gēar	年
Hundgēar	世紀
Rīn	ライン川
Oslo	オスロ
Katowice	カトヴィツェ
1 Ceres	ケレス (準惑星)
Ii	アイオナ島
Dubai	ドバイ
Folga	ヴォルガ川
Æðmlyft	酸素
Dweligende tungol	惑星
Venetia	ヴェネツィア
Naruto	NARUTO -ナルト-
Moscow	モスクワ
Italisc sprǣc	イタリア語
Cead	チャド
Nīwe Sǣland	ニュージーランド
Indea	インド
Īsen	鉄
Willelm Scacaspere	ウィリアム・シェイクスピア
Lēad	鉛
Mongolland	モンゴル国
Ficgīege	フィジー
Feneswela	ベネズエラ
Blēobord	チェス
Maine	メイン州
Hors	ウマ
Amsterdam	アムステルダム
Wǣpen	武器
Dēor	動物
Paraguay	パラグアイ
Ecuador	エクアドル
Colombia	コロンビア
Strēawberge	オランダイチゴ属
Buddendōm	仏教
Bolifia	ボリビア
Coper	銅
Plante	植物
Nīwu Hāmtūnscīr	ニューハンプシャー州
Iamaica	ジャマイカ
Massachusetts	マサチューセッツ州
Connecticut	コネチカット州
Henn	ニワトリ
Hawaii	ハワイ州
Cēsarēa	ジャージー
Swīn	ブタ
Īshæf	北極海
Persealand	イラン
Irac	イラク
Alaska	アラスカ州
Israhēl	イスラエル
Utrecht	ユトレヒト
Gemen	イエメン
Clēofanwyrm	ウイルス
Polisc sprǣc	ポーランド語
Hascemisc Cynerīce þæs Iordanes	ヨルダン
Florida	フロリダ州
Arizona	アリゾナ州
Cuwait	クウェート
Libanus	レバノン
Oregon	オレゴン州
Utah	ユタ州
Hriðer	ウシ
Malægsia	マレーシア
Burma	ミャンマー
Oman	オマーン
Pacistan	パキスタン
Qatar	カタール
Tennis	テニス
Saudisc Arabea	サウジアラビア
Tāprabane	スリランカ
Iosep Stalin	ヨシフ・スターリン
Syria	シリア
Plato	プラトン
Tacgicastan	タジキスタン
Aristoteles	アリストテレス
Thailand	タイ王国
Ūtƿeorp	ラジオ
Turcmenistan	トルクメニスタン
Geānedu Arabisc Bregorīcu	アラブ首長国連邦
Fietnam	ベトナム
Sūþcorēa	大韓民国
Afghanistan	アフガニスタン
J. R. R. Tolkien	J・R・R・トールキン
Gold	金
Bængladesc	バングラデシュ
Bleach (manga)	BLEACH
Socrates	ソクラテス
Angola	アンゴラ
Tansania	タンザニア
Philippines	フィリピン
Middel Affricanisc Cynewīse	中央アフリカ共和国
Sūþende þǣre eaxe	南極点
Norþende þære eaxe	北極点
Isaac Newton	アイザック・ニュートン
Albert Einstein	アルベルト・アインシュタイン
Geolu	黄色
Tunisia	チュニジア
Simbabwe	ジンバブエ
Beicing	北京市
Sūþsudan	南スーダン
Botswana	ボツワナ
Burkina Faso	ブルキナファソ
Folcrīcelicu Cynewīse þæs Congwes	コンゴ民主共和国
Bægwaraland	バイエルン州
Baden-Wyrttemberg	バーデン＝ヴュルテンベルク州
Æriþrea	エリトリア
Nīwe Delhi	ニューデリー
Iohannes Paulus II Pāpa	ヨハネ・パウロ2世 (ローマ教皇)
Gabon	ガボン
Mohandas Karamchand Gandhi	マハトマ・ガンディー
Gambia	ガンビア
Guinea	ギニア
Elpendbānrima	コートジボワール
Camerun	カメルーン
Grēnenæs Īega	カーボベルデ
Lesotho	レソト
Liberia	リベリア
Libia	リビア
Madagascar	マダガスカル
Mauritania	モーリタニア
Morocco	モロッコ
Mosambice	モザンビーク
Namibia	ナミビア
Nigeria	ナイジェリア
Charles Darwin	チャールズ・ダーウィン
Uganda	ウガンダ
Rwanda	ルワンダ
Sōmalia	ソマリア
Gaius Iulius Caesar	ガイウス・ユリウス・カエサル
Sudan	スーダン
Swasiland	スワジランド
Hamburg	ハンブルク
Heorte	心臓
Brægen	脳
Prag	プラハ
Bleoh	青
Seolfor	銀
Tin	スズ
Reddit	Reddit
Elsass	アルザス地域圏
Bihar	ビハール州
Michigan	ミシガン州
Puerto Rico	プエルトリコ
Niðerseaxland	ニーダーザクセン州
Hetwaraland	ヘッセン州
Illinois	イリノイ州
Norþdakota	ノースダコタ州
Brandenburg	ブランデンブルク州
Langbeardnaland	ロンバルディア州
Sūþdakota	サウスダコタ州
Montǣna	モンタナ州
Wyoming	ワイオミング州
Ierusalem	エルサレム
Idaho	アイダホ州
Hwæsingatūn	ワシントン州
Nevada	ネバダ州
Danais	ドン川
Indisc Gārsecg	インド洋
Caribisc Sǣ	カリブ海
Colorado	コロラド州
Tuscania	トスカーナ州
Alpis	アルプス山脈
Gænt	ヘント
Chicago	シカゴ
The Beatles	ビートルズ
Winter	冬
Ēawielm	春
Efenniht	分点
Spēonisc sprǣc	スペイン語
Caligardamana	コルカタ
West Bengal	西ベンガル州
Ātorcoppe	クモ
Virginia	バージニア州
Westvirginia	ウェストバージニア州
Nīwe Eoforwīc	ニューヨーク州
Rhode Īeg	ロードアイランド州
Ceorfdēor	昆虫
Marianland	メリーランド州
Delaware	デラウェア州
Fladimir Lenin	ウラジーミル・レーニン
Ohio	オハイオ州
Pennsylvānia	ペンシルベニア州
Uetersen	ユーテルゼン
Augustus	アウグストゥス
Microsoft Windows	Microsoft Windows
Nīwe Cēsarēa	ニュージャージー州
Calpis	ジブラルタル
Finnisc sprǣc	フィンランド語
Indiǣna	インディアナ州
Selffērende wægn	自動車
Roger Federer	ロジャー・フェデラー
Georgia (America)	ジョージア州
Marcus Aurelius	マルクス・アウレリウス・アントニヌス
Texas	テキサス州
Puilla	プッリャ州
Norþcarolīna	ノースカロライナ州
Sūþcarolīna	サウスカロライナ州
Sicilia	シチリア
Sardinia	サルデーニャ
Ligore	ロワール川
Sigen	セーヌ川
Buenos Aires	ブエノスアイレス
Mexicoburg	メキシコシティ
Pīnæppel	パイナップル
Mississippi	ミシシッピ州
Mississippi ēa	ミシシッピ川
Mizoram	ミゾラム州
Tennessee	テネシー州
Abu Dhabi	アブダビ
Nīwe Mexico	ニューメキシコ州
Athēnas	アテネ
Minnesota	ミネソタ州
Wisconsin	ウィスコンシン州
Iowa	アイオワ州
Nebraska	ネブラスカ州
Kansas	カンザス州
Hafana	ハバナ
Missouri	ミズーリ州
Louisiāna	ルイジアナ州
Nagaland	ナガランド州
Kentucky	ケンタッキー州
Arkansas	アーカンソー州
Ælf ēa	エルベ川
Oklahoma	オクラホマ州
Donua	ドナウ川
Hæfel	ハーフェル川
Norþsǣ	北海
Flēogeball	バレーボール
Uigenna	ウィーン
Cēapmannahæfen	コペンハーゲン
Stoccholm	ストックホルム
Helsinki	ヘルシンキ
Difelin	ダブリン
Rēcwīc	レイキャヴィーク
Riga	リガ
Menuþias	ザンジバル
Dantsic	グダニスク
Frankfurt	フランクフルト・アム・マイン
Death Note	DEATH NOTE
Biblioþēce	聖書
Ho Chi Minh Burg	ホーチミン市
Sōþ Iesus Cirice	真イエス教会
Nīwenglisc sprǣc	英語
Andorra la Vella	アンドラ・ラ・ベリャ
Đồng Hới	ドンホイ
Concepcion	コンセプシオン (チリ)
Cænugeard	キエフ
Ontario	オンタリオ州
Ottawa	オタワ
Alberta	アルバータ州
Nīwe Scotland	ノバスコシア州
Końskowola	コィンスコヴォラ
Geocon Landscipe	ユーコン準州
Florentia	フィレンツェ
Ǣt	食品
Snaca	ヘビ
Halifax	ハリファックス
Quebecceaster	ケベック・シティー
3. Æfterran Gēolan	1月3日
4. Æfterran Gēolan	1月4日
Región del Biobío (Cile)	ビオビオ州
5. Æfterran Gēolan	1月5日
Arica	アリカ (チリ)
6. Æfterran Gēolan	1月6日
7. Æfterran Gēolan	1月7日
8. Æfterran Gēolan	1月8日
9. Æfterran Gēolan	1月9日
10. Æfterran Gēolan	1月10日
11. Æfterran Gēolan	1月11日
12. Æfterran Gēolan	1月12日
13. Æfterran Gēolan	1月13日
Beormingahām	バーミンガム
14. Æfterran Gēolan	1月14日
15. Æfterran Gēolan	1月15日
16. Æfterran Gēolan	1月16日
17. Æfterran Gēolan	1月17日
18. Æfterran Gēolan	1月18日
Rōmānisc Rīce	ローマ帝国
Microsoft	マイクロソフト
30. Æfterran Gēolan	1月30日
Kurów	クルフ
11. Solmōnðes	2月11日
11. Gēolmōnþes	12月11日
12. Gēolmōnðes	12月12日
17. Gēolmōnðes	12月17日
Wæþ	フォース川
Þrittiggēara Orlege	三十年戦争
Benedictus XVI Pāpa	ベネディクト16世 (ローマ教皇)
6. Ēastermōnðes	4月6日
4. Ēastermōnþes	4月4日
Helmut Kohl	ヘルムート・コール
17. Ēastermōnðes	4月17日
12. Þrimilcemōnþes	5月12日
13. Þrimilcemōnþes	5月13日
20. Þrimilcemōnðes	5月20日
31 Þrimilcemōnaþ	5月31日
6. Mǣdmōnðes	7月6日
1. Mǣdmōnðes	7月1日
18. Mǣdmōnðes	7月18日
Gyldfōtþōðer	サッカー
26. Gēolmōnðes	12月26日
Eallbærnet	ホロコースト
IPad	IPad
Madrid	マドリード
Elton John	エルトン・ジョン
Undersǣbāt	潜水艦
26. Wēodmōnðes	8月26日
24. Wēodmōnðes	8月24日
2. Hāligmōnþes	9月2日
Kassel	カッセル
Canadisc underrīcu	カナダの州
25. Hāligmōnðes	9月25日
Santiago (Cile)	サンティアゴ (チリ)
1. Winterfylleðes	10月1日
14. Winterfylleðes	10月14日
8. Winterfylleðes	10月8日
7. Winterfylleðes	10月7日
Oldenburg (Oldenburg)	オルデンブルク
26. Winterfylleðes	10月26日
4. Blōtmōnðes	11月4日
1. Blōtmōnðes	11月1日
Wolfsburg	ヴォルフスブルク
Carl Micela Francena Cyning	カール大帝
Canberra	キャンベラ
Sydney	シドニー
Grēne	緑
Rēad	赤
Perþ (Australia)	パース (西オーストラリア州)
Fȳr	火
Westerne Australia	西オーストラリア州
Nīwe Sūþwealas	ニューサウスウェールズ州
Norþerne Landscipe	ノーザンテリトリー
Australisc Hēafodbyrig Landscipe	オーストラリア首都特別地域
Fīfeldor	アイダー川
Nīl	ナイル川
Heortfordscīr	ハートフォードシャー
Comēta	彗星
Angol	アンゴル
Antofagasta	アントファガスタ
Ancyra	アンカラ
Flocc:Bysen	Category:ウィキペディアのテンプレート
Castro (Cile)	カストロ (チリ)
Frencisc Guiana	フランス領ギアナ
Chillán (Cile)	チヤン
Amāzanēa	アマゾン川
Tybingen	テュービンゲン
Coyhaique	コイハイケ
Flocc:Bysen Land	Category:国関連のテンプレート
Flocc:Bysen tīd	Category:暦と日付と時間のテンプレート
Willelmeshæfen	ヴィルヘルムスハーフェン
Copiapó (Cile)	コピアポ
Manama	マナーマ
Delmenhorst	デルメンホルスト
Brandenburg (burg)	ブランデンブルク・アン・デア・ハーフェル
Wikipǣdia:Sandbox	Wikipedia:サンドボックス
Wikipǣdia:Inlǣdung	Wikipedia:ウィキペディアへようこそ
Cantabria	カンタブリア州
Hūs	家屋
Rīmagiefung	代数学
Mennisc bodiglār	人体解剖学
Osasco	オザスコ (サンパウロ州)
Fujairah	フジャイラ
Glasgow	グラスゴー
Donghoi Lyfthæfene	ドンホイ空港
Rodor	宇宙空間
Sweartweald	シュヴァルツヴァルト
Curitiba	クリチバ
Weald	森林
Flocc:Cliferfētedēor	Category:偶蹄目
Talca	タルカ
Flothere	海軍
Bysen:Lang-lt	Template:Lang-lt
Cwidbōc	箴言
Rancagua	ランカグア
Confucius	孔子
Corbin Bleu	コービン・ブルー
Flocc:Rīmcræft	Category:数学
Faroisca Īega	フェロー諸島
Wendelsǣ	地中海
Flocc:Nīwes Sǣlandes īga	Category:ニュージーランドの島
Cōcnearuness	クック海峡
Crīstendōm	キリスト教
Windows 8	Microsoft Windows 8
Bysen:Asia	Template:アジア
Gandis	ガンジス川
Worulddǣl	大陸
Fugol	鳥類
Hēafodstōl	首都
Monzón	モンソン
Portuglisc sprǣc	ポルトガル語
Mōnaþ	月 (暦)
Bysen:Fōtball stycce	Template:Footy-stub
Almazán	アルマサン
Huang Siānfan	黄現ハン
Kescwisc sprǣccynn	ケチュア語
Bill Gates	ビル・ゲイツ
Iapanisc sprǣc	日本語
Wīsdōmbōc	百科事典
Hēafodtramet	メインページ
Golf	ゴルフ
Hrōcburhfōtþōðer	ラグビー
Olympisc Gamen	近代オリンピック
Eurasia	ユーラシア大陸
Andes	アンデス山脈
Durban	ダーバン
Caspia	カスピ海
Uictoriamere	ヴィクトリア湖
Babilōn	バビロン
Ēalendisca Īega	オーランド諸島
Cægman Īegland	ケイマン諸島
Novak Đoković	ノバク・ジョコビッチ
Fortunatus iegland	カナリア諸島
Hrōcburhgesamnunge plega	ラグビーユニオン
Ūðwitegung	哲学
Flocc:Candidates for speedy deletion	Category:即時削除対象のページ
Tē	茶
Hebe Camargo	ヘーペ・カマルゴ
Gemǣnre ǣhte rǣd	共産主義
Wealdlīste rǣd	アナキズム
Ǣhtwealdes endebyrdness	資本主義
Frēodōmes þōht	自由主義
Gilmrǣd	ファシズム
Cofentreo	コヴェントリー
Lodi	ローディ
Ōðre Penisc Gūþ	第二次ポエニ戦争
Cartaina	カルタゴ
Bryttisc Museum	大英博物館
Sund	水泳
1451	1451年
Ellaspontus	ダーダネルス海峡
Strǣtburg	ストラスブール
Gytārre	ギター
Croatisc sprǣc	クロアチア語
Cesena	チェゼーナ
Hāmburgere	ハンバーガー
Fédération Internationale de Volleyball	国際バレーボール連盟
20e gēarhundred	20世紀
Stefan Raab	シュテファン・ラープ
Catalan sprǣc	カタルーニャ語
11e gēarhundred	11世紀
Gelēaflēasnes	無神論
Cynn scī huang	始皇帝
Elisabeþ I Engla Cwēn	エリザベス1世
Cynewīse	共和制
Þēodlices gemǣnscipes rǣd	ナチズム
Nazi Þēodscland	ナチス・ドイツ
Christopher Columbus	クリストファー・コロンブス
Iacobus Cōc	ジェームズ・クック
Ēare	耳
Nasu	鼻
Ēage	目
Scēap	ヒツジ
Mereswīn	イルカ
Sǣhund	サメ
Sycedēor	哺乳類
Ǣmette	アリ
Bēo	ハナバチ
Niðerlendisc sprǣc	オランダ語
Ǣȝƿyrt	ナス
Draca	ドラゴン
Mōdor	母親
Snāw	雪
Wæterþōðer	水球
1865	1865年
Napoleon III Francena Casere	ナポレオン3世
Russisc sprǣc	ロシア語
Hloþwig XIV Francena Cyning	ルイ14世 (フランス王)
Hām	家庭
Vladimir Putin	ウラジーミル・プーチン
Loðwic-Philippus Francena Cyning	ルイ・フィリップ (フランス王)
Þēodacynewīse	イギリス連邦
Hlāf	パン
Taurica	クリミア半島
Līfclēofa	細胞
Blōd	血液
Īwungplega	コンピュータゲーム
Rumǣnisc sprǣc	ルーマニア語
Regn	雨
Medumweder	気候
Woruldlicu wearmung	地球温暖化
Eorþbeofung	地震
Museum on Dēoraby	ダービー博物館・美術館
Winston Churchill	ウィンストン・チャーチル
Nelson Mandela	ネルソン・マンデラ
10. gēarhundred	10世紀
Fȳrbeorg	火山
Wolcen	雲
Īwungplegtōl	ゲーム機
Wind	風
Lyfthelm	大気圏
Sprǣccræft	言語学
Flocc:Pulgaraland	Category:ブルガリア
Flocc:Francland	Category:フランス
Flocc:Glīƿdrēam	Category:音楽
Flocc:Bōccræft	Category:文学
Fox	アカギツネ
Valladolid	バリャドリッド
Alexander Mæcedonia Cyning	アレクサンドロス3世
Hēaphandþōðer	ハンドボール
Hugo Chávez	ウゴ・チャベス
Þēowdōm	奴隷
Caffig	コーヒー
Meolc	乳
Beorg	山
Oferswefn	催眠
Andrew Johnson	アンドリュー・ジョンソン
Miami	マイアミ
Americanisce Ingefeoht	南北戦争
Rio de Janeiro	リオデジャネイロ
Bryttisce Rīce	イギリス帝国
Albanisc sprǣc	アルバニア語
Ucrægnisc sprǣc	ウクライナ語
Crabba (steorra)	かに座
Swēonisc sprǣc	スウェーデン語
Denisc sprǣc	デンマーク語
Norðisc sprǣc	ノルウェー語
Noam Chomsky	ノーム・チョムスキー
Bæmisc sprǣc	チェコ語
Karl Marx	カール・マルクス
Lettisc sprǣc	ラトビア語
Liþþuanisc sprǣc	リトアニア語
Hinduismus	ヒンドゥー教
Wīflicu brēost	乳房
Mot	原子
Crēacisc sprǣc	ギリシア語
Weorcendebyrdness	オペレーティングシステム
Īrisc sprǣc	アイルランド語
Ambihtlic Cīnisc sprǣc/ᚱᚢᚾ	官話
C. S. Lewis	C・S・ルイス
Baku	バクー
Hebrēisc sprǣc	ヘブライ語
Azeri sprǣc	アゼルバイジャン語
Wilisc sprǣc	ウェールズ語
Scyttisce sprǣc	スコットランド・ゲール語
John Locke	ジョン・ロック
Friedrich Nietzsche	フリードリヒ・ニーチェ
Lifere	肝臓
Drēag (Fūdū)	ゾンビ
Gārsecg	大洋
Gautama Budda	釈迦
Premier League	プレミアリーグ
Mahomet	ムハンマド・イブン＝アブドゥッラーフ
Ācweorna	リス
Rēmisc Cirice	カトリック教会
Bengalisc sprǣc	ベンガル語
Tunge	舌
Folcland Īegland	フォークランド諸島
Manīeg	マン島
Wiht (īeg)	ワイト島
Heortford	ハートフォード (ハートフォードシャー)
Elisabeþ II	エリザベス2世
ß	ß
John F. Kennedy	ジョン・F・ケネディ
Ronald Reagan	ロナルド・レーガン
Æ	Æ
Ð	Ð
Fernando Alonso	フェルナンド・アロンソ
Flocc:Feneswela	Category:ベネズエラ
Þunreshæfen	トースハウン
11. Hāligmōnþes 2001. torngemōt	アメリカ同時多発テロ事件
Culfre	ハト科
Trēow	木
Cīese	チーズ
Wīnberge	ブドウ
Hunig	蜂蜜
Eorþperu	ジャガイモ
Searuþræl	ロボット
Searucræft	テクノロジー
Feorrspreca	電話機
Lugo	ルーゴ (スペイン)
Hēahdēmere þāra Geāndena Rīca American	アメリカ合衆国最高裁判所長官
Windows 7	Microsoft Windows 7
Windows Vista	Microsoft Windows Vista
World Trade Center	ワールドトレードセンター (ニューヨーク)
Nelson Rockefeller	ネルソン・ロックフェラー
David Rockefeller	デイヴィッド・ロックフェラー
One World Trade Center	1 ワールドトレードセンター
Fidel Castro	フィデル・カストロ
Rockefeller Center	ロックフェラー・センター
Flocc:Brasil	Category:ブラジル
Flocc:Rumǣnia	Category:ルーマニア
Hēafodgesceaft	元素
Gemot	分子
Cræftlicu endebyrdung	生物の分類
Lyft	気体
Lyftcræft	航空機
Clāðas	被服
Swēg	音
Paper	紙
Rīm	数
Bere	オオムギ
Nirvana	ニルヴァーナ (バンド)
Weder	気象
Land þǣre worulde	国の一覧
Bera	クマ
John Adams	ジョン・アダムズ
Thomas Jefferson	トーマス・ジェファーソン
James Madison	ジェームズ・マディスン
James Monroe	ジェームズ・モンロー
John Quincy Adams	ジョン・クィンシー・アダムズ
Andrew Jackson	アンドリュー・ジャクソン
Martin Van Buren	マーティン・ヴァン・ビューレン
William Henry Harrison	ウィリアム・ハリソン
John Tyler	ジョン・タイラー
James K. Polk	ジェームズ・ポーク
Zachary Taylor	ザカリー・テイラー
Ǣtweg	消化
Kylie Minogue	カイリー・ミノーグ
Āc	オーク
Pīntrēow	マツ
Āte	エンバク
Hwǣte	コムギ
Corn	穀物
Unmeaht	障害者
Gerīmbōc	暦
Ādl	病気
Gregorisc gerīmbōc	グレゴリオ暦
Soria	ソリア
Manisc sprǣc	マン島語
Bysen:Stedefindend scite Breten	Template:Location map United Kingdom
Millard Fillmore	ミラード・フィルモア
Franklin Pierce	フランクリン・ピアース
James Buchanan	ジェームズ・ブキャナン
Pireni	ピレネー山脈
Hālig Rōmānisc Rīce	神聖ローマ帝国
Mongolrīce	モンゴル帝国
Oþomanisce Rīce	オスマン帝国
Cirice Ednīwung	宗教改革
Wīcingas	ヴァイキング
Sweord	剣
Fȳrwǣpen	銃
Iberia	イベリア半島
Fȳrspringend	爆発物
Campwægn	戦車
Antwerpen	アントウェルペン
François Asselineau	フランソワ・アスリノー
Brycg (burh)	ブルッヘ
Blǣwenberge	ブルーベリー
Blæcberige	ブラックベリー
Fenberge	クランベリー
Cīnisc gōsberige	キウイフルーツ
Retoromanisc sprǣc	ロマンシュ語
Īsrēam	アイスクリーム
Ceace	ケーキ
Īsbrīw	シャーベット
Dinegisc sprǣc	ナバホ語
Meolcbrīw	ヨーグルト
Montserrat	モントセラト
Bysen:Location map Greenland	Template:Location map Greenland
Wikicynn	ウィキスピーシーズ
Arabisc sprǣc	アラビア語
Ian Magen	ヤンマイエン島
Corsica	コルシカ島
Affricanisc sprǣc	アフリカーンス語
Forma Þegn þæs Geānedan Cynerīces	イギリスの首相
Santiago de Compostela	サンティアゴ・デ・コンポステーラ
Fiscoþ	漁
Iquique	イキケ
La Serena (Cile)	ラ・セレナ
Niðerscyttisc sprǣc	スコットランド語
Linux (cyrnel)	Linuxカーネル
Darwin (æhtendebyrd)	Darwin (オペレーティングシステム)
Emmen	エメン (オランダ)
Sofiet Gesamnung	ソビエト連邦
Se Hlāford þāra Hringa	指輪物語
Hrūse	地殻
Sīensearu	カメラ
Gaðes	カディス
Llión	レオン (スペイン)
Fōt	足
Queen	クイーン (バンド)
Freddie Mercury	フレディ・マーキュリー
Normandig	ノルマンディー
Metallica	メタリカ
Wikipǣdia:Fulgōd gewritu	Wikipedia:秀逸な記事
Bysen:Link FA	Template:Link FA
Lēoht (dæg)	昼
Wikipǣdia:Se Þorpes Wella	Wikipedia:井戸端
Vermont	バーモント州
Jacksonville, Florida	ジャクソンビル (フロリダ州)
Los Ángeles (Cile)	ロス・アンヘレス
Eþna	エトナ火山
Æg	卵
Tibet	チベット
Handsprecend	携帯電話
Strȳta	ダチョウ
Corēa	朝鮮
Wesend	バイソン属
Mameceaster	マンチェスター
Turcas and Caicos Īegland	タークス・カイコス諸島
Blēocræft	刺繍
Wulf	オオカミ
Major League Soccer	メジャーリーグサッカー
Þōðer	ボール
Club de Gimnasia y Esgrima La Plata	ヒムナシア・ラ・プラタ
Nīwu Gecȳþnes	新約聖書
Middelseaxe	ミドルセックス
San Pedro de la Paz	サン・ペドロ・デ・ラ・パス
Dūfedoppa	ペリカン属
Nha Trang	ニャチャン
Podolsk	ポドリスク
Pāpa	教皇
Rafael Correa	ラファエル・コレア
5	5年
Louvre	ルーヴル美術館
Sæfern	セヴァーン川
Temes	テムズ川
Tirana	ティラナ
Motorhead	モーターヘッド
6	6年
Josh Duhamel	ジョシュ・デュアメル
Stīðen Āc	スティーブニッジ
Crīstesmæsse	クリスマス
Bises	閏年
Steve Jobs	スティーブ・ジョブズ
Indo-Europisc sprǣchīred	インド・ヨーロッパ語族
Breinigerberg	ブライニガーベルク
Muammar al-Gaddafi	ムアンマル・アル＝カッザーフィー
Tiger	トラ
Moru	芋
Samsunghēap	サムスングループ
Ēaster	復活祭
Germanisca sprǣca	ゲルマン語派
Windows Mobile	Windows Mobile
GNU Frēo Gewrita Amearcunge Lēaf	GNU Free Documentation License
John Kerry	ジョン・ケリー
Taiwan (īeg)	台湾
Searusprecend	スマートフォン
Trōia	イリオス
Nīwe Eoforwīc (scīrung)	ニューヨーク (曖昧さ回避)
Ceafer	甲虫類
Scōh	靴
Baðanceaster	バース (イングランド)
Īrland	アイルランド島
Bradanford	ブラッドフォード (イングランド)
Ceasterscīr	チェシャー
Lonceasterscīr	ランカシャー
Norþhymbraland	ノーサンバーランド (イングランド)
Dūnholmscīr	ダラム (カウンティ)
Lincolnscīr	リンカンシャー
Snotingahāmscīr	ノッティンガムシャー
Dēorabyscīr	ダービーシャー
Scrobbesbyrigscīr	シュロップシャー
Stæffordscīr	スタッフォードシャー
Lægreceastrescīr	レスターシャー
Roteland	ラトランド
Norþfolc	ノーフォーク
Sūþfolc	サフォーク
Grantabrycgscīr	ケンブリッジシャー
Norþhāmtūnescīr	ノーサンプトンシャー
Westmidlandscīr	ウェスト・ミッドランズ
Herefordscīr	ヘレフォードシャー
Wigreceastrescīr	ウスターシャー
Wæringscīr	ウォリックシャー
Beadanfordscīr	ベッドフォードシャー
Cornweal	コーンウォール
Bricgstōw	ブリストル
Defenascīr	デヴォン
Sumorsǣte	サマセット
Dorsǣte	ドーセット
Gleawcesterscīr	グロスタシャー
Oxnafordscīr	オックスフォードシャー
Wiltūnscīr	ウィルトシャー
Hāmtūnescīr	ハンプシャー
Bearrucscīr	バークシャー
Buccingahāmscīr	バッキンガムシャー
Ēastseaxe	エセックス
Sūþrīge	サリー (イングランド)
Cent	ケント (イングランド)
Lundenceaster	シティ・オブ・ロンドン
Sūþseaxe	サセックス
Seofon	7
Taylor Lautner	テイラー・ロートナー
Cumbraland	カンバーランド
Jeremy Renner	ジェレミー・レナー
Īs	氷
Fæder ūre	主の祈り
Musée d'Orsay	オルセー美術館
Hwerhwette	キュウリ
Edinburg	エディンバラ
Hwīt	白
Sweart	黒
Chris Pine	クリス・パイン
Lordi	ローディ (バンド)
6 (getæl)	6
Ambihtlicu sprǣc	公用語
Heortæppel	トマト
Phong Nha-Ke Bang	フォンニャ＝ケバン国立公園
Entrena	エントレナ
Selena	セレナ (歌手)
NASA	アメリカ航空宇宙局
Merida (Feneswela)	メリダ (ベネズエラ)
Atlanta	アトランタ
Benito Mussolini	ベニート・ムッソリーニ
Bermuda	バミューダ諸島
Hēafod	頭
Weolingtūn (Nīwe Sǣland)	ウェリントン
Bryten	グレートブリテン島
Alfred Nobel	アルフレッド・ノーベル
Camb (tō hǣre)	櫛
Mennisc līc	人体
Lila Downs	リラ・ダウンズ
Andrew Garfield	アンドリュー・ガーフィールド
Dottatiger	チーター
Albany on Nīwum Eoforwīce	オールバニ (ニューヨーク州)
Ūle	フクロウ目
Anguilla	アンギラ
Guernsey	ガーンジー
Scearpbeorgas	スヴァールバル諸島
Hrycgdēor	脊椎動物
Nowy Dwór Królewski	ノヴィ・ドゥヴル・クルレフスキ
Faroisc sprǣc	フェロー語
Catt	ネコ科
Lytel Spēonland	イスパニョーラ島
Harrisburg	ハリスバーグ (ペンシルベニア州)
Hamor	槌
Picilemo	ピチレム
Bryttiscan Fæmne Īegland	イギリス領ヴァージン諸島
Flēoge	ハエ目
Norða	北極
Hund	イヌ科
Fresisc sprǣc	フリジア語
Antoni Gaudí	アントニ・ガウディ
Cliferfētedēor	ウシ目
Steorrfisc	ヒトデ
Eurasisc bleohcrāwe	カケス
Hrōc	ミヤマガラス
Ēotaland	ユトランド半島
Niþeru Þēodsc sprǣc	低地ドイツ語
Mölnlycke	メンリッケ
Coning	アナウサギ
Cuscan Rīce	クシャーナ朝
Tromsīeg	トロムソ
Sandwīc	サンドウィッチ (イングランド)
Eormengyld Niccolò Cusano	ニコラウス・クザーヌス大学
Montpelier on Uermonte	モントピリア (バーモント州)
Geac	ヤク
Palistiniscre Frēogunge Þēodnes	パレスチナ解放機構
Westgermanisca sprǣca	西ゲルマン語群
Taylor Swift	テイラー・スウィフト
Cōcīega	クック諸島
Brocc	アナグマ
Sealterisc sprǣc	東フリジア語
Middelasia	中央アジア
Langaland	ランゲラン島
Ofersǣwisc rind	シナモン
Jackson (Mississippi)	ジャクソン (ミシシッピ州)
Concord (Nīwu Hāmtūnscīr)	コンコード (ニューハンプシャー州)
Annapolis	アナポリス (メリーランド州)
Eald Corēa	古朝鮮
Hreaðemūs	コウモリ
Ēastrīce-Ungerland	オーストリア＝ハンガリー帝国
Tarnobrzeg	タルノブジェク
Wesle	イタチ
Scīr	カウンティ
Sandwīc (ǣt)	サンドイッチ
Spearwa	スズメ科
Eormanrīc	エルマナリク
Francisco Franco	フランシスコ・フランコ
Tarja Halonen	タルヤ・ハロネン
Willis Tower	ウィリス・タワー
Cantwaraburg	カンタベリー
Cīna	中国
Tracter	漏斗
Englisc lagu	コモン・ロー
Seolh	鰭脚類
Ecser	エチェル
Silesisc gereord	シレジア語
Zhengzhou	鄭州市
Foresittend	大統領
Frencisc Polynesia	フランス領ポリネシア
Roðem	ルーアン
Crīstesmæsse Īeg	クリスマス島 (オーストラリア)
Bleohfugol	オウム目
Cambihtere	オウム
Arabea	アラビア半島
Fȳstlāc	ボクシング
Seax	ナイフ
Top Gear	トップ・ギア
Tasmansǣ	タスマン海
Ceroke sprǣc	チェロキー語
Campwīg be Tannebeorge	タンネンベルクの戦い (1410年)
Īsbera	ホッキョクグマ
Hand	手
Tu Fu	杜甫
Nīwe Scotta Ēaland	ニューカレドニア
Cecoslofacia	チェコスロバキア
Lēaf	葉腋
Nepal Bhasa	ネパール・バサ語
Valparaíso (on Cilan)	バルパライソ
Nathalia Dill	ナタリア・ディル
Oaxaca	オアハカ州
Tahitisc sprǣc	タヒチ語
Flemisc sprǣc	フラマン語
Yasser Arafat	ヤーセル・アラファート
Oxnaford	オックスフォード
Międzyrzec Podlaski	ミェンヅィジェツ・ポドラスキ
Tasmania	タスマニア州
Creto	クレタ島
Saint-Dié-des-Vosges	サン＝ディエ＝デ＝ヴォージュ
Eormengyld Oxnafordes	オックスフォード大学
Þyrla	ヘリコプター
Sancte Elene Īeg	セントヘレナ
Nicor	カバ
Egisca Sǣ	エーゲ海
Ichiro Mizuki	水木一郎
Anastacia	アナスタシア (歌手)
Eufrāte	ユーフラテス川
James A. Garfield	ジェームズ・ガーフィールド
Cirice	教会
Persisc Sǣ	ペルシア湾
Sand	砂
Cyningestūn (Iamaica)	キングストン (ジャマイカ)
Lafor	ヒョウ
Age of Empires	エイジ オブ エンパイア シリーズ
Tequixquiac	テキシキアック
Ulysses S. Grant	ユリシーズ・グラント
Oklahoma City	オクラホマシティ
Meotedisca Mere	アゾフ海
William McKinley	ウィリアム・マッキンリー
Cawel	キャベツ
Foresittend þāra Geāndena Rīca	歴代アメリカ合衆国大統領の一覧
Sūþgeorgia and þā Sūþsandwic Īegland	サウスジョージア・サウスサンドウィッチ諸島
Webbsīde	ウェブサイト
Ealdfresisc sprǣc	古フリジア語
Catalão	カタラン (ブラジル)
Grover Cleveland	グロバー・クリーブランド
Ealdhēahþēodisc	古高ドイツ語
Ealdseaxisc sprǣc	古ザクセン語
Satan	サタン
Wordstǣrcræft	語源
Beorglēo	ピューマ
Arabas	アラブ人
Proponditis	マルマラ海
Ēagduru	窓
Chester A. Arthur	チェスター・A・アーサー
Riffeng	ウラル山脈
Rīcu þāra Geāndena Rīca American	アメリカ合衆国の州
Pitcearnīega	ピトケアン諸島
Benjamin Harrison	ベンジャミン・ハリソン
Rutherford B. Hayes	ラザフォード・ヘイズ
Wīnlendisc panðer	ジャガー
Sūþaustralia	南オーストラリア州
Gotisc sprǣc	ゴート語
Boise	ボイシ
Bāt	ボート
Awaisc sprǣc	グアラニー語
Gærsbēam	竹
Interlingua	インターリングア
Bosporos	ボスポラス海峡
Smyrna	イズミル
Lemburg	リヴィウ
Cwēneland	クイーンズランド州
Siligo	シーリゴ
Puerto Montt	プエルトモント
Iane Austen	ジェーン・オースティン
Tægcwondo	テコンドー
Middel Englisc sprǣc	中英語
Māorisc sprǣc	マオリ語
Hannibal	ハンニバル
Hōrdōm	売春
Twinemniendlic nama	学名
Victoria (Australia)	ビクトリア州
Geugoslafia	ユーゴスラビア
Ætla	アッティラ
Scrælingas	アメリカ州の先住民族
Arancón	アランコン
Willelm Heretoga of Grantanbrycge	ウィリアム (ケンブリッジ公)
Toshiro Mifune	三船敏郎
Tallahassee	タラハシー (フロリダ州)
Sundorrīcehād	独立
Bismarck (Norþdakota)	ビスマーク (ノースダコタ州)
Aucland	オークランド (ニュージーランド)
Iohannes Paulus I Pāpa	ヨハネ・パウロ1世 (ローマ教皇)
John Michael Talbot	ジョン・マイケル・タルボット
Acrotiri and Ðecelia	アクロティリおよびデケリア
Arara	アララ (パライバ州)
Cnēo	膝
Willelm I Engla Cyning	ウィリアム1世 (イングランド王)
Campora Sancte Iohannes	カンポラ・サン・ジョヴァンニ
Sīde	絹
Sint-Truiden	シント＝トロイデン
Lēoðlic scātung	フィギュアスケート
Stefn (līfcræft)	門 (分類学)
Heanrig VIII Engla Cyning	ヘンリー8世 (イングランド王)
Columbia (Sūþcarolīna)	コロンビア (サウスカロライナ州)
Xena: Warrior Princess	ジーナ
1880. gēar oþ 1889. gēar	1880年代
Helena (Montana)	ヘレナ (モンタナ州)
Wælhwelp	猟犬
Eormengyld Biobiwes	ビオ＝ビオ大学
Sufa	スバ
Eorþmistel	バジリコ
Lēohtfȳsend	レーザー
Prēossland	プロイセン
Cheyenne (Wyoming)	シャイアン (ワイオミング州)
Norðerne healftrendel	北半球
Loidis	リーズ
Fūcgī Beorg	富士山
Mūs	ハツカネズミ属
Geolurēad	オレンジ色
Æcs	斧
Seofonbyrig	トランシルヴァニア
Tōl	道具
Alī	アリー・イブン・アビー・ターリブ
Hrān	トナカイ
Stānhencg	ストーンヘンジ
Ágreda	アグレダ
Amazonas	アマゾナス州
Ajaccio	アジャクシオ
Rodorcræft	宇宙機
Lisa Gerrard	リサ・ジェラルド
Thirty Seconds to Mars	サーティー・セカンズ・トゥー・マーズ
Paulínia	パウリニア
Pierre	ピア (サウスダコタ州)
Crabba	カニ
God Nerie þā Cwēne	女王陛下万歳
Meteūtsiht	下痢
Anna Maria Jopek	アナ・マリア・ヨペック
Horshwæl	セイウチ
Fōrhēafod	額
Haile Selassie	ハイレ・セラシエ1世
Caðum	カーン
Sonygegyld	ソニー
Mynet	硬貨
Sūðerne Healftrendel	南半球
Cnihtas þæm Temple	テンプル騎士団
Americanisc fōtball	アメリカンフットボール
Tōþsticca	爪楊枝
Folcmorðor	ジェノサイド
Hociȝ	アイスホッケー
Swīnmūþa	シフィノウイシチェ
Īrisc Sǣ	アイリッシュ海
Tracia	トラキア
Mongolas	モンゴル系民族
Mǣs	マース川
Talcahuano	タルカワノ
Tahitīeg	タヒチ島
Ontynung	ヨハネの黙示録
Abel Tasman	アベル・タスマン
Gotan	ゴート族
Nettfrumfindend	Uniform Resource Locator
Ænglisc sprǣc	古英語
Englisc folc	イングランド人
Eoforwic	ヨーク (イングランド)
Iron Maiden	アイアン・メイデン
Asterix	アステリックス
Grǣg	灰色
Wearm geard	熱帯
Hwælhuntoþ	捕鯨
Sǣcū	マナティー
Gregorius Pāpa I	グレゴリウス1世 (ローマ教皇)
Cȳta (lyftcræft)	凧
Þunor	トール
Castel Goffredo	カステル・ゴッフレード
Roðos	ロドス島
Sanct	聖人
Wikipǣdia:FAQ	Wikipedia:FAQ
Galatasaray	ガラタサライSK
Cycene	台所
Wæterdraca	クロコダイル科
Hlæstwægn	貨物自動車
Carl Wēala Þēoden	チャールズ (プリンス・オブ・ウェールズ)
Villeneuve-d'Ascq	ヴィルヌーヴ＝ダスク
Crāwe	カラス属
Sūþtun on Defnum	プリマス
Bryttisca Indisca Garsecg Landscipe	イギリス領インド洋地域
Dēoraby	ダービー (イギリス)
Francan	フランク人
Fealcen	ハヤブサ属
Nightwish	ナイトウィッシュ
Mattheus se Godspellere	マタイ
Mac OS	Mac OS
Leyden	ライデン
Fiðerlēasere	キーウィ (鳥)
Montehermoso	モンテエルモーソ
Louis the Pious	ルートヴィヒ1世 (フランク王)
Cwēnsǣ	白海
Jim Morrison	ジム・モリソン
GNOME	GNOME
Hāt	熱
Spere	槍
Ēadig getæl	ハッピー数
Charleston (Westvirginia)	チャールストン (ウェストバージニア州)
Mynster	僧院
Oxnaford Englisc Wordbōc	オックスフォード英語辞典
Īsearn	カワセミ亜目
Carl XVI Gustaf Swēona Cyning	カール16世グスタフ (スウェーデン王)
Świętochłowice	シフィエントフウォヴィツェ
Nile	ナイル (曖昧さ回避)
Zac Efron	ザック・エフロン
Monte Carlo	モンテカルロ
Elba	エルバ島
The Doors	ドアーズ
Fylfōt	卍
Hara	ノウサギ属
Rīcisc edisc	国立公園
Boga	弓矢
Byrdling	リクガメ科
Bryttisc landbūnes	イギリスの海外領土
Brūn	茶色
Hjaltland	シェトランド諸島
Byrddæg	誕生日
Æx-in-Profentse	エクス＝アン＝プロヴァンス
Gaza	ガザ
Īsbeorg	氷山
Ephese	エフェソス
Englisc wera rīcisc fōtballtēam	サッカーイングランド代表
Pratibha Patil	プラティバ・パティル
Minte	ミント
Spilcarte	トランプ
Bysen:Commonscat	Template:Commonscat
Hālig Land	聖地
Folcland Gewinn	フォークランド紛争
Bēowulf	ベオウルフ
Marīahæfen	マリエハムン
Hrǣw	死体
IOS	IOS (アップル)
Lee Harvey Oswald	リー・ハーヴェイ・オズワルド
Frumtæl	素数
Þ	Þ
Orlando	オーランド
Saint Petersburg	セントピーターズバーグ (フロリダ州)
Hereðaland	ホルダラン県
Sogn and þa Flēotas	ソグン・オ・フィヨーラネ県
Meore and Romsdæl	ムーレ・オ・ロムスダール県
Troms	トロムス県
Dǣlere	約数
Australisc fōtþōðer	オーストラリアンフットボール
Secglēac	チャイブ
Stānweall sacunga	ストーンウォールの反乱
Punta Arenas	プンタ・アレーナス
Aaron	アロン
Wu-Tang Clan	ウータン・クラン
Osgar I Swēona Cyning	オスカル1世 (スウェーデン王)
Hwēolrinnung	サイクリング
Aquilegia	アクイレイア
Hyll	丘
Beorneslēah	バーンズリー
Banff	バンフ (スコットランド)
Soria (scīr)	ソリア県
Harold V Norrena Cyning	ハーラル5世 (ノルウェー王)
Þēodlic Dæg	国家の日
John Key	ジョン・キー
Ēadweard I Engla Cyning	エドワード1世 (イングランド王)
Sūþerne Thila	南トゥーレ
Ræt	ネズミ上科
Ariel Sharon	アリエル・シャロン
1050e	1050年代
Æneid	アエネーイス
Forma Frencisce Rīce	フランス第一帝政
Se Holbytla	ホビットの冒険
Eocene	始新世
Hwilpe	アメリカダイシャクシギ
Strǣt	ストリート
Superman	スーパーマン
Wikipǣdia:Fulgōdra gewrita teohhunga	Wikipedia:秀逸な記事の選考
Wikipǣdia:Gōd gewrit genamunga	Wikipedia:良質な記事/良質な記事の選考
Rætswīn	モルモット
Iconium	コンヤ
Emma Goldman	エマ・ゴールドマン
Iacobus I Grēatre Bryten Cyning	ジェームズ1世 (イングランド王)
Crīstcirice	クライストチャーチ
Coronel Fabriciano	コロネル・ファブリシアーノ
Babsk	バプスク (ウッチ県)
Englisca Ingewinn	イングランド内戦
Bengal	ベンガル地方
Morgenmete	朝食
1060e	1060年代
Pippen III Francena Cyning	ピピン3世
Carl I (Grēatre Bryten Cyning)	チャールズ1世 (イングランド王)
Ȝealdor/ᚷᛖᚪᛚᛞᚩᚱ	魔術
Cucler	スプーン
Geþofted Rīcu American	アメリカ連合国
Elpendbān	象牙
Villarrobledo	ビリャロブレド
Temuco	テムコ
Hloðwic I Francena Cyning	クロヴィス1世
William Wallace	ウィリアム・ウォレス
Bundesliga	サッカー・ブンデスリーガ (ドイツ)
Fȳrland	ティエラ・デル・フエゴ
Maria I Engla Cwēn	メアリー1世 (イングランド女王)
Angelcirice	イングランド国教会
Engla Cyning	イングランド君主一覧
Lencten (tīd)	四旬節
Fuþorc	ルーン文字
Lēactric	レタス
Beadu Hǣstingum	ヘイスティングズの戦い
Ēadweard VI Engla Cyning	エドワード6世 (イングランド王)
Jacques-Yves Cousteau	ジャック＝イヴ・クストー
Horatio Nelson	ホレーショ・ネルソン
Galilēa	ガリラヤ
Gaderscypefāna	イギリスの国旗
Foldlic clūt	リソスフェア
Þūma	親指
Ælfrēd Micela	アルフレッド大王
Hāmlǣrung	ホームスクーリング
Teutoburg Weald Beadu	トイトブルク森の戦い
Bysen:Cite book	Template:Cite book
O Canada	オー・カナダ
Biobío	ビオビオ川
Orcanege	オークニー諸島
Profentse	プロヴァンス
Predore	プレドーレ
Seaxe	サクソン人
Willelm II Engla Cyning	ウィリアム2世 (イングランド王)
Limburgisc	リンブルフ語
Eallerīca Gotena Cyning	アラリック1世
Tygelwīg	綱引き
Boētius	ボエティウス
Hunigbēo	ミツバチ
Abbod	修道院長
Mæcedonia	マケドニア
Sameramis	セミラミス
Pīp	パイプ (たばこ)
Aerosol	大気エアロゾル粒子
Gangnihessou	ガニヘス
Ilfingburg	エルブロンク
Mierce	マーシア
Þēodrīc Ēastgotena Cyning	テオドリック (東ゴート王)
Westseaxena Rīce	ウェセックス
Hēahland	ハイランド地方
Norþhymbra Rīce	ノーサンブリア
Wulfila	ウルフィラ
Bram Stoker's Dracula	ドラキュラ (映画)
Angeow	アンジュー
2011 FIFA Frēona Woruldceampscipe	2011 FIFA女子ワールドカップ
Alexander VI Pāpa	アレクサンデル6世 (ローマ教皇)
Æppellēaf	ニオイスミレ
Mexiciscu rīce	メキシコの州
Edward Braddock	エドワード・ブラドック
Cethāmīga	チャタム諸島
Norþīg	北島 (ニュージーランド)
Anne Cwēn	アン (イギリス女王)
Sūþīeg	南島 (ニュージーランド)
Dziecinów	ヂェチヌフ (オトフォツク郡)
Sunnstede	至点
Wynton Rufer	ウィントン・ルーファー
Regnwyrm	ミミズ
Kara	KARA
Ceadmere	チャド湖
Getalu Rōmāniscra Cāsera	ローマ皇帝一覧
Heantun	ウルヴァーハンプトン
Wascas	バスク人
Minerva	ミネルウァ
Fȳræg	爆弾
Ashley Tisdale	アシュレイ・ティスデイル
Nīwe Woruld	新世界
Fȳrweorc	花火
Æsc	トネリコ属
Galwæg	ゴールウェイ
Ēadweard Andettere	エドワード懺悔王
Hramsa	ラムソン
Scīdfarung	スキー
World of Warcraft	World of Warcraft
Byrig þāra Geāndena Rīca	アメリカ合衆国の主な都市人口の順位
Nemniendlic cāsus	主格
Folcawanderung	民族移動時代
Slayer	スレイヤー
Biliþ and lēoþcræft	IMMAGINE&POESIA
Maria Scotta Cwēn	メアリー (スコットランド女王)
Indisc rīce	インドの地方行政区画
Scield	盾
Henry V Englalandes	ヘンリー5世 (イングランド王)
Sciþþia	スキタイ
Sceanca	脚
Pulgare	ブルガリア人
Lyftscip	飛行船
Cnut se Micela	クヌート1世 (イングランド王)
Saturnus	サートゥルヌス
Exanceaster	エクセター
Sanctes Laurentes Ēa	セントローレンス川
Mundlēow	流し台
Sūþhjaltland	サウス・シェトランド諸島
Cartespil	カードゲーム
Iscimbag	イシンバイ
Basu Heorte	パープルハート章
Marianburg	マルボルク
Rosseg	メインランド島 (オークニー諸島)
Nīwsǣlandworulddǣl	ジーランディア
Carl Fǣtta Francena Cyning	カール3世 (フランク王)
Þēodisc Āþbēorscipe	ドイツ連邦
Wikipǣdia:How to edit a page	Help:ページの編集
Cantwarabyrig eorþbeofung 2011.	カンタベリー地震 (2011年)
Eorðæppelstycce	フライドポテト
Rīnland	ラインラント
Eormengyld Tybingenes	エバーハルト・カール大学テュービンゲン
Blōdmearh	ブラッドソーセージ
Midsumor	ヨーロッパの夏至祭
Timborwyrhta	大工
Anlaf V Norrena Cyning	オーラヴ5世 (ノルウェー王)
Ēadweard Westseaxna Eorl	エドワード (ウェセックス伯爵)
Hacun VII Norrena Cyning	ホーコン7世
Ecgbryht	エグバート (ウェセックス王)
Earnulf Carendran	アルヌルフ (東フランク王)
Bēda	ベーダ・ヴェネラビリス
Laplandes Gūþ	ラップランド戦争
Willelm-Alexander Niðerlanda Cyning	ウィレム＝アレクサンダー (オランダ王)
Bredspearctellend	タブレット (コンピュータ)
Mathusal	メトシェラ
Bægware	バイエルン人
Bēowyrt	ショウブ
Pontcysyllte Wætertyge	ポントカサステ水路橋と運河
Universidade Federal da Bahia	バイーア連邦大学
Nēohwæl	イッカク
Ajman	アジュマーン
Harold Godwinson	ハロルド2世 (イングランド王)
Ȳþrīdung	サーフィン
Brū	まつげ
Port:Stǣr	タジキスタンの国旗
Kiæresburh	シェルブール＝オクトヴィル
Bresl	プレッツェル
CONCACAF	北中米カリブ海サッカー連盟
Searoburg	ソールズベリー
Lunden Ēage	ロンドン・アイ
Valdivia	バルディビア
Pachuca de Soto	パチューカ
Dweorgedosle	ペニーロイヤルミント
Landbūnes	海外領土・自治領の一覧
Rēadingas	レディング
Grēate Bryten Cynerīce	グレートブリテン王国
Iane Grey Hlæfdige	ジェーン・グレイ
Charmed	チャームド
Grammatisc cyn	性 (文法)
Nica Ūphebbung	ニカの乱
Sihþ	視覚
Brycgāðexe	ムカシトカゲ
Americanisc wera rīcisc fōtballtēam	サッカーアメリカ合衆国代表
Maywood, Illinois	メイウッド (イリノイ州)
Þrēo Coreaniscu Cynerīcu	三国時代 (朝鮮半島)
Feðer (blæces)	ペン
Bryttisca Antarctisca Landscipe	イギリス領南極地域
Starcraft	スタークラフト
Seofon dēadlica synna	七つの大罪
Finger	中指
Midwearme geardas	温帯
Angleseg	アングルシー島
Niðerseaxisc sprǣc	低ザクセン語
Māse	シジュウカラ科
Caselle Landi	カゼッレ・ランディ
Penwiðsteort	ランズ・エンド (岬)
Ratchet & Clank	ラチェット&クランク (ゲーム)
Æðelstān Engla Cyning	アゼルスタン (イングランド王)
Ras al-Khaimah	ラアス・アル＝ハイマ
Elene Constantinoples	聖ヘレナ
Nintendo DS	ニンテンドーDS
Ēse	アース神族
Nīwe Francland	ヌーベルフランス
Englalandes Fana	イングランドの国旗
Cyclades	キクラデス諸島
Trafalgar Sǣfeoht	トラファルガーの海戦
Iosephine Francena Caserin	ジョゼフィーヌ・ド・ボアルネ
Sōlate	ヒマワリ
Cynelica Sciphere	イギリス海軍
Inbærnes	乳香
Difelinscīr	ダブリン州
Æppelcyrnel (wǣpen)	手榴弾
Helm	ヘルメット
Umm Al Quwain	ウンム・アル＝カイワイン
Nīwes Sǣlandes þēodlīc fōtþōðerhēap	サッカーニュージーランド代表
Ingang:Stǣr	Portal:歴史
Nonne Etone	ヌニートン
Fīfte Cynewīse	第五共和政
The Oval	ザ・オーバル
2010 FIFA Woruldceampscipe	2010 FIFAワールドカップ
Sunu	息子
Grīpfealcen	シロハヤブサ
Snāwbordfarung	スノーボード
Ōsgeard	アースガルズ
Glīdflēogung	パラグライダー
Mageoscīr	メイヨー州
Australisc rīce	オーストラリアの州と特別地域
Blizzard Entertainment	ブリザード・エンターテインメント
Gerinnung	凝固・線溶系
Dofras	ドーバー (イギリス)
Cannae Beadu	カンナエの戦い
Herenuma	捕虜
Dȳfung	潜水
Daguerreotype	ダゲレオタイプ
Dūnholm	ダラム
Þrēotīene Landbūnessa	13植民地
Brenda Song	ブレンダ・ソング
Lincoln	リンカン (イングランド)
Syllīega	シリー諸島
Smallville (TV endebyrdnes)	ヤング・スーパーマン
Helen Clark	ヘレン・クラーク
Būr	部屋
Wēala Þēoden	プリンス・オブ・ウェールズ
Scōnīeg	スコーネ地方
Milanes Bann	ミラノ勅令
Francforta	ホットドッグ
Gelocen boge	クロスボウ
Meremægden	人魚
Wichlawscīr	ウィックロー州
Striuelin	スターリング (スコットランド)
Æðelred Unrǣd	エゼルレッド2世 (イングランド王)
Twentig Þūsend Lēowena Under þǣm Sǣ	海底二万里
Baius	バイユー
Ballōn (lyftcræft)	気球
Colneceaster	コルチェスター
Meodu	蜂蜜酒
Met (Grammaticcræft)	法 (文法)
Sǣelpend	ゾウアザラシ属
Grytviken	グリトビケン
Fox News	FOXニュース
Ēadweard se Ieldra	エドワード長兄王
Iþacige	イタキ島
Baius tæpped	バイユーのタペストリー
Montréal Canadiens	モントリオール・カナディアンズ
Underburg	郊外
Sharjah	シャールジャ
Antrimscīr	アントリム州
Vigdís Finnbogadóttir	ヴィグディス・フィンボガドゥティル
Final Fantasy	ファイナルファンタジーシリーズ
Norrena Cyning	ノルウェー君主一覧
Westmynster	ウェストミンスター
Ēadmund Æðeling	エドマンド1世 (イングランド王)
Rachel McAdams	レイチェル・マクアダムス
Fermanagh	ファーマナ州
Dūnscīr	ダウン州
E Pluribus Unum	エ・プルリブス・ウヌム
Foresittend Franclandes	共和国大統領 (フランス)
New Jersey Devils	ニュージャージー・デビルス
Philadelphia Flyers	フィラデルフィア・フライヤーズ
Yun Chi-ho	尹致昊
Sancte Elene Īeg, Upstigeīeg and Tristan da Cunha	セントヘレナ・アセンションおよびトリスタンダクーニャ
Tirowen	ティロン州
Jack Ruby	ジャック・ルビー
Ardmachusscīr	アーマー州
Scene	シャノン川
Wīnland	ヴィンランド
Venom (trūðhlōð)	ヴェノム (バンド)
Luel	カーライル (イングランド)
Ēadgar Engla Cyning	エドガー (イングランド王)
Kea	ミヤマオウム
Itumbiara	イツンビアラ
A Night at the Opera	オペラ座の夜
Queen (album)	戦慄の王女
Þunres Hamor	ミョルニル
Oben am jungen Rhein	若きライン川上流に
Guinness	ギネス
Liðere	投石器
Thomas Cranmer	トマス・クランマー
Tawpomere	タウポ湖
Universidad de Concepción	コンセプシオン大学
Hameldūn (Nīwe Sǣland)	ハミルトン (ニュージーランド)
Stǣr þǣre Worulde	世界の歴史
Rēad wulf	アメリカアカオオカミ
Normandisca Forcyme	ノルマン・コンクエスト
Fif Scīr	ファイフ
Stǣrwrītere	歴史家
Carolina Hurricanes	カロライナ・ハリケーンズ
Nebrond	ニムロド
Tampa Bay Lightning	タンパベイ・ライトニング
Scrobbesburh	シュルーズベリー
Fæger hǣr	金髪
Napier (Nīwe Sǣland)	ネーピア
Myrra	没薬
Harold III Norrena Cyning	ハーラル3世 (ノルウェー王)
Fisc and styccu	フィッシュ・アンド・チップス
Middeltūn þǣra de Cahaignes	ミルトン・キーンズ
Florida Panthers	フロリダ・パンサーズ
Washington Capitals	ワシントン・キャピタルズ
Īrisc fōtþōðer	ゲーリックフットボール
Nīwes Sǣlandes Þēodlic Stēormǣlhēap	ニュージーランド国民党
West Loðene	ウェスト・ロージアン
Lonceaster	ランカスター (イングランド)
Sūþalpis	南アルプス山脈
Midloðene	ミッドロージアン
Neamere	ネイ湖
Wyrt	ハーブ
Maðante	マント＝ラ＝ジョリー
Ēast Loðene	イースト・ロージアン
Fermat tæl	フェルマー数
Clackmannanscīr	クラックマナンシャー
Liccidfeld	リッチフィールド (イングランド)
Sūþorcanege	サウス・オークニー諸島
Rænkīnes hātȝemet	ランキン度
Se Fēolagascipe þæs Hringes	旅の仲間
Cod	タラ
Gold (bleoh)	金色
Holstānburg	シシミウト
Micel Ficgīeg	ビティレブ島
Wrenna	ミソサザイ科
Ciricewæl	カークウォール
1984 (bōc)	1984年 (小説)
Folcaþing	フォルケティング
Underset gamen	拡張パック
Elig	イーリー
Getalu burga in Þēodsclande	ドイツの市町村一覧
Innuendo	イニュエンドウ
The Game	ザ・ゲーム
Bancorena burg	バンゴール
Gēol	ユール
Washington Redskins	ワシントン・レッドスキンズ
Swīma	回転性めまい
Ægelesburg	アリスバーリー
Tristania	トリスタニア
Wuldor	ウル (北欧神話)
Lāmwic	ラーウィック
Westgeatland	ヴェステルイェートランド地方
Victory (scip)	ヴィクトリー (戦列艦)
Sihhem	ナーブルス
Beatrix Potter	ビアトリクス・ポター
Ēadgar Æðeling	エドガー・アシリング
Grēat Rōmisc Fȳr	ローマ大火
Mann	人間
Tollund wer	トーロンマン
Ynce	インチ
Gearwung (plega)	フィジカルトレーニング
Diablo (gamen)	ディアブロ (ゲーム)
Anggun	アングン
Verizon Center	ベライゾン・センター
Apaxco	アパスコ
Cham	ハム (聖書)
Zune	Zune
Nettþōðer	ネットボール
Lox	リンクス
In	IN
Diablo	ディアブロ
Roanoke	ロアノーク
Cnut	クヌート
Acan tūn	アクトン
Eormengyld Ciles	チリ大学
Engel	天使
Sasha Cohen	サーシャ・コーエン
Rachael Taylor	レイチェル・テイラー
Pat Benatar	パット・ベネター
Michelle Kwan	ミシェル・クワン
Wæstm	農産物
Beate Eriksen	ベアーテ・エリクセン
D.C. United	D.C. ユナイテッド
Eowland	エーランド島
Starcraft II	スタークラフト2
Gregorius Pāpa	グレゴリウス
Allan Kardec	アラン・カルデック
Diablo III	ディアブロ3
Sceadu (gyden)	スカジ (北欧神話)
Diablo II	ディアブロ2
Atlanta Thrashers	アトランタ・スラッシャーズ
The God Delusion	神は妄想である
Canadisc fōtþōðer	カナディアンフットボール
Hæstingas (missenlīc gewritu)	ヘイスティングズ
Ealra Hālgena Ǣfen	ハロウィン
Sūþtun	サットン
Weorcdæg	労働時間
Leðerhosu	レーダーホーゼン
Bān	骨
7 World Trade Center	7 ワールドトレードセンター
Vampire Knight	ヴァンパイア騎士
Ælfweard West-Seaxes	エルフウェルド
Bēagel	ベーグル
Rēcels	香
Ūtwyrp	ラジオ放送局
Iapanisc āttorcopplic crabba	タカアシガニ
Woruldlic Gemōt þāra Ciricena	世界教会協議会
Blæcesburg, Virginia	ブラックスバーグ (バージニア州)
Ériu	エリウ
Ítróttarfelag Fuglafjarðar	ÍFフグラフィヨルズル
Oresundes brycg	オーレスン・リンク
Dohtor	娘
Spell Twēgra Burga	二都物語
Morbid Angel	モービッド・エンジェル
John Ashcroft	ジョン・アシュクロフト
Alexander Ovechkin	アレクサンドル・オベチキン
Alexis Tsipras	アレクシス・ツィプラス
Seolfor (bleoh)	銀色
Philip Jaisohn	徐載弼
Widukind	ウィドゥキント
Wælheall Herig	ヴァルハラ神殿
Æbbandūn	アビンドン＝オン＝テムズ
Law & Order	ロー&オーダー
Westmannland	ヴェストマンランド地方
Leaves' Eyes	リーヴズ・アイズ
Corn Flakes	コーンフレーク
Penda Miercna Cyning	ペンダ (マーシア王)
Dūnstān	ドゥンスタン
Mælcolm II Scotta Cyning	マルカム2世 (スコットランド王)
Ēadgar Scotta Cyning	エドガー (スコットランド王)
Pak Hon-yong	朴憲永
Americanisc frēona rīcisc fōtballtēam	サッカーアメリカ合衆国女子代表
Obituary	オビチュアリー
Berserca	ベルセルク
Bēam	ビーム
Minoru Yamasaki	ミノル・ヤマサキ
Pulgara Cyning	ブルガリア君主一覧
Ēadmund se Martyr	エドマンド殉教王
Australisca Witenagemōt	オーストラリア連邦議会
Lao	ラーオ族
Wīfel	ゾウムシ
Agalloch	アガアロク
Godspell Mattheus	マタイによる福音書
Uzumaki/ᚢᛋᚢᛗᚪᛦᛁ	うずまき
Ēadmund	エドマンド
Wīn	WIN
James Ēa	ジェームズ川
Ȝ	Ȝ
Nazarēth	ナザレ
Ænglisc grammaticcræft	古英語の文法
Rise of Nations	ライズ オブ ネイション 〜民族の興亡〜
Geþingedōm	スコットランドの地方行政区画
Kwara Rīce	クワラ州
Windlesōra	ウィンザー (イングランド)
Heo Jong-suk	許貞淑
Caroline Zhang	キャロライン・ジャン
America's Cup	アメリカスカップ
Wīnlendisc cystel	アメリカグリ
Brian Jacques	ブライアン・ジェイクス
Agmodesham	アマーシャム
Paramore	パラモア
Recedham	ロッチデール
Illative cāsus	入格
Herelic munucregol	騎士修道会
Ǣȝhnōg	エッグノッグ
Coritiba Foot Ball Club	コリチーバFC
Tansonnhates Geondrīciscum Lyfthæfene	タンソンニャット国際空港
Þresc stīele	スラッシュメタル
The Chronicles of Narnia	ナルニア国物語
Iacub Colas	ヤクプ・コーラス
James Hetfield	ジェイムズ・ヘットフィールド
Keane	キーン (バンド)
Medinaceli	メディナセリ
Burgo de Osma-Ciudad de Osma	エル・ブルゴ・デ・オスマ
Pensacola	ペンサコーラ (フロリダ州)
Anath	アナト
Barbourscīr, Westvirginia	バーバー郡 (ウェストバージニア州)
Duval Scīr, Florida	デュバル郡 (フロリダ州)
Hāmtūnscīr Scīr, West Virginia	ハンプシャー郡 (ウェストバージニア州)
Samsung Galaxy Note	SC-05D
Perfume	Perfume
Park Jung-yang	朴重陽
Beadu Cealdre Hȳðe	コールドハーバーの戦い
Rōwrenoc (Virginia)	ロアノーク (バージニア州)
Sūþtūn Hōh	サットン・フー
Tuidi	ツイード川
Sǣbeorg	海山
Dornwaraceaster	ドーチェスター
Chris Pratt	クリス・プラット
Walhshalh	ウォルソール
Bēdesford, Virginia	ベッドフォード (バージニア州)
Ēadƿeard Æðeling Scīr, Virginia	プリンスエドワード郡 (バージニア州)
Angul	アンゲルン半島
Fiðele	フィドル
Cambihtuc	オカメインコ
Hwælsang	クジラの歌
Boston Breakers	ボストン・ブレイカーズ
Cannae	カンナエ
Niht (gyden)	ノート (北欧神話)
Mexicanisc frēona rīcisc fōtballtēam	サッカーメキシコ女子代表
Læland	ロラン島
Bukan	ブーカーン
God Hates Us All	ゴッド・ヘイツ・アス・オール
Gemǣne Rīca of Australie	オーストラリアの総督
Ælmer	マルムズベリーのエイルマー
Grahamland	グレアムランド
Wikipǣdia:Sceortpæþ	Wikipedia:ショートカット
Mirai Nagasu	長洲未来
Eormengyld Juraj Dobrila on Pula	ユライ・ドブリラ大学プーラ
Scieppend	創造神
Sybelhūs on Lundne	バンケティング・ハウス
Beadu þæs Bogn	ボイン川の戦い
Puebla FC	プエブラFC
MorphOS	MorphOS
Atari Jaguar	Atari Jaguar
Hēffe Wehbig	ハイファ・ワハビ
Ulfretūn	ニューベリー (バークシャー)
Tæppa	蛇口
Tīdunghēap	ニュースグループ
Nile (trūðhlōð)	ナイル (バンド)
Stǣr Angelþēode ciricean	イングランド教会史
Rēan	ラーン (北欧神話)
Tæfingstoc	タヴィストック
Negombo	ニゴンボ
Blecinga īeg	ブレーキンゲ地方
Lox (catte)	オオヤマネコ
Lǣden-ofgangena stæfrǣwa	ラテンアルファベットに由来するアルファベット
Huntandūn	ハンティンドン
Tomtun	タムワース
Ambihtlicu Cīnisc sprǣc	普通話
Mans	メーヌ
Hwicce	ウィッチェ
Falster	ファルスター島
Janus (Windows beta)	Microsoft Windows 3.x
Difelinburg	ダブリン城
SOX leoht-fæt	ナトリウムランプ
Wuduhen	ニュージーランドクイナ
Gawain and se Grēna Cniht	ガウェイン卿と緑の騎士
Chrono Trigger	クロノ・トリガー
Selfrīcsiendlica landbūnessa	自治区
Bloomesdæg	ブルームの日
Rīdungfȳrramm	人間魚雷
Adreminte	ナツシロギク
Stæfford	スタッフォード (イングランド)
Almarza	アルマルサ
Aldealices	アルデアリセス
Aldealafuente	アルデアラフエンテ
Alentisque	アレンティスケ
Adradas	アドラーダス
Abejar	アベハール
Aldealpozo	アルデアルポソ
Alcubilla de Avellaneda	アルクビージャ・デ・アベジャネーダ
Maján	マハン (スペイン)
Castillejo de Robledo	カスティリェホ・デ・ロブレド
Ergo Proxy	Ergo Proxy
Rōmānisc Cāsere	ローマ皇帝
Weogornaceasterscīrsēaw	ウスターソース
Getalu ambihtlicra sprǣca	公用語の一覧
Maybach Exelero	マイバッハ・エクセレロ
Īslendisc frēona rīcisc fōtþōðerhēap	サッカーアイスランド女子代表
Worulde Fanan	Flags of the World
Hafoc	鷹
Dēaðas in 2005. gēare	訃報 2005年
York University	ヨーク大学 (カナダ)
Cirenceaster	サイレンセスター
Strēoneshalh	ウィットビー
Skræling	スクレリング
Grēnelandes Norren sprǣc	グリーンランドノルド語
BloodRayne 2	ブラッドレイン2
Brytenwealda	ブレトワルダ
Sǣearmlandes Rīcisc Edisc	フィヨルドランド国立公園
Port Authority of New York and New Jersey	ニューヨーク・ニュージャージー港湾公社
Getalu īega be landware	島の一覧 (人口順)
Street Fighter IV	ストリートファイターIV
Help:Innoþ	Help:目次
Wikipǣdia:Tutorial	Wikipedia:ガイドブック
Wīntrēow	つる植物
Witch Hunter Robin	Witch Hunter ROBIN
Oenoīeg	オエノ島
3 World Trade Center	3 ワールドトレードセンター
Los Angeles Sol	ロサンゼルス・ソル
Hrodulf se rēadnosoda hrāndēor	ルドルフ 赤鼻のトナカイ
Elpendīeg	エレファント島
Getæl īega	島の一覧
Faroisce cwidas	フェロー諸島のバラッド
Elenesburh	ヘレンズバラ
Sūþern Strēamflēot	カンゲルルススアーク
Vrahovice	ヴラホヴィツェ
Gēatland	ゴットランド島
Būc	胃
Nīwes Sǣlandes Weorces Stēormǣlhēap	ニュージーランド労働党
Unicron	ユニクロン
Stǣr Floridan	フロリダ州の歴史
Stēamwægn	蒸気自動車
Simeon II Pulgara Cyning	シメオン・サクスコブルクゴツキ
Cutey Honey	キューティーハニー
Clarenceīeg, Sūþhjaltland	クラレンス島
Umm Culþþūm	ウム・クルスーム
2 World Trade Center	2 ワールドトレードセンター
Froggmann	フロッグマン
Beadu Omdurmanes	オムダーマンの戦い
Ƿ	Ƿ
Hellraiser	ヘル・レイザー
Elisabeþ Cwēn Land	クイーン・エリザベス・ランド
Wikipǣdia:Ambihtsecghof	Wikipedia:大使館
Mǣþ	草刈り
National Hockey League	ナショナルホッケーリーグ
Flyhthæfen	空港
Universidad de Santiago de Chile	サンティアゴ・デ・チレ大学
Sandeg, Orcanege	サンデー島 (オークニー諸島)
Sundrodland	シティ・オブ・サンダーランド
Leskovīeg	レスコフ島
Love Machine (sang)	LOVEマシーン
Nīwes Sǣlandes Grēne Stēormǣlhēap	緑の党 (ニュージーランド)
Stǣrlice gemynddagas	365日
Uzumaki	うずまき (漫画)
4 World Trade Center	4 ワールドトレードセンター
KMFDM	KMFDM
Women's Professional Soccer	アメリカ女子プロサッカー
Sǣweardþrēat	沿岸警備隊
Agnes Monica	アグネス・モニカ
Evile	イーヴァイル
Pasquier Quesnel	パスキエ・ケネル
Flocc:Ƿeras	Category:男性
Flocc:Þēodscland	Category:ドイツ
Flocc:Italia	Category:イタリア
Flocc:Geānedu Rīcu American	Category:アメリカ合衆国
Flocc:Russland	Category:ロシア
Flocc:Canada	Category:カナダ
Flocc:Geānede Cynerīce	Category:イギリス
Flocc:Spēonland	Category:スペイン
Flocc:Cīna	Category:中国
Flocc:Iapan	Category:日本
Flocc:Australia	Category:オーストラリア
Flocc:Mexico	Category:メキシコ
Flocc:Indea	Category:インド
Flocc:Saudisc Arabea	Category:サウジアラビア
Flocc:Israhēl	Category:イスラエル
Flocc:Turcland	Category:トルコ
Flocc:Sūðaffrica	Category:南アフリカ共和国
Flocc:Ǣgypt	Category:エジプト
Flocc:Persealand	Category:イラン
Flocc:Nīwe Sǣland	Category:ニュージーランド
Flocc:Argentina	Category:アルゼンチン
Sky Blue FC	スカイ・ブルーFC
Flocc:Afghanistan	Category:アフガニスタン
Flocc:Algeria	Category:アルジェリア
Flocc:Ēastrīce	Category:オーストリア
Flocc:Bangladesc	Category:バングラデシュ
Flocc:Cūba	Category:キューバ
Flocc:Sigelhearwenaland	Category:エチオピア
Flocc:Indonesia	Category:インドネシア
Flocc:Irac	Category:イラク
Flocc:Niðerland	Category:オランダ
Flocc:Nigeria	Category:ナイジェリア
Flocc:Pacistan	Category:パキスタン
Flocc:Pōlaland	Category:ポーランド
Flocc:Portugal	Category:ポルトガル
Flocc:Sudan	Category:スーダン
Flocc:Tansania	Category:タンザニア
Flocc:Ucrægna	Category:ウクライナ
Flocc:Fietnam	Category:ベトナム
Flocc:Rōmānisc Cāsere	Category:ローマ帝国
Flocc:Sycedēor	Category:哺乳類
Flocc:Fugolas	Category:鳥類
Flocc:Plantan	Category:植物
Flocc:Stǣr	Category:歴史
Flocc:Ferscipe	Category:社会
Flocc:Gelēafan	Category:宗教
Flocc:Plegan	Category:スポーツ
Flocc:Sprǣc	Category:言語
Flocc:Eorþ	Category:地球
Victor Iusccenco	ヴィクトル・ユシチェンコ
Thila-īeg	テューレ島
Saint Louis Athletica	セントルイス・アスレティカ
Palmerland	パーマーランド
Hocig	ホッケー
Frēodōm	フリーダム
MTB	高速魚雷艇
Īsensmiþ	鍛冶屋
Wiogoraceastre	ウスター
Abbodesse	女子修道院長
Ganet	シロカツオドリ属
Sydneycofa	シドニー・コーブ
Smith & Wesson 500	S&W M500
Hwæl	クジラ
Richard Pearse	リチャード・ピアース
Flocc:Scīrung	Category:曖昧さ回避
Flocc:Olympisc Gamen	Category:オリンピック
Flocc:Crīstendōm	Category:キリスト教
Flocc:Alladōm	Category:イスラム教
Beorgford	バーフォード
Decatur	ディケーター
Ātmǣl	オートミール
Earn	鷲
Scyrte	スカート
Wyomingdenu wæl	ワイオミングの戦い
Irac Cyning	イラク国王一覧
Oferferung on Francenarīce	フランスの交通
Elworuldontygenes	アルテルモンディアリスム
Bochotnica	ボホトニツァ
Anna Hutchison	アンナ・ハッチソン
Adesa	釿
Sceota	ブラウントラウト
Flocc:Styccelicu gewritu	Category:スタブ
Flocc:Wikipedia categorization	Category:カテゴリ関連
Flocc:Sidaþing	Category:文化
Flocc:Gēar	Category:年
Flocc:Worulddǣl	Category:大陸
Flocc:Lyftcræftas	Category:航空機
The Tonight Show with Jay Leno	ザ・トゥナイト・ショー・ウィズ・ジェイ・レノ
Wikipǣdia:Gecorene gemynddagas	Wikipedia:今日は何の日
Bysen:Stēorungsunnanendebyrdnes	Template:太陽系
Smiþþfeld, Lunden	スミスフィールド
Wikipǣdia:Wikibōceras	Wikipedia:ウィキペディアン
Scearseax	剃刀
Wikipǣdia:Snell bīcniend	Wikipedia:索引
Wikipǣdia:Recentchanges	Help:最近更新したページ
Basu	紫
Yfelland Ƿeard	バッドランズ・ガーディアン
Sciþþisc īsmægden	パジリク古墳群
Bysen:Succession box	Template:Succession box
Flocc:Flēogeball	Category:バレーボール
Flocc:Wikipedia bots	Category:Wikipedia bots
Port:Gefērscipe	Portal:メディア
Ened	カモ
Hwīt Draca	白い竜 (ウェールズの伝承)
Bysen:Cquote	Template:Quote
Flocc:Þēodisc	Category:ドイツの人物
Flocc:Land	Category:国
Catherine	キャサリン
Wikipǣdia:Bewitendas	Wikipedia:管理者
Flocc:Lēode	Category:人物
Wikipǣdia:Bēna tō and fram bewitendhāde	Wikipedia:管理者への立候補
Flocc:Tīd	Category:時間
Flocc:Bodiȝlār	Category:解剖学
Wikipǣdia:Betwuxsprǽclice bendas	Help:言語間リンク
Flocc:Leornung	Category:教育
Cyningesbeorg	ケーニヒスベルク (プロイセン)
Ægypt	エジプト
Yulia Lipnitskaya	ユリア・リプニツカヤ
Flocc:Ūtwitan	Category:哲学者
Bysen:Bot	Template:Bot
Wikipǣdia:Hwæt Wikipǣdia Nis	Wikipedia:ウィキペディアは何ではないか
Canada	カナダ
Flocc:Ungerland	Category:ハンガリー
Flocc:Belgice	Category:ベルギー
Flocc:Cipros	Category:キプロス
Flocc:Cecland	Category:チェコ
Flocc:Denemearc	Category:デンマーク
Flocc:Estland	Category:エストニア
Flocc:Finnland	Category:フィンランド
Flocc:Crecaland	Category:ギリシャ
Flocc:Lettland	Category:ラトビア
Flocc:Īsland	Category:アイスランド
Flocc:Letseburg	Category:ルクセンブルク
Flocc:Liþuania	Category:リトアニア
Flocc:Melita	Category:マルタ
Flocc:Swēoland	Category:スウェーデン
Flocc:Slofacia	Category:スロバキア
Flocc:Īrland Cynewīse	Category:アイルランド
Flocc:Fulgōd ȝeƿritu	Category:秀逸な記事
Flocc:Spærcletelle gamen	Category:コンピュータゲーム
Heofon	天国
Fresland	フリースラント
Flocc:Microsoft	Category:マイクロソフト
Wikipǣdia:Edit summary	Help:要約欄
Bysen:Flagicon	Template:Flagicon
Flocc:Land on Europan	Category:ヨーロッパの国
Flocc:Europe	Category:ヨーロッパ
Flocc:Wikipedia:Help	Category:ヘルプ
Help:Mōtungtramet	Help:ノートページ
Wikipǣdia:Efenealde belimpas	Portal:最近の出来事
Bysen:Documentation	Template:Documentation
Wikipǣdia:Protected pages	Wikipedia:保護の方針
Flocc:Wikibōceras	Category:ウィキペディアン
Wikipǣdia:Gemǣnscipes Ingang	Wikipedia:コミュニティ・ポータル
Flocc:Brūcendsprǣc	Category:言語別の利用者
Wikipǣdia:Fīf styde	Wikipedia:五本の柱
Wikipǣdia:Ānsund styccegewrit	Wikipedia:スタブ
Wikipǣdia:Bealu	Wikipedia:荒らし
Sung Jae-ki	成在基
Bysen:Softredirect	Template:Softredirect
Bysen:Delete	Template:即時削除
Snægel	腹足綱
Bryttisce Wealdendas	イギリス君主一覧
Flocc:Searucræft	Category:技術
Flocc:Sprǣca	Category:諸言語
Flocc:Gerīmbōc	Category:暦法
Flocc:Hāliȝdagas	Category:祝日
Help:Onbregdan nīwne tramet	Help:新規ページの作成
Flocc:Wikipǣdia	Category:ウィキペディア
Flocc:Unȝebēacniende trametas	Category:検索エンジンに収集されないページ
Flocc:Pages with broken file links	Category:壊れたファイルへのリンクがあるページ
Wikipǣdia:Manual of Style	Wikipedia:スタイルマニュアル
Bysen:-	Template:-
Bysen:Navbox	Template:Navbox
Handspearctellend	携帯機器
Flocc:Byrig on Persum	Category:イランの都市
Ichikawadaimon, Yamanashi	市川大門町
Bysen:Sēðung þurfed	Template:要出典
Bysen:!	Template:!
Flocc:Fana bysen	Category:旗のテンプレート
Bysen:((	Template:((
Bysen:!-	Template:!-
Bysen:!!	Template:!!
Bysen:=	Template:=
Bysen:Navbar	Template:Tnavbar
Bysen:Unicode	Template:Unicode
Bysen:E	Template:E
Bysen:Clear	Template:Clear
Bysen:Col-break	Template:Col-break
Bysen:Col-begin	Template:Col-begin
Bysen:Col-end	Template:Col-end
Bysen:Color	Template:Color
Bysen:Anchor	Template:Anchors
Wikipǣdia:List of articles all languages should have	Wikipedia:すべての言語版にあるべき項目の一覧
Flocc:Affrica	Category:アフリカ
Flocc:Mǣdmōnaþ	Category:7月
Flocc:Bēc	Category:書物
Flocc:Mōnþas	Category:月 (暦)
Bysen:Wikisource	Template:Wikisource
Bysen:Babel	Template:Babel
Bysen:Commons	Template:Commons
Bysen:Link GA	Template:Link GA
Bysen:Reflist	Template:Reflist
Bysen:NavPeriodicTable	Template:NavPeriodicTable
Bysen:Stycce	Template:Stub
Bysen:Brūcend de	Template:User de
Bysen:Brūcend de-1	Template:User de-1
Bysen:Brūcend el	Template:User el
Bysen:Brūcend es	Template:User es
Bysen:Brūcend de-3	Template:User de-3
Bysen:Brūcend en-3	Template:User en-3
Bysen:Brūcend el-1	Template:User el-1
Bysen:Brūcend en-1	Template:User en-1
Bysen:Brūcend en-2	Template:User en-2
Bysen:Brūcend eo-2	Template:User eo-2
Bysen:Brūcend en-4	Template:User en-4
Bysen:Brūcend fi	Template:User fi
Bysen:Brūcend en-0	Template:User en-0
Bysen:Brūcend es-4	Template:User es-4
Bysen:Brūcend en	Template:User en
Bysen:Brūcend de-2	Template:User de-2
Bysen:Brūcend es-1	Template:User es-1
Bysen:Brūcend fi-1	Template:User fi-1
Bysen:Brūcend fr-1	Template:User fr-1
Flocc:Līf	Category:生命
Bysen:Brūcend he-2	Template:User he-2
Bysen:Brūcend it-3	Template:User it-3
Bysen:User sk	Template:User sk
Bysen:Brūcend fr-2	Template:User fr-2
Bysen:Brūcend ja	Template:User ja
Bysen:Brūcend ja-1	Template:User ja-1
Bysen:Brūcend it-1	Template:User it-1
Bysen:Brūcend fr	Template:User fr
Cosco	クスコ
Flocc:Solmōnaþ	Category:2月
Flocc:1949	Category:1949年
Bysen:Stedefindend scite/Writ	Template:Location map/Info
Flocc:Ceorfdēor	Category:昆虫
Flocc:Asia	Category:アジア
Flocc:Cile	Category:チリ
Flocc:21e gēarhundred	Category:21世紀
Flocc:Lesotho	Category:レソト
Flocc:Brūcend uk	Category:User uk
Flocc:Sūðamerica	Category:南アメリカ
Flocc:Brūcend uk-M	Category:User uk-N
Flocc:1918	Category:1918年
Flocc:1954	Category:1954年
Flocc:Ǣt	Category:食品
Flocc:1946	Category:1946年
Bysen:Fs player	Template:サッカークラブチーム選手一覧 開始
Flocc:Gyldfōtþōðer	Category:サッカー
Flocc:1945	Category:1945年
Bysen:Mod	Template:Mod
Flocc:1926	Category:1926年
Bysen:NowCommons	Template:NowCommons
Bysen:Brūcend sv	Template:User sv
Flocc:1920	Category:1920年
Bysen:Brūcend it	Template:User it
Bysen:Brūcend uk	Template:User uk
Bysen:Brūcend es-2	Template:User es-2
Bysen:Infobox Football club	Template:サッカークラブ
Bysen:Welcome	Template:Welcome
Flocc:Bysen mid ūtweardum hlence	Category:外部リンク用テンプレート
Bysen:Country data Slovakia	Template:Country data Slovakia
Bysen:Country flagnavy	Template:Country flagnavy
Bysen:Country data Czech Republic	Template:Country data Czech Republic
Bysen:Country data Honduras	Template:Country data Honduras
Bysen:Sprec-ang	Template:Pronounced
Bysen:Country data Bolivia	Template:Country data Bolivia
Bysen:Country data Denemearc	Template:Country data Denmark
Bysen:Country data Īsland	Template:Country data Iceland
Bysen:Country data Poland	Template:Country data Poland
Bysen:Scire in Irlande	Template:アイルランドの地方行政区画
Bysen:Click	Template:Click
Bysen:Wikivar	Template:Wikivar2
Flocc:Brūcend fr-1	Category:User fr-1
Bysen:Country data Norway	Template:Country data Norway
Bysen:Wikiquote	Template:Wikiquote
Bysen:Country showdata	Template:Country showdata
Bysen:Country data Mexico	Template:Country data Mexico
Bysen:Affrica	Template:アフリカ
Bysen:Infobox television	Template:Infobox television
Bysen:FWB	Template:FWB
Bysen:IUCN2008	Template:IUCN2008
Bysen:Geānedu Rīcu American	Template:アメリカ合衆国の州
Bysen:Country data Australia	Template:Country data Australia
Bysen:Cyþþubox ieg	Template:Infobox Islands
Bysen:Country data France	Template:Country data France
Bysen:Ambox	Template:Ambox
Flocc:Americanisc stǣr	Category:アメリカ合衆国の歴史
Bysen:Fossil range/bar	Template:Fossil range/bar
Bysen:Rnd	Template:Rnd
Bysen:Infobox Country	Template:基礎情報 国
Bysen:Max	Template:Max
Bysen:Country data Austria	Template:Country data Austria
Bysen:Infobox Mīlitisc Gemōt	Template:Infobox Military Conflict
Bysen:Documentation/docname	Template:Documentation/docname
Bysen:Country data Finland	Template:Country data Finland
Wikipǣdia:Tutorial (Wikipedia links)	Wikipedia:チュートリアル リンク
Bysen:Country data Japan	Template:Country data Japan
Bysen:Start box	Template:S-start
Bysen:Infobox U.S. Scīr	Template:Infobox U.S. County
Bysen:Cleanup	Template:Cleanup
Flocc:Crabbas	Category:カニ
Bysen:Cite journal	Template:Cite journal
Bysen:Xpd	Template:Xpd
Bysen:Lang-ar	Template:Lang-ar
Bysen:Brūcend es-0	Template:User es-0
Bysen:Cite news	Template:Cite news
Bysen:Featured article	Template:Featured article
Bysen:Country data Russia	Template:Country data Russia
Flocc:Paris	Category:パリ
Flocc:Brūcend en-4	Category:User en-4
Flocc:Brūcend en	Category:User en
Flocc:Croatia	Category:クロアチア
Flocc:Brūcend en-2	Category:User en-2
Bysen:Infobox	Template:Infobox
Bysen:Main other	Template:Main other
Bysen:Image class names	Template:Image class names
Flocc:Francena cyningas	Category:フランス国王
Flocc:Stafas	Category:アルファベット
Bysen:Documentation/start box	Template:Documentation/start box
Bysen:Documentation/end box2	Template:Documentation/end box2
Bysen:Documentation/start box2	Template:Documentation/start box2
Bysen:Template other	Template:Template other
Bysen:Lang-da	Template:Lang-da
Bysen:Legend	Template:Legend
Bysen:Lang-got	Template:Lang-got
Flocc:Bryttisce wrīteras	Category:イギリスの著作家
Bysen:Cite web	Template:Cite web
Bysen:Country data Italy	Template:Country data Italy
Bysen:Imdb title	Template:IMDb title
Flocc:Stǣr þæs Geānedan Cynerīces	Category:ブリテン諸島の歴史
Bysen:Country data	Template:Country data
Wikipǣdia:Talk page	Wikipedia:ノートページのガイドライン
Bysen:Coor URL	Template:座標URL
Bysen:Notice	Template:Notice
Bysen:Pp-template	Template:Pp-template
Bysen:·	Template:·
Bysen:Brūcend nl-1	Template:User nl-1
Bysen:Min	Template:Min
Bysen:Wiktionarypar2	Template:Wiktionary
Bysen:Brūcend nl-2	Template:User nl-2
Bysen:Infobox Ice Hockey Player	Template:Infobox ice hockey player
Bysen:Lang-enm	Template:Lang-enm
Bysen:Country data Sweden	Template:Country data Sweden
Flocc:Byrig on Dēnum	Category:デンマークの都市
Bysen:Lang-ang	Template:Lang-ang
Flocc:Eorþtilþ	Category:農業
Bysen:Lang-sr	Template:Lang-sr
Flocc:Beorgas	Category:山
Bysen:Brūcend ru	Template:User ru
Flocc:20e gēarhundred	Category:20世紀
Bysen:IPA	Template:IPA2
Bysen:Bēc þǣre Nīwan Gecȳþnesse	Template:新約聖書
Bysen:USpresidents	Template:アメリカ合衆国大統領
Flocc:Bysen Brūcend Box Spræc	Category:バベル
Bysen:LangWithName	Template:LangWithName
Flocc:Hwæsingatūn	Category:ワシントン州
Flocc:Wihta	Category:神話・伝説の生物
Bysen:Birth date and age	Template:生年月日と年齢
Bysen:MONTHNAME	Template:MONTHNAME
Bysen:Sortname	Template:Sortname
Flocc:Gebēd	Category:祈り
Bysen:Country data Ireland	Template:Country data Ireland
Flocc:Country data templates	Category:Country dataテンプレート
Bysen:Namespace detect	Template:Namespace detect
Wikipǣdia:Gecorene gemynddagas/Solmōnaþ	Wikipedia:今日は何の日 2月
Bysen:Fmbox	Template:Fmbox
Bysen:Country data England	Template:Country data England
Flocc:19e gēarhundred	Category:19世紀
Bysen:Country data Republic of Ireland	Template:Country data Republic of Ireland
Flocc:Wrīteras	Category:作家
Bysen:Country data Switzerland	Template:Country data Switzerland
Flocc:Eormengyld	Category:大学
Bysen:Lang-cs	Template:Lang-cs
Bysen:Lang-he	Template:Lang-he
Bysen:Infobox OS	Template:Infobox OS
Bysen:Both	Template:Both
Bysen:Brūcend pt-1	Template:User pt-1
Flocc:Æfterra Gēola	Category:1月
Bysen:Lang-fa	Template:Lang-fa
Bysen:Brūcend pl	Template:User pl
Bysen:Brūcend nl	Template:User nl
Bysen:Tab	Template:Tab
Bysen:Brūcend no-2	Template:User no-2
Bysen:Start tab	Template:Start tab
Bysen:Australia	Template:オーストラリアの地方行政区画
Bysen:Rtl-lang	Template:Rtl-lang
Bysen:Tlx	Template:Tlx
Bysen:CAN	Template:CAN
Bysen:Lang-de	Template:Lang-de
Bysen:Country data Austria-Hungary	Template:Country data Austria-Hungary
Bysen:Sæternes Bōtm	Template:土星の衛星
Bysen:Lang-la	Template:Lang-la
Flocc:Wucu	Category:週
Bysen:Lang-af	Template:Lang-af
Wikipǣdia:Gecorene gemynddagas/Gēolmōnaþ	Wikipedia:今日は何の日 12月
Bysen:Infobox Album	Template:Infobox Album
Bysen:User	Template:User
Wikipǣdia:Brōðra rǣdscēawung	Wikipedia:査読依頼
Bysen:Year nav	Template:年代ナビ
Flocc:Flyhthæfenan on Fietname	Category:ベトナムの空港
Bysen:Brūcend pl-1	Template:User pl-1
Flocc:Gebed	Category:キリスト教の祈り
Flocc:Cyningas of Englalande	Category:イングランドの君主
Flocc:Bryttisce cyningas	Category:イギリスの君主
Bysen:Brūcend fr-3	Template:User fr-3
Bysen:Imdb name	Template:IMDb name
Flocc:Tunisia	Category:チュニジア
Bysen:PD	Template:PD-because
Bysen:Cyþþubox Ira tun	Template:アイルランドの都市
Bysen:Wikispell	Template:Wikinews
Bysen:Brūcend lt	Template:User lt
Bysen:Cc-by-sa-2.0	Template:Cc-by-sa-2.0
Bysen:Mbox	Template:Mbox
Bysen:Oppose	Template:反対
Bysen:Coord/link	Template:Coord/link
Bysen:Infobox UK place	Template:Infobox UK place
Bysen:Brūcend is-1	Template:User is-1
Bysen:Brūcend is-2	Template:User is-2
Bysen:Brūcend is	Template:User is
Bysen:Brūcend de-0	Template:User de-0
Bysen:Brūcend fr-5	Template:User fr-5
Bysen:Brūcend en-5	Template:User en-5
Bysen:Dagas þǣre wuce	Template:曜日
Flocc:Þēodisc burg	Category:ドイツの居住地
Bysen:Brūcend fr-0	Template:User fr-0
Flocc:Norþ Carolīna	Category:ノースカロライナ州
Flocc:Puerto Rico	Category:プエルトリコ
Bysen:ColBreak	Template:Multicol-break
Flocc:Byrig þāra Geāndena Rīca American	Category:アメリカ合衆国の都市
Bysen:Country data West Germany	Template:Country data West Germany
Bysen:Lang-ru	Template:Lang-ru
Bysen:Country data East Germany	Template:Country data East Germany
Bysen:Infobox Aircraft Begin	Template:Infobox Aircraft Begin
Bysen:Brūcend it-0	Template:User it-0
Flocc:Brittisca Here	Category:イギリス陸軍
Bysen:Disambig	Template:Aimai
Bysen:Country data Nazi Germany	Template:Country data Nazi Germany
Bysen:Selectskin	Template:Selectskin
Bysen:Doi	Template:Doi
Bysen:Country data German Empire	Template:Country data German Empire
Flocc:Coreanisc stǣr	Category:朝鮮の歴史
Bysen:Fb	Template:Fb
Bysen:Lang-grc	Template:Lang-grc
Bysen:Infobox Film	Template:Infobox Film
Bysen:Lang-en	Template:Lang-en
Bysen:Fix	Template:Fix
Bysen:Lang-id	Template:Lang-id
Bysen:Period end	Template:Period end
Bysen:Tn	Template:Tn
Bysen:Brūcend sv-2	Template:User sv-2
Bysen:Previewskin	Template:Previewskin
Bysen:Brūcend it-2	Template:User it-2
Bysen:Lang-fr	Template:Lang-fr
Bysen:Fossil range	Template:Fossil range
Bysen:Betwuxwici	Template:Wikipedia
Flocc:Byrig in þǣm Niðerlandum	Category:オランダの都市
Wikipǣdia:Gecorene gemynddagas/Hāligmōnaþ	Wikipedia:今日は何の日 9月
Bysen:Coord	Template:Coord
Bysen:Brūcend pt-3	Template:User pt-3
Flocc:Byrig on Lincolnscīre	Category:リンカンシャーのタウン
Bysen:Country data Kalmar Union	Template:Country data Kalmar Union
Bysen:Brūcend pt-2	Template:User pt-2
Flocc:Wyoming	Category:ワイオミング州
Bysen:Brūcend fr-4	Template:User fr-4
Flocc:Grēneland	Category:グリーンランド
Wikipǣdia:Gecorene gemynddagas/Winterfylleþ	Wikipedia:今日は何の日 10月
Bysen:Brūcend la-1	Template:User la-1
Bysen:Land on Europan	Template:ヨーロッパ
Flocc:User sk	Category:User sk
Flocc:Brūcend eo	Category:User eo
Flocc:Brūcend fr	Category:User fr
Flocc:Brūcend cy	Category:User cy
Flocc:Brūcend ang	Category:User ang
Flocc:Brūcend la	Category:User la
Flocc:Brūcend lt	Category:User lt
Flocc:Brūcend pt	Category:User pt
Flocc:Brūcend sv	Category:User sv
Flocc:Brūcend fr-3	Category:User fr-3
Flocc:Brūcend cy-3	Category:User cy-3
Flocc:Brūcend ang-3	Category:User ang-3
Flocc:Brūcend it-3	Category:User it-3
Flocc:Brūcend pl-3	Category:User pl-3
Flocc:Brūcend fi-1	Category:User fi-1
Flocc:Brūcend cy-1	Category:User cy-1
Flocc:Brūcend ang-1	Category:User ang-1
Flocc:Brūcend nl-1	Category:User nl-1
Flocc:Brūcend pl-1	Category:User pl-1
Flocc:Brūcend fr-4	Category:User fr-4
Flocc:Brūcend ang-4	Category:User ang-4
Flocc:Brūcend it-4	Category:User it-4
Flocc:Brūcend pl-4	Category:User pl-4
Flocc:Brūcend fr-2	Category:User fr-2
Flocc:Brūcend cy-2	Category:User cy-2
Flocc:Brūcend ang-2	Category:User ang-2
Flocc:Brūcend it-2	Category:User it-2
Flocc:Brūcend la-2	Category:User la-2
Flocc:Brūcend pl-2	Category:User pl-2
Flocc:Brūcend sv-2	Category:User sv-2
Flocc:Brūcend fr-M	Category:User fr-N
Flocc:Brūcend cy-M	Category:User cy-N
Flocc:Brūcend ang-N	Category:User ang-N
Flocc:Brūcend is-M	Category:User is-N
Flocc:Brūcend lt-N	Category:User lt-N
Flocc:Brūcend nl-M	Category:User nl-N
Flocc:Brūcend ru-M	Category:User ru-N
Flocc:Brūcend fr-5	Category:User fr-5
Flocc:Feormung	Category:娯楽
Flocc:Hēafodstōlas þæs Sericus Gārsecges	Category:オセアニアの首都
Flocc:Turcas and Caicos Īegland	Category:タークス・カイコス諸島
Flocc:Tudoryld	Category:テューダー朝
Flocc:Articles that need to be wikified	Category:Wikifyが必要な項目
Flocc:Īega	Category:島
Flocc:Sericus Garsecg	Category:太平洋
Flocc:User sk-N	Category:User sk-N
Flocc:Brūcend de	Category:User de
Flocc:Brūcend de-2	Category:User de-2
Flocc:Brūcend de-3	Category:User de-3
Flocc:Brūcend de-4	Category:User de-4
Flocc:Brūcend el	Category:User el
Flocc:Brūcend el-1	Category:User el-1
Flocc:Brūcend el-2	Category:User el-2
Flocc:Brūcend el-3	Category:User el-3
Flocc:Brūcend el-N	Category:User el-N
Flocc:Sūþgeorgia and þā Sūþsandwic Īegland	Category:サウスジョージア・サウスサンドウィッチ諸島
Flocc:Brūcend en-3	Category:User en-3
Flocc:Brūcend en-5	Category:User en-5
Flocc:Brūcend en-M	Category:User en-N
Flocc:Brūcend eo-2	Category:User eo-2
Flocc:Brūcend es	Category:User es
Flocc:Brūcend es-1	Category:User es-1
Flocc:Brūcend es-2	Category:User es-2
Flocc:Puilla	Category:プッリャ州
Flocc:Brūcend es-3	Category:User es-3
Flocc:Brūcend es-4	Category:User es-4
Flocc:Brūcend es-N	Category:User es-N
Flocc:Brūcend fi	Category:User fi
Flocc:Brūcend fi-M	Category:User fi-N
Flocc:Brūcend fo	Category:User fo
Flocc:Brūcend fo-1	Category:User fo-1
Flocc:Brūcend fo-2	Category:User fo-2
Flocc:Brūcend fo-M	Category:User fo-N
Flocc:Brūcend is	Category:User is
Flocc:Brūcend is-1	Category:User is-1
Flocc:Brūcend is-2	Category:User is-2
Flocc:Brūcend is-3	Category:User is-3
Bysen:Brūcend la-3	Template:User la-3
Flocc:Frencisc Guiana	Category:フランス領ギアナ
Ǣht	財産権
Flocc:Hebrēisc sprǣc	Category:ヘブライ語
Flocc:Brūcend pt-3	Category:User pt-3
Flocc:Bryttisc bōccræft	Category:イギリス文学
Flocc:Brūcend pl-N	Category:User pl-N
Flocc:Brūcend pt-1	Category:User pt-1
Bysen:Country data Germany	Template:Country data Germany
Bysen:Country data Geāned Cynerīce	Template:Country data United Kingdom
Wikipǣdia:Gecorene gemynddagas/Mǣdmōnaþ	Wikipedia:今日は何の日 7月
Bysen:Lang-be	Template:Lang-be
Bysen:Cite encyclopedia	Template:Cite encyclopedia
Bysen:Country data Scotland	Template:Country data Scotland
Wikipǣdia:Tutorial (Formatting)	Wikipedia:ガイドブック 執筆する
Flocc:Brūcend it	Category:User it
Flocc:Brūcend it-1	Category:User it-1
Flocc:Rīcu þāra Geāndena Rīca American	Category:アメリカ合衆国の州
Flocc:Brūcend ksh	Category:User ksh
Bysen:Mpl	Template:Mpl
Flocc:Brūcend la-1	Category:User la-1
Flocc:Brūcend la-3	Category:User la-3
Flocc:Brūcend la-N	Category:User la-N
Bysen:Cite doi	Template:Cite doi
Flocc:Pulgara cyningas	Category:ブルガリアの君主
Flocc:Fȳrbeorgas	Category:火山
Flocc:Dēorabyscīr	Category:ダービーシャー
Flocc:Byrig on Latie	Category:ラツィオ州のコムーネ
Bysen:Englaland Scīra	Template:イングランドのカウンティ
Flocc:Feohtan	Category:武術
Bysen:Country data Australasia	Template:Country data Australasia
Flocc:Blōtmōnaþ	Category:11月
Flocc:Difelinscīr	Category:ダブリン州
Wikipǣdia:Babel	Wikipedia:バベル
Flocc:Lēodweard	Category:役職
Flocc:Scopas	Category:詩人
Flocc:Hāligmōnaþ	Category:9月
Flocc:Winterfylleþ	Category:10月
Flocc:Sǣ	Category:海
Flocc:Gēolmōnaþ	Category:12月
Flocc:Wēodmōnaþ	Category:8月
Flocc:Þrimilcemōnaþ	Category:5月
Flocc:Brandenburg	Category:ブランデンブルク
Flocc:Englaland	Category:イングランド
Seringas	中国人
Flocc:Ēastermōnaþ	Category:4月
Bysen:IPA2	Template:IPA-all
Flocc:Līfnamrǣden	Category:分類学
Bysen:Lang-it	Template:Lang-it
Bysen:Coord/dms2dec	Template:Coord/dms2dec
Bysen:Country data Brazil	Template:Country data Brazil
Flocc:Gestorfen in 988	Category:988年没
Flocc:Wæter	Category:水
Flocc:Hēafod and swēor	Category:頭頸部
Flocc:Geboren in 121	Category:121年生
Wikipǣdia:MediaWiki namespace	Help:システムメッセージ
Bysen:Lang-mi	Template:Lang-mi
Flocc:180	Category:180年
Flocc:Gestorfen in 180	Category:180年没
Flocc:Drincas	Category:飲料
Flocc:Gestorfen in 2005	Category:2005年没
Flocc:450	Category:450年
Wikipǣdia:Administrators' how-to guide	Help:管理者マニュアル
Bysen:Start date and age	Template:Start date and age
Wikipǣdia:Manigsprǣclicu samodwyrcung	Wikipedia:多言語プロジェクトとしてのウィキペディア
Flocc:Geboren in 1974	Category:1974年生
Flocc:Geboren in 1899	Category:1899年生
Flocc:Oklahoma	Category:オクラホマ州
Flocc:Iapanisc sangeras	Category:日本の歌手
Flocc:Forman Þegnas	Category:首相
Flocc:Geboren in 1954	Category:1954年生
Flocc:850	Category:850年
Flocc:Geboren in 850	Category:850年生
Bysen:Cyþþubox Æþel	Template:Infobox royalty
Flocc:Hwītrussland	Category:ベラルーシ
Flocc:Alberta	Category:アルバータ州
Flocc:Ontario	Category:オンタリオ州
Flocc:Nīwe Scotland	Category:ノバスコシア州
Flocc:899	Category:899年
Flocc:Gestorfen in 899	Category:899年没
Flocc:Geocon Landscipe	Category:ユーコン準州
Flocc:Massachusetts	Category:マサチューセッツ州
Flocc:924	Category:924年
Flocc:Gestorfen in 924	Category:924年没
Bysen:Editprotected	Template:保護編集依頼
Bysen:Country data Ungerland	Template:Country data Hungary
Flocc:Land on Affrice	Category:アフリカの国
Bysen:Canadan underrīce	Template:カナダの州
Bysen:Template reference list	Template:Template reference list
Flocc:Geboren in 1239	Category:1239年生
Flocc:1249	Category:1249年
Bysen:Brūcend la-0	Template:User la-0
Flocc:1289	Category:1289年
Flocc:1305	Category:1305年
Flocc:Gestorfen in 1305	Category:1305年没
Flocc:1307	Category:1307年
Wikipǣdia:Gecorene gemynddagas/Blōtmōnaþ	Wikipedia:今日は何の日 11月
Bysen:Country data New Zealand	Template:Country data New Zealand
Bysen:Brūcend es-3	Template:User es-3
Flocc:Ēa Franclandes	Category:フランスの河川
Bysen:Incumbent succession box	Template:Incumbent succession box
Flocc:Brūcend pt-2	Category:User pt-2
Flocc:Brūcend pt-4	Category:User pt-4
Flocc:Brūcend pt-N	Category:User pt-N
Flocc:Brūcend ru	Category:User ru
Flocc:Brūcend sv-M	Category:User sv-N
Flocc:1634	Category:1634年
Flocc:1638	Category:1638年
Bysen:En icon	Template:En icon
Flocc:1719	Category:1719年
Flocc:Gestorfen in 1719	Category:1719年没
Bysen:Country data Faroe Islands	Template:Country data Faroe Islands
Flocc:121	Category:121年
Bysen:Lang	Template:Lang
Bysen:Country data Americanisc	Template:Country data United States
Flocc:Trēowu	Category:木
Bysen:Infobox ea	Template:Infobox 河川
Flocc:Geboren in 1634	Category:1634年生
Flocc:Geboren in 1638	Category:1638年生
Flocc:Geboren in 1852	Category:1852年生
Flocc:Geboren in 1892	Category:1892年生
Flocc:Geboren in 1918	Category:1918年生
Flocc:Geboren in 1945	Category:1945年生
Flocc:Geboren in 1949	Category:1949年生
Flocc:Geboren in 1981	Category:1981年生
Flocc:Geboren in 1993	Category:1993年生
Flocc:1715	Category:1715年
Wikipǣdia:Gecorene gemynddagas/Ēastermōnaþ	Wikipedia:今日は何の日 4月
Bysen:Period color	Template:Period color
Flocc:11e gēarhundred	Category:11世紀
Flocc:988	Category:988年
Flocc:10e gēarhundred	Category:10世紀
Flocc:7e gēarhundred	Category:7世紀
Flocc:1239	Category:1239年
Flocc:Gestorfen in 1307	Category:1307年没
Flocc:Corsica	Category:コルス地方公共団体
Flocc:Gestorfen in 1715	Category:1715年没
Flocc:Australisce hēafodstōlas	Category:オーストラリアの州都
Flocc:Russisce bōccræft	Category:ロシア文学
Flocc:Sardinia	Category:サルデーニャ州
Bysen:Lang-hi	Template:Lang-hi
Flocc:Florida	Category:フロリダ州
Flocc:Normandig	Category:ノルマンディー
Bysen:Convert/And0	Template:Convert/And0
Flocc:Francena caseras	Category:フランス皇帝
Bysen:Elementbox isotopes stable	Template:Elementbox isotopes stable
Flocc:Nevada	Category:ネバダ州
Flocc:Nebraska	Category:ネブラスカ州
Flocc:Norþ Dakota	Category:ノースダコタ州
Flocc:Nīwe Eoforwīc	Category:ニューヨーク州
Flocc:Rhode Īeg	Category:ロードアイランド州
Flocc:Louisiāna	Category:ルイジアナ州
Flocc:Marianland	Category:メリーランド州
Flocc:Maine	Category:メイン州
Flocc:Minnesota	Category:ミネソタ州
Flocc:Michigan	Category:ミシガン州
Flocc:Mississippi	Category:ミシシッピ州
Flocc:Missouri	Category:ミズーリ州
Flocc:Vermont	Category:バーモント州
Flocc:Virginia	Category:バージニア州
Flocc:Idaho	Category:アイダホ州
Flocc:Iowa	Category:アイオワ州
Flocc:Arkansas	Category:アーカンソー州
Flocc:Alaska	Category:アラスカ州
Flocc:Arizona	Category:アリゾナ州
Flocc:Alabama	Category:アラバマ州
Flocc:Ohio	Category:オハイオ州
Flocc:Westvirginia	Category:ウェストバージニア州
Flocc:Wisconsin	Category:ウィスコンシン州
Flocc:Indiāna	Category:インディアナ州
Flocc:Illinois	Category:イリノイ州
Flocc:Kansas	Category:カンザス州
Flocc:California	Category:カリフォルニア州
Flocc:Kentucky	Category:ケンタッキー州
Flocc:Connecticut	Category:コネチカット州
Flocc:Colorado	Category:コロラド州
Flocc:Texas	Category:テキサス州
Flocc:Hawaii	Category:ハワイ州
Bysen:Fs end	Template:サッカークラブチーム選手一覧 終了
Bysen:WPMILHIST Infobox style	Template:WPMILHIST Infobox style
Flocc:Ōðru Woruldgūþ	Category:第二次世界大戦
Flocc:Nīwes Sǣlandes byrig	Category:ニュージーランドの都市
Bysen:Fossil range/marker	Template:Fossil range/marker
Flocc:Hundas	Category:犬
Flocc:Cattas	Category:ネコ科
Flocc:Russisce wrīteras	Category:ロシアの著作家
Bysen:•	Template:•
Flocc:1066	Category:1066年
Flocc:Gestorfen in 1066	Category:1066年没
Flocc:Angola	Category:アンゴラ
Flocc:Botswana	Category:ボツワナ
Flocc:Elpendbānrima	Category:コートジボワール
Flocc:Æriþrea	Category:エリトリア
Flocc:Gabon	Category:ガボン
Flocc:Gambia	Category:ガンビア
Flocc:Guinea	Category:ギニア
Flocc:Camerun	Category:カメルーン
Flocc:Grēnenæs Īega	Category:カーボベルデ
Flocc:Cenia	Category:ケニア
Flocc:Liberia	Category:リベリア
Flocc:Libia	Category:リビア
Flocc:Morocco	Category:モロッコ
Flocc:Mauritania	Category:モーリタニア
Flocc:1451	Category:1451年
Flocc:Namibia	Category:ナミビア
Flocc:Caribisc Sǣ	Category:カリブ海
Flocc:Delaware	Category:デラウェア州
Flocc:Georgia (America)	Category:ジョージア州
Flocc:Montāna	Category:モンタナ州
Flocc:Eall gewritu þe hlȳtrunge þurfaþ	Category:整理が必要な項目
Bysen:Merge	Template:統合提案
Flocc:Tennessee	Category:テネシー州
Flocc:Baden-Wyrttemberg	Category:バーデン＝ヴュルテンベルク
Flocc:1852	Category:1852年
Flocc:1892	Category:1892年
Flocc:Gestorfen in 1926	Category:1926年没
Flocc:1973	Category:1973年
Flocc:Gestorfen in 1973	Category:1973年没
Flocc:1975	Category:1975年
Flocc:1981	Category:1981年
Flocc:Gestorfen in 1982	Category:1982年没
Flocc:2004	Category:2004年
Flocc:Gestorfen in 2004	Category:2004年没
Flocc:2005	Category:2005年
Flocc:2006	Category:2006年
Flocc:2007	Category:2007年
Flocc:2008	Category:2008年
Flocc:Ēa	Category:河川
Bysen:Brūcend el-2	Template:User el-2
Bysen:Brūcend fo-1	Template:User fo-1
Bysen:Brūcend la-2	Template:User la-2
Bysen:Brūcend no-1	Template:User no-1
Bysen:Brūcend pl-2	Template:User pl-2
Bysen:Brūcend pt	Template:User pt
Flocc:Sūþsudan	Category:南スーダン
Flocc:Cead	Category:チャド
Flocc:Uganda	Category:ウガンダ
Flocc:Rōmānisce Cāseras	Category:ローマ皇帝
Flocc:Brūcend nl	Category:User nl
Flocc:Sūþhjaltland	Category:サウス・シェトランド諸島
Flocc:Brūcend no-1	Category:User no-1
Flocc:Brūcend no-2	Category:User no-2
Flocc:Brūcend no	Category:User no
Flocc:Niðerlanda Cyningas	Category:オランダ国王
Flocc:Norrena cyningas	Category:ノルウェーの君主
Flocc:Swēona cyningas	Category:スウェーデンの君主
Flocc:Armenia	Category:アルメニア
Flocc:Bahrain	Category:バーレーン
Flocc:Mennisc bodiȝlār	Category:人体解剖学
Flocc:Feorrsīen	Category:テレビ
Flocc:Angelcirice	Category:イングランド国教会
Flocc:14e gēarhundred	Category:14世紀
Flocc:13e gēarhundred	Category:13世紀
Flocc:2e gēarhundred	Category:2世紀
Flocc:4e gēarhundred	Category:4世紀
Flocc:5e gēarhundred	Category:5世紀
Flocc:18e gēarhundred	Category:18世紀
Flocc:6e gēarhundred	Category:6世紀
Flocc:Arabea	Category:アラビア半島
Flocc:Nīwesǣlendisce wrīteras	Category:ニュージーランドの著作家
Flocc:Seaxland-Anhalt	Category:ザクセン＝アンハルト
Flocc:Niðerseaxland	Category:ニーダーザクセン
Flocc:Russe	Category:ロシアの人物
Flocc:Unƿǣre lēode	Category:架空の人物
Flocc:Crēcisc ūtwitan	Category:ギリシャの哲学者
Flocc:Bægwaraland	Category:バイエルン
Flocc:Superman	Category:スーパーマン
Flocc:Ēage	Category:目
Flocc:Corn	Category:穀物
Flocc:Nīweoforwīcburg	Category:ニューヨーク市
Flocc:Norþfolc	Category:ノーフォーク
Flocc:Norþhāmtūnescīr	Category:ノーサンプトンシャー
Flocc:NBC	Category:NBC
Flocc:Gamen	Category:レクリエーション
Flocc:Snotingahāmscīr	Category:ノッティンガムシャー
Flocc:15e gēarhundred	Category:15世紀
Flocc:Georgia (land)	Category:グルジア
Flocc:Cambodia	Category:カンボジア
Flocc:Americanisc sangeras	Category:アメリカ合衆国の歌手
Flocc:Bryttisce scopas	Category:イギリスの詩人
Flocc:Stǣr þæs Cynerices Greatbryttenes	Category:イギリスの歴史
Flocc:Iamaica	Category:ジャマイカ
Bysen:Lang-hy	Template:Lang-hy
Flocc:Scotta cyningas	Category:スコットランドの君主
Flocc:Bryttiscan Fæmne Īegland	Category:イギリス領ヴァージン諸島
Flocc:Corēa	Category:朝鮮
Flocc:Burma	Category:ミャンマー
Flocc:Taprabane	Category:スリランカ
Bysen:Col-3	Template:Col-3
Flocc:Tacgicastan	Category:タジキスタン
Flocc:Ēasttimor	Category:東ティモール
Flocc:Turcmenistan	Category:トルクメニスタン
Flocc:Usbecastan	Category:ウズベキスタン
Flocc:Geānedan Arabiscan Bregorīce	Category:アラブ首長国連邦
Flocc:9e gēarhundred	Category:9世紀
Flocc:Sofiet Gesamnung	Category:ソビエト社会主義共和国連邦
Bysen:Bēc þǣre Ealdan Gecȳþnesse	Template:旧約聖書
Wikipǣdia:Sēðung þurfed	Wikipedia:「要出典」をクリックされた方へ
Bysen:Brūcend de-4	Template:User de-4
Flocc:Searwa stycce	Category:工学関連のスタブ
Flocc:Wēalas	Category:ウェールズ
Flocc:Foresittendas þāra Geāndena Rīca American	Category:アメリカ合衆国の大統領
Flocc:Europisc stǣr	Category:ヨーロッパ史
Flocc:Hascemisce Cynerīce þæs Iordanes	Category:ヨルダン
Flocc:Bosnia and Herzegovina	Category:ボスニア・ヘルツェゴビナ
Flocc:Norþweg	Category:ノルウェー
Flocc:Barbados	Category:バルバドス
Flocc:Paraguay	Category:パラグアイ
Flocc:Ficgiege	Category:フィジー
Flocc:Lēohtenstān	Category:リヒテンシュタイン
Flocc:Uruguay	Category:ウルグアイ
Flocc:Andorra	Category:アンドラ
Flocc:Serbia	Category:セルビア
Flocc:Ecuador	Category:エクアドル
Flocc:Peru	Category:ペルー
Flocc:Bolifia	Category:ボリビア
Flocc:Albania	Category:アルバニア
Flocc:Monaco	Category:モナコ
Flocc:Land on Norðamerican	Category:北アメリカの国
Flocc:Fiscas	Category:魚類
Flocc:Mūþ	Category:口
Flocc:Wyrta	Category:野菜
Flocc:Ofet	Category:果物
Flocc:Nīwu Gecȳþnes	Category:新約聖書
Flocc:Musea	Category:博物館
Flocc:Rímcræft	Category:関数
Flocc:Landscipas Swēolandes	Category:スウェーデンの県
Flocc:Stǣrlice Sprǣccræft	Category:歴史言語学
Flocc:Dūnholmscīr	Category:ダラム (カウンティ)
Flocc:Manga	Category:日本の漫画
Flocc:Eoferwicscīr	Category:ヨークシャー
Flocc:Oferhæleðas	Category:スーパーヒーロー
Flocc:Calpis	Category:ジブラルタル
Flocc:Beadwe	Category:戦闘
Flocc:Weorcendebyrdnessa	Category:オペレーティングシステム
Flocc:Mexicorīce	Category:メキシコの州
Flocc:Hidalgo Rīce	Category:イダルゴ州
Flocc:Hetwaraland	Category:ヘッセン
Flocc:Canadan underrīce and landscipas	Category:カナダの州
Flocc:Lunden	Category:ロンドン
Flocc:Lincolnscīr	Category:リンカンシャー
Bysen:Incubator	Template:Incubator
Flocc:Dæg þæs gēares	Category:日付
Flocc:Wikimedian geweorc	Category:ウィキメディア財団
Flocc:Byrig on Buccingahamscīre	Category:バッキンガムシャーのタウン
Flocc:Wiltūnscīr	Category:ウィルトシャー
Flocc:Wigreceastrescīr	Category:ウスターシャー
Flocc:Americanisce Ingefeoht	Category:南北戦争
Flocc:Byrig on Tuscanie	Category:トスカーナ州のコムーネ
Flocc:Wyrt	Category:ハーブ
Flocc:Dēor	Category:動物
Flocc:Hweorfdēor	Category:脊椎動物
Flocc:Pitcearnīega	Category:ピトケアン諸島
Flocc:Cægman Īegland	Category:ケイマン諸島
Flocc:Folcland Īegland	Category:フォークランド諸島
Flocc:Land on Sūðamerican	Category:南アメリカの国
Flocc:Colombia	Category:コロンビア
Flocc:Anime	Category:日本のアニメ作品
Flocc:Oxnafordscīr	Category:オックスフォードシャー
Flocc:Hociȝ	Category:ホッケー
Flocc:Heortfordscīr	Category:ハートフォードシャー
Flocc:Sicilia	Category:シチリア州
Flocc:Grantabrycgscīr	Category:ケンブリッジシャー
Flocc:Þēodacynewīse	Category:イギリス連邦
Flocc:Līþ	Category:酒
Flocc:Spearctellas	Category:ゲーム機
Flocc:Englisc scīr	Category:イングランドの州
Flocc:Æþelingas	Category:プリンス
Flocc:Ceasterscīr	Category:チェシャー
Flocc:Sūþrige	Category:サリー (イングランド)
Flocc:Defenascīr	Category:デヴォン州
Flocc:Se Hlāford þāra Hringa	Category:指輪物語
Flocc:Rōmāniscu Folclār	Category:ローマ神話
Flocc:Beadanfordscīr	Category:ベッドフォードシャー
Flocc:Bergan	Category:ベリー
Flocc:Bēor	Category:ビール
Flocc:Sang	Category:歌
Flocc:Hēafodstōlas	Category:首都
Flocc:Byrig on Paraguay	Category:パラグアイの都市
Flocc:Stōwlice hēafodstōlas Canadan	Category:カナダの都市
Flocc:Ēastseaxe	Category:エセックス
Flocc:Middelasia	Category:中央アジア
Flocc:Indisca Underworulddǣl	Category:南アジア
Flocc:NFL	Category:NFL
Flocc:Tuscania	Category:トスカーナ州
Flocc:Latium	Category:ラツィオ州
Flocc:Lonceasterscīr	Category:ランカシャー
Flocc:Hāmtūnescīr	Category:ハンプシャー
Flocc:Brūcend pl	Category:User pl
Flocc:Gleawcesterscīr	Category:グロスタシャー
Flocc:Rōmānisca sprǣca	Category:ロマンス諸語
Flocc:Fōr	Category:交通
Flocc:Sund	Category:水泳
Flocc:Hēapplegan	Category:団体競技
Flocc:Toys	Category:玩具
Flocc:Hīwscipe	Category:家族
Flocc:Cornweall	Category:コーンウォール
Flocc:Cīna Caseras	Category:中国の皇帝
Flocc:Tūnas on Sūþfolce	Category:サフォークのヴィレッジ
Flocc:Antarctica	Category:南極
Flocc:Norðamerica	Category:北アメリカ
Flocc:Sangestre	Category:歌手
Flocc:Euxinus	Category:黒海
Flocc:Meras	Category:湖
Bysen:Elementbox isotopes decay2	Template:Elementbox isotopes decay2
Bysen:Flagcountry	Template:Flagcountry
Bysen:Country data Weimar Republic	Template:Country data Weimar Republic
Flocc:Sweartbeorg	Category:モンテネグロ
Flocc:Indisc Gārsecg	Category:インド洋
Flocc:Wægnas	Category:自動車
Bysen:Brūcend af-2	Template:User af-2
Wealhmoru	ニンジン
Flocc:Byrig on Francum	Category:フランスの居住地
Flocc:Byrig on Fietname	Category:ベトナムの都市
Flocc:Byrig on þǣm Ucrægnan	Category:ウクライナの都市
Flocc:Byrig on Eotolwarum	Category:イタリアの都市
Flocc:Beorgas on Brettum	Category:イギリスの山
Flocc:Scotland	Category:スコットランド
Flocc:Spēonisc bōccræft	Category:スペイン文学
Flocc:Hēafodstōlas in Europe	Category:ヨーロッパの首都
Flocc:Hēafodstōlas in Asie	Category:アジアの首都
Flocc:Norðerne Īrland	Category:北アイルランド
Flocc:Nīwesǣlendisc bōccræft	Category:ニュージーランド文学
Flocc:Īrisc bōccræft	Category:アイルランド文学
Bysen:CompactTOC	Template:TOC
Flocc:Geāsparedu līc	Category:ミイラ
Bysen:Dmbox	Template:Dmbox
Flocc:Byrig on Cile	Category:チリの都市
Flocc:Wikipedia tutorial	Category:Wikipedia ガイドブック
Bysen:Wikia	Template:Wikia
Flocc:World Trade Center	Category:ワールドトレードセンター
Flocc:Loidis	Category:リーズ
Flocc:Australisc Hēafodburg Landscipe	Category:オーストラリア首都特別地域
Bysen:Country data Cænada	Template:Country data Canada
Bysen:Col-begin-small	Template:Col-begin-small
Bysen:Color box	Template:Color box
Flocc:Angleseg	Category:アングルシー島
Bysen:Coord/dec2dms	Template:Coord/dec2dms
Bysen:Coord/prec dec	Template:Coord/prec dec
Bysen:Country data Barbados	Template:Country data Barbados
Bysen:Country data Empire of Japan	Template:Country data Empire of Japan
Bysen:Country data Free French	Template:Country data Free French
Bysen:Country data Martinique	Template:Country data Martinique
Bysen:Country data Åland Islands	Template:Country data Åland Islands
Bysen:Lang-pl	Template:Lang-pl
Bysen:Brūcend pl-3	Template:User pl-3
Bysen:Brūcend pl-4	Template:User pl-4
Flocc:Flæmingaland	Category:フランドル
Flocc:Ēastengla cyningas	Category:イースト・アングリアの君主
Flocc:Miercna cyningas	Category:マーシアの君主
Flocc:Westseaxna cyningas	Category:ウェセックスの君主
Trojany (Masovian Voivodship)	トロヤニ (マゾフシェ県)
Flocc:Willelm Shakespeare	Category:シェイクスピア
Flocc:Land on Asie	Category:アジアの国
Flocc:Windows gamen	Category:Windows用ゲームソフト
Bysen:Landskap	Template:スウェーデンの地方
Flocc:Wicibōceras in þǣm Geānlǣhtum Rīcum American	Category:アメリカ合衆国在住のウィキペディアン
Bysen:Plegere-stycce	Template:Actor-stub
Bysen:Nigerie Rīce	Template:ナイジェリアの州
Flocc:Wikipedia protected edit requests	Category:保護編集依頼中の記事
Bysen:Brūcend la	Template:User la
Bysen:Brūcend it-4	Template:User it-4
Bysen:Brūcend is-3	Template:User is-3
Bysen:Brūcend fo	Template:User fo
Bysen:Brūcend el-3	Template:User el-3
Bysen:Brūcend cy-3	Template:User cy-3
Bysen:Brūcend cy-2	Template:User cy-2
Bysen:Brūcend cy-1	Template:User cy-1
Bysen:Brūcend cy	Template:User cy
Bysen:Brūcend ang	Template:User ang
Bysen:Lang-ty	Template:Lang-ty
Bysen:Lang-ti	Template:Lang-ti
Bysen:Lang-sq	Template:Lang-sq
Bysen:Lang-ro	Template:Lang-ro
Bysen:Lang-kl	Template:Lang-kl
Bysen:IPAc-en	Template:IPAc-en
Bysen:Lang-es	Template:Lang-es
Bysen:Lang-cy	Template:Lang-cy
Bysen:Lang-bn	Template:Lang-bn
Flocc:Westmidlandscīr	Category:ウェスト・ミッドランズ
Flocc:West Loðene	Category:ウェスト・ロージアン
Bysen:Country data Ryūkyū Kingdom	Template:Country data Ryūkyū Kingdom
Flocc:Wæringscīr	Category:ウォリックシャー
Wikipǣdia:Gecorene gemynddagas/Wēodmōnaþ	Wikipedia:今日は何の日 8月
Flocc:Seolh	Category:アシカ亜目
Flocc:Engla cyningas	Category:アングロ・サクソンの君主
Flocc:Quebec	Category:ケベック州
Flocc:Ostsǣ	Category:バルト海
Flocc:Bysen Brūcend Box	Category:ウィキペディアのユーザーボックス
Flocc:Clackmannanscīr	Category:クラックマナンシャー
Flocc:Gūþ	Category:戦争
Flocc:Ēastgermanisca sprǣca	Category:東ゲルマン語群
Flocc:Ēast Loðene	Category:イースト・ロージアン
Flocc:Fermanagh	Category:ファーマナ州
Flocc:Tirowen	Category:ティロン州
Flocc:Fif Scīr	Category:ファイフ
Flocc:Lēoðlic scātung	Category:フィギュアスケート
Bysen:Lang-zh	Template:Lang-zh
Bysen:Lang-mn	Template:Lang-mn
Bysen:Lang-fi	Template:Lang-fi
Bysen:Lang-sv	Template:Lang-sv
Flocc:Frencisc Polynesia	Category:フランス領ポリネシア
Flocc:Germanisca sprǣca	Category:ゲルマン語派
Bysen:Precision1	Template:Precision1
Bysen:Precision/tz	Template:Precision/tz
Bysen:Precision/tz/1	Template:Precision/tz/1
Flocc:Herefordscīr	Category:ヘレフォードシャー
Flocc:Rōmānisc stǣr	Category:ローマの歴史
Flocc:Huntandunscīr	Category:ハンティンドンシャー
Flocc:Īshocig	Category:アイスホッケー
Wikipǣdia:Edit conflicts	Help:編集の競合
Flocc:Īrland	Category:アイルランド島
Flocc:Constantinopolis	Category:イスタンブル
Wikipǣdia:Page history	Help:履歴
Flocc:Mintan	Category:シソ科
Flocc:Bysen Sprǣc	Category:言語ラベル
Flocc:Lægreceastrescīr	Category:レスターシャー
Flocc:Langbeardnaland	Category:ロンバルディア州
Wikipǣdia:Snellbred	Help:早見表
Wikipǣdia:Show preview	Help:プレビューを表示
Flocc:Midloðene	Category:ミッドロージアン
Flocc:Rōm	Category:ローマ
Flocc:Norþhymbraland	Category:ノーサンバーランド
Flocc:Rūncræft	Category:ルーン文字
Flocc:Roteland	Category:ラトランド
Flocc:Sancte Elene Īeg, Upstigeīeg and Tristan da Cunha	Category:セントヘレナ・アセンションおよびトリスタンダクーニャ
Flocc:Hjaltland	Category:シェトランド諸島
Flocc:Scipu	Category:船
Flocc:Scrobbesbyrigscīr	Category:シュロップシャー
Flocc:Byrig on Gleawcesterscīre	Category:グロスタシャーのタウン
Flocc:NHL	Category:NHL
Flocc:Byrig on Nīwum Hāmtūnscīre	Category:ニューハンプシャー州の都市
Flocc:Byrig on Dūnholmscīre	Category:ダラム (カウンティ)のタウン
Flocc:Byrig on Dēorabyscīre	Category:ダービーシャーのタウン
Flocc:Byrig on Defenum	Category:デヴォンのタウン
Flocc:Byrig on Lonceasterscīre	Category:ランカシャーのタウン
Flocc:Americanisc fōtball	Category:アメリカンフットボール
Flocc:Stæffordscīr	Category:スタッフォードシャー
Flocc:Bermuda	Category:バミューダ諸島
Flocc:Bearrucscīr	Category:バークシャー
Flocc:Byrig on Bearrucscīre	Category:バークシャーのタウン
Flocc:Norþgermanisca sprǣca	Category:北ゲルマン語群
Flocc:São Paulo	Category:サンパウロ
Flocc:Ucrægnisc sprǣc	Category:ウクライナ語
Flocc:Westgermanisca sprǣca	Category:西ゲルマン語群
Flocc:Byrig on Sūþrigum	Category:サリーのタウン
Flocc:Byrig on Grantabrycgscīre	Category:ケンブリッジシャーのタウン
Flocc:Byrig on Cornweallum	Category:コーンウォールのタウン
Flocc:Byrig on Cent	Category:ケントのタウン
Flocc:Byrig on Oxnafordscīre	Category:オックスフォードシャーのタウン
Flocc:Byrig on Westmidlandscīre	Category:ウェスト・ミッドランズのタウン
Flocc:Dȳfung	Category:潜水
Flocc:Byrig on Scrobbesbyrigscīre	Category:シュロップシャーのタウン
Flocc:Byrig on Stæffordscīre	Category:スタッフォードシャーのタウン
Flocc:Ardmachusscīr	Category:アーマー州
Flocc:Byrig on Wigreceastrescīre	Category:ウスターシャーのタウン
Flocc:Byrig on Wæringscīre	Category:ウォリックシャーのタウン
Flocc:Wichlawscīr	Category:ウィックロー州
Flocc:Byrig on Wiltūnscīre	Category:ウィルトシャーのタウン
Flocc:Antrimscīr	Category:アントリム州
Flocc:Mageoscīr	Category:メイヨー州
Flocc:Celtisc sprǣc	Category:ケルト語派
Flocc:Fōtþōðer	Category:フットボール
Flocc:Bryttisce Scīre	Category:イギリスのカウンティ
Flocc:Wendelsǣs īega	Category:地中海の島
Flocc:Orcanege	Category:オークニー諸島
Flocc:Byrig on Ēastseaxum	Category:イースト・サセックスのタウン
Flocc:Gyldfōtþōðres styccelicu gewritu	Category:サッカーに関するスタブ
Flocc:Byrig	Category:都市
Flocc:Brūcend fo-3	Category:User fo-3
Flocc:Englisc sprǣc	Category:古英語
Flocc:Personal life	Category:生活
Flocc:WPS	Category:アメリカ女子プロサッカー
Flocc:Nīwbyrig on Brettum	Category:イギリスのニュータウン
Flocc:Byrig on Nīwum Eoforwīce	Category:ニューヨーク州の都市
Flocc:Byrig on Brettum	Category:イギリスの都市
Bysen:Coord/display/title	Template:Coord/display/title
Bysen:Year in other calendars	Template:Year in other calendars
Bysen:Ombox/core	Template:Ombox/core
Flocc:Brūcend en-1	Category:User en-1
Flocc:Geboren in 1946	Category:1946年生
Flocc:Brūcend de-1	Category:User de-1
Flocc:Geboren in 1920	Category:1920年生
Flocc:Germanisc mægþ	Category:ゲルマン
Flocc:Īrisce Scīre	Category:アイルランドのカウンティ
Flocc:Skrælingcynn	Category:アメリカ州の先住民族
Flocc:Byrig on Cumbralande	Category:カンブリアのタウン
Flocc:Byrig on Heortfordscīre	Category:ハートフォードシャーのタウン
Bysen:Virginia	Template:バージニア州
Bysen:Bo	Template:Bo
Bysen:Kylie Minogue	Template:カイリー・ミノーグ
Wikipǣdia:Gecorene gemynddagas/Sēremōnaþ	Wikipedia:今日は何の日 6月
Wikipǣdia:Gecorene gemynddagas/Æfterra Gēola	Wikipedia:今日は何の日 1月
Wikipǣdia:Gecorene gemynddagas/Hrēþmōnaþ	Wikipedia:今日は何の日 3月
Wikipǣdia:Gecorene gemynddagas/Þrimilcemōnaþ	Wikipedia:今日は何の日 5月
Wikipǣdia:Tutorial (Talk pages)	Wikipedia:チュートリアル ノートページ
Wikipǣdia:Tutorial (Related site links)	Wikipedia:チュートリアル 注意点
Bysen:Start date	Template:Start date
Wikipǣdia:New User Welcome	Wikipedia:案内文の文例
Bysen:Brūcend ang-2	Template:User ang-2
Bysen:Brūcend ang-1	Template:User ang-1
Bysen:Brūcend ang-3	Template:User ang-3
Bysen:Elementbox isotopes decay	Template:Elementbox isotopes decay
Bysen:Italy-hist-stub	Template:Italia-storia-stub
Bysen:Lang-kw	Template:Lang-kw
Bysen:Infobox/row	Template:Infobox/row
Wikipǣdia:Tutorial (Wrap-up and more info)	Wikipedia:チュートリアル まとめ
Bysen:Lang-sco	Template:Lang-sco
Wikipǣdia:Tutorial (Registration)	Wikipedia:チュートリアル アカウント登録
Bysen:Coor title dm	Template:Coor title dm
Wikipǣdia:Ádihtoðes FAQ	Wikipedia:FAQ 編集
Wikipǣdia:Lārcwide/TabsHeader	Wikipedia:チュートリアル/タブヘッダ
Swǣfe	シュヴァーベン
Wikipǣdia:Protection log	Wikipedia:Protection log
Wikipǣdia:Block log	Wikipedia:Block log
Wikipǣdia:Deletion log	Wikipedia:削除記録
Hindberge	ヨーロッパキイチゴ
Bysen:End	Template:End
Bysen:Syndrigebocstafas	Template:特殊文字
Bysen:Xpda	Template:Xpda
Wikipǣdia:Upload log	Wikipedia:Upload log
Bysen:Country flagairforce	Template:Country flagairforce
Wikipǣdia:How to rename (move) a page	Help:ページの移動
Lorde	ロード (歌手)
Georgius Grantanbrycge Æþeling	ジョージ・オブ・ケンブリッジ
Bysen:Lang-osx	Template:Lang-osx
Flocc:Wæstmas	Category:農作物
Bysen:Country flaglink	Template:Country flaglink
Wikipǣdia:Administrators' reading list	Wikipedia:管理者が心得るべき文書の一覧
Wikipǣdia:Lārcwide/Tabs	Wikipedia:チュートリアル/タブ
Wikipǣdia:Lārcwide/Tab1	Wikipedia:チュートリアル/タブ1
Wikipǣdia:Lārcwide/Tab2	Wikipedia:チュートリアル/タブ2
Wikipǣdia:Lārcwide/TabsBottom	Wikipedia:チュートリアル/タブ下部
Module:Yesno	モジュール:Yesno
Module:Category handler	モジュール:Category handler
Module:Arguments	モジュール:Arguments
Syndrig:RecentChanges	特別:最近の更新
Flocc:Byrig on Langbeardum	Category:ロンバルディア州のコムーネ
Module:Namespace detect	モジュール:Namespace detect
Flocc:Gestorfen in 1975	Category:1975年没
Module:Namespace detect/data	モジュール:Namespace detect/data
Module:Namespace detect/config	モジュール:Namespace detect/config
Gōs	雁
