ܐܦܪܝܩܐ	アフリカ
ܝܦܢ	日本
ܐܡܪܝܩܐ ܬܝܡܢܝܬܐ	南アメリカ
ܢܘܪܒܝܓ	ノルウェー
ܩܘܛܢܝܘܬܐ ܕܐܝܪܠܢܕ	アイルランド
ܡܓܪ	ハンガリー
ܐܣܦܢܝܐ	スペイン
ܐܘܚܕܢܐ ܡܚܝܕܐ	アメリカ合衆国
ܒܠܓܝܩܐ	ベルギー
ܠܘܟܣܡܒܘܪܓ	ルクセンブルク
ܬܒܝܠ	宇宙
ܐܪܥܐ	地球
ܡܘܬܐ	死
ܒܪ ܐܢܫܐ	ヒト
ܓܘܪܓ ܘܐܫܝܢܓܛܘܢ	ジョージ・ワシントン
ܦܝܢܠܢܕ	フィンランド
ܣܘܝܕ	スウェーデン
ܕܐܢܡܐܪܩ	デンマーク
ܦܘܠܢܕ	ポーランド
ܠܬܘܢܝܐ	リトアニア
ܐܝܛܠܝܐ	イタリア
ܣܘܝܣܪܐ	スイス
ܢܡܣܐ	オーストリア
ܝܘܢ	ギリシャ
ܛܘܪܩܝܐ	トルコ
ܦܘܪܛܘܓܠ	ポルトガル
ܐܘܪܘܦܐ (ܝܒܫܬܐ)	ヨーロッパ
ܐܣܝܐ (ܝܒܫܬܐ)	アジア
ܐܡܪܝܩܐ ܓܪܒܝܝܬܐ	北アメリカ
ܐܢܛܐܪܩܛܝܩܐ	南極大陸
ܘܝܩܝܦܕܝܐ	ウィキペディア
ܗܘܠܢܕܐ	オランダ
ܢܝܘ ܝܘܪܩ (ܡܕܝܢܬܐ)	ニューヨーク
ܘܐܫܢܓܛܘܢ (ܐܪܫܟܝܬܐ)	ワシントンD.C.
ܒܪܠܝܢ	ベルリン
ܚܫܘܒܐ (ܡܐܟܢܐ)	コンピュータ
ܒܪܢ	ベルン
ܬܣܝܪܝܟ	チューリッヒ
ܐܢܛܪܢܛ	インターネット
ܒܪܐܩ ܐܘܒܐܡܐ	バラク・オバマ
ܠܘܢܕܘܢ	ロンドン
ܐܠܟܣܢܕܪܝܐ	アレクサンドリア
ܚܙܘܪܐ	リンゴ
ܦܐܪܝܣ	パリ
ܡܟܣܝܩܘ	メキシコ
ܐܘܩܝܢܘܣ ܐܛܠܢܛܝܐ	大西洋
ܐܘܩܝܢܘܣ ܫܝܢܝܐ	太平洋
ܒܘܣܛܘܢ	ボストン
ܬܪܝܢܒܫܒܐ	月曜日
ܟܢܘܢ ܒ	1月
ܫܒܛ	2月
ܐܕܪ	3月
ܟܘܫ	エチオピア
ܢܝܣܢ	4月
ܐܝܪ	5月
ܚܙܝܪܢ	6月
ܬܡܘܙ	7月
ܐܒ	8月
ܐܝܠܘܠ	9月
ܬܫܪܝܢ ܐ	10月
ܬܫܪܝܢ ܒ	11月
ܟܢܘܢ ܐ	12月
ܬܠܬܒܫܒܐ	火曜日
ܐܪܒܥܒܫܒܐ	水曜日
ܚܡܫܒܫܒܐ	木曜日
ܥܪܘܒܬܐ	金曜日
ܫܒܬܐ (ܙܒܢܐ)	土曜日
ܚܕܒܫܒܐ	日曜日
ܐܪܝܐ	ライオン
ܦܪܢܣܐ	フランス
ܟܠܒܐ	イヌ
ܡܠܟܘܬܐ ܡܚܝܕܬܐ	イギリス
ܩܛܐ	ネコ
ܩܘܛܢܝܘܬܐ ܥܡܡܝܬܐ ܕܨܝܢ	中華人民共和国
ܠܫܢܐ ܦܪܢܣܝܐ	フランス語
ܒܪܐܙܝܠ	ブラジル
ܪܘܣܝܐ	ロシア
ܝܡܐ	海
ܝܡܐ ܐܘܟܡܐ	黒海
Π	Π
ܐܠܒܐܡܐ	アラバマ州
ܣܐܘ ܦܐܘܠܘ	サンパウロ
ܩܝܒܩ (ܗܘܦܪܟܝܐ)	ケベック州
ܓܪܡܢ	ドイツ
ܒܠܐܪܘܣ	ベラルーシ
ܠܫܢܐ ܓܪܡܢܝܐ	ドイツ語
ܐܠܗܐ	神
ܐܣܛܘܢܝܐ	エストニア
ܛܝܣܬܐ	飛行機
ܩܪܒܐ	戦争
1 (ܡܢܝܢܐ)	1
2 (ܡܢܝܢܐ)	2
3 (ܡܢܝܢܐ)	3
4 (ܡܢܝܢܐ)	4
5 (ܡܢܝܢܐ)	5
ܠܐܛܒܝܐ	ラトビア
ܐܘܩܪܐܝܢܐ	ウクライナ
ܬܫܝܟ	チェコ
ܣܠܘܒܩܝܐ	スロバキア
ܣܠܘܒܢܝܐ	スロベニア
ܡܘܠܕܘܒܐ	モルドバ
ܪܘܡܢܝܐ	ルーマニア
ܒܘܠܓܐܪܝܐ	ブルガリア
ܪܗܘܡܐ (ܡܕܝܢܬܐ)	ローマ
ܩܘܛܢܝܘܬܐ ܕܡܩܕܘܢܝܐ	マケドニア共和国
ܐܠܒܢܝܐ	アルバニア
ܩܪܘܐܛܝܐ	クロアチア
ܒܘܣܢܐ ܘܗܪܬܣܓܘܒܝܢܐ	ボスニア・ヘルツェゴビナ
ܐܙܪܒܝܓܐܢ	アゼルバイジャン
ܐܢܕܘܪܐ	アンドラ
ܩܘܦܪܘܣ	キプロス
ܓܘܪܓܝܐ (ܐܬܪܐ)	グルジア
ܩܙܩܣܛܐܢ	カザフスタン
ܡܝܠܛܐ	マルタ
ܡܘܢܐܩܘ	モナコ
ܛܘܪܐ ܐܘܟܡܐ	モンテネグロ
ܡܕܝܢܬܐ ܕܘܛܝܩܢ	バチカン
ܣܢ ܡܪܝܢܘ	サンマリノ
ܒܪܘܟܣܠ	ブリュッセル
ܠܘܕܒܝܓ ܒܐܢ ܒܝܛܗܘܒܢ	ルートヴィヒ・ヴァン・ベートーヴェン
ܠܫܢܐ ܛܘܪܩܝܐ	トルコ語
ܓܙܐܐܪ	アルジェリア
ܐܘܙܒܩܣܛܐܢ	ウズベキスタン
ܘܐܪܣܘ	ワルシャワ
ܚܡܪܐ (ܫܬܝܐ)	ワイン
ܡܝܐ	水
ܦܪܣ ܚܙܘܐ	テレビ
ܬܫܝܠܝ	チリ
ܐܠ ܓܪܝܩܘ	エル・グレコ
ܝܫܘܥ	イエス・キリスト
ܠܫܢܐ (ܡܡܠܠܐ)	言語
ܫܘܠܛܢ ܛܪܘܢܘܬܐ	独裁政治
ܡܡܠܠܘܬ ܟܘܟܒܐ	天文学
ܡܪܝܡ (ܐܡܗ ܕܝܫܘܥ)	イエスの母マリア
ܠܝܟܛܢܫܛܝܢ	リヒテンシュタイン
ܐܕܘܠܦ ܗܝܛܠܪ	アドルフ・ヒトラー
ܠܝܢܘܟܣ	Linux
ܠܫܢܐ ܠܐܛܝܢܝܐ	ラテン語
ܒܚܪܝܢ	バーレーン
ܐܪܡܢܝܐ	アルメニア
ܣܪܒܝܐ	セルビア
ܣܗܪܐ	月
ܐܝܣܛܢܒܘܠ (ܡܕܝܢܬܐ)	イスタンブル
ܐܘܣܛܪܠܝܐ (ܐܬܪܐ)	オーストラリア
ܦܝܣܝܟ	物理学
ܩܘܪܐܢ	クルアーン
ܐܣܠܐܡ	イスラム教
ܟܡܬܪܐ	ナシ属
ܠܟ ܒܐܘܢܣܐ	レフ・ヴァウェンサ
ܫܠܡܐ (ܫܝܢܐ)	平和
ܚܘܝܕܐ ܐܘܪܘܦܝܐ	欧州連合
ܐܢܬܬܐ	女性
ܛܝܙܐ	肛門
ܫܚܬܐ (ܝܘܠܦܢ ܨܪܘܝܘܬܐ)	腋の下
ܗܒܒܐ	花
ܝܘܠܦܢ ܨܪܘܝܘܬܐ	解剖学
ܡܕܝܢܬܐ	都市
ܢܐܦܠܝܘܢ ܒܘܢܐܦܪܛ	ナポレオン・ボナパルト
ܟܘܟܒܐ	恒星
ܫܡܫܐ	太陽
ܝܡܐ ܕܡܕܢܚܐ	バルト海
ܫܢܐ	歯
ܘܝܩܝܡܝܕܝܐ ܩܘܡܡܘܢܣ	ウィキメディア・コモンズ
ܟܬܒܐ (ܣܦܪܐ)	本
ܝܘܡܐ	日
ܠܠܝܐ	夜
ܫܢܬܐ (ܙܒܢܐ)	年
ܕܪܐ	世紀
ܐܘܣܠܘ	オスロ
ܠܫܒܘܢܐ	リスボン
ܦܠܝܛܐ	惑星
ܙܡܪܘܬܐ	音楽
ܡܘܣܩܒܐ	モスクワ
ܠܫܢܐ ܐܝܛܠܝܐ	イタリア語
ܬܫܐܕ	チャド
ܬܝܡܢܐ	北
ܢܝܘ ܙܝܠܢܕ	ニュージーランド
ܓܪܒܝܐ	南
ܗܢܕܘ	インド
ܦܪܙܠܐ	鉄
ܡܥܪܒܐ	西
ܡܕܢܚܐ	東
ܒܢܙܘܝܠܐ	ベネズエラ
ܛܠܦܣܢܐ	チェス
ܡܝܢ	メイン州
ܣܘܣܝܐ	ウマ
ܐܡܣܛܪܕܐܡ	アムステルダム
ܙܝܢܐ	武器
ܚܝܘܬܐ	動物
ܩܘܠܘܡܒܝܐ	コロンビア
ܢܝܘ ܗܐܡܦܫܪ	ニューハンプシャー州
ܠܝܘܢܪܕܘ ܕܗ ܒܢܬܫܝ	レオナルド・ダ・ヴィンチ
ܡܐܣܐܬܫܘܣܬܣ	マサチューセッツ州
ܐܘܛܪܝܟܛ (ܗܘܦܪܟܝܐ)	ユトレヒト州
ܟܘܢܝܬܝܟܬ	コネチカット州
ܐܝܪܐܢ	イラン
ܥܝܪܐܩ	イラク
ܐܠܐܣܟܐ	アラスカ州
ܐܝܣܪܐܝܠ	イスラエル
ܐܘܛܪܝܟܛ (ܡܕܝܢܬܐ)	ユトレヒト
ܝܡܢ	イエメン
ܠܫܢܐ ܦܘܠܢܕܝܐ	ポーランド語
ܝܘܪܕܢܢ	ヨルダン
ܩܝܪܓܝܙܣܛܐܢ	キルギス
ܐܪܝܙܘܢܐ	アリゾナ州
ܟܘܘܝܬ (ܐܬܪܐ)	クウェート
ܠܒܢܢ	レバノン
ܐܘܪܝܓܘܢ	オレゴン州
ܐܡܪܝܩܐ	アメリカ州
ܝܘܬܐ	ユタ州
ܥܘܡܐܢ	オマーン
ܦܐܩܣܛܐܢ	パキスタン
ܩܛܪ	カタール
ܣܥܘܕܝܐ	サウジアラビア
ܝܘܣܦ ܣܛܐܠܝܢ	ヨシフ・スターリン
ܣܘܪܝܐ	シリア
ܛܐܓܝܩܣܛܐܢ	タジキスタン
ܦܪܣ ܩܠܐ	ラジオ
ܛܘܪܩܡܢܣܛܐܢ	トルクメニスタン
ܐܡܝܪܘܬܐ ܥܪܒܝܬܐ ܡܚܝܕܬܐ	アラブ首長国連邦
ܐܦܓܐܢܣܛܐܢ	アフガニスタン
ܕܗܒܐ	金
ܡܠܝ	マリ共和国
ܦܝܠܝܦܝܢܝܐ	フィリピン
ܩܘܛܢܝܘܬܐ ܕܐܦܪܝܩܐ ܡܨܥܝܬܐ	中央アフリカ共和国
ܐܝܣܚܩ ܢܝܘܛܢ	アイザック・ニュートン
ܫܥܘܬܐ (ܓܘܢܐ)	黄色
ܬܘܢܣ (ܐܬܪܐ)	チュニジア
ܬܝܡܢܐ ܕܣܘܕܐܢ	南スーダン
ܩܘܛܢܝܘܬܐ ܕܩܘܢܓܘ	コンゴ共和国
ܩܘܛܢܝܘܬܐ ܕܩܘܢܓܘ ܕܝܡܘܩܪܛܝܬܐ	コンゴ民主共和国
ܦܐܦܐ ܝܘܚܢܢ ܦܘܠܘܣ ܬܪܝܢܐ	ヨハネ・パウロ2世 (ローマ教皇)
ܛܒܝܠܝܣܝ	トビリシ
ܩܐܡܪܘܢ	カメルーン
ܠܘܒܐ	リビア
ܡܘܪܝܛܢܝܐ	モーリタニア
ܡܓܪܒ	モロッコ
ܢܝܓܪ	ニジェール
ܣܘܕܐܢ	スーダン
ܩܫܬܐ ܕܡܪܢ	虹
ܗܐܡܒܘܪܓ	ハンブルク
ܝܡܬܐ ܕܐܘܢܛܪܝܘ	オンタリオ湖
ܝܡܬܐ ܕܣܘܦܝܪܝܘܪ	スペリオル湖
ܓܐܘܓܪܦܝܐ	地理学
ܠܒܐ	心臓
ܡܘܚܐ	脳
ܓܠܕܐ	皮膚
ܓܘܢܐ	色
ܦܪܐܓ	プラハ
ܙܪܩܐ	青
ܟܣܦܐ (ܣܐܡܐ)	銀
ܡܫܝܓܢ	ミシガン州
ܝܡܬܐ ܕܡܝܫܝܓܢ	ミシガン湖
ܐܠܝܢܘܝ	イリノイ州
ܢܘܪܬ ܕܐܟܘܬܐ	ノースダコタ州
ܣܐܘܬ ܕܐܟܘܬܐ	サウスダコタ州
ܡܘܢܬܐܢܐ	モンタナ州
ܘܐܝܘܡܝܢܓ	ワイオミング州
ܐܘܪܫܠܡ	エルサレム
ܐܝܕܐܗܘ	アイダホ州
ܢܝܒܐܕܐ	ネバダ州
ܐܘܩܝܢܘܣ ܗܢܕܘܝܐ	インド洋
ܟܘܠܘܪܐܕܘ	コロラド州
ܫܝܩܓܘ	シカゴ
ܣܬܘܐ	冬
ܬܕܐܐ	春
ܩܝܛܐ	夏
ܬܫܪܝܬܐ	秋
ܨܕܐܡ ܚܘܣܝܢ	サッダーム・フセイン
ܠܫܢܐ ܐܣܦܢܝܐ	スペイン語
ܓܘܓܝ	クモ
ܐܒܐ (ܦܐܪܐ)	果実
ܩܘܦܐ	サル
ܒܪܓܝܢܝܐ	バージニア州
ܝܡܬܐ ܕܝܘܪܘܢ	ヒューロン湖
ܢܝܘ ܝܘܪܩ (ܐܘܚܕܢܐ ܡܚܝܕܐ)	ニューヨーク州
ܪܘܕ ܐܝܠܐܢܕ	ロードアイランド州
ܪܚܫܐ	昆虫
ܡܐܪܝܠܐܢܕ	メリーランド州
ܕܝܠܐܘܝܪ	デラウェア州
ܐܘܗܐܝܘ	オハイオ州
ܦܢܣܝܠܒܐܢܝܐ	ペンシルベニア州
ܐܝܛܙܢ	ユーテルゼン
ܐܓܘܣܛܘܣ ܩܣܪ	アウグストゥス
ܢܝܘ ܓܝܪܣܝ	ニュージャージー州
ܐܢܕܝܐܢܐ	インディアナ州
ܪܕܝܬܐ	自動車
ܓܘܪܓܝܐ (ܐܘܚܕܢܐ ܡܚܝܕܐ)	ジョージア州
ܣܩܠܝܐ	シチリア
ܣܢ (ܢܗܪܐ)	セーヌ川
ܛܘܩܝܘ	東京都
ܦܪܕܝܢܢܕ ܡܓܝܠܢ	フェルディナンド・マゼラン
ܢܝܘ ܡܝܟܣܝܟܘ	ニューメキシコ州
ܐܬܢܘܣ	アテネ
ܡܢܝܣܘܬܐ	ミネソタ州
ܒܓܕܐܕ (ܡܕܝܢܬܐ)	バグダード
ܘܝܣܟܘܢܣܢ	ウィスコンシン州
ܐܝܐܘܐ	アイオワ州
ܢܝܒܪܐܣܟܐ	ネブラスカ州
ܟܐܢܣܐܣ	カンザス州
ܡܝܙܘܪܝ	ミズーリ州
ܐܪܟܢܣܐܣ	アーカンソー州
ܠܫܢܐ ܕܐܘܪܕܘ	ウルドゥー語
ܐܘܟܠܐܗܘܡܐ	オクラホマ州
ܝܡܐ ܕܓܪܒܝܐ	北海
ܒܝܝܢܐ	ウィーン
ܩܘܦܢܗܐܓܢ	コペンハーゲン
ܣܛܘܩܗܘܠܡ	ストックホルム
ܗܠܣܢܩܝ	ヘルシンキ
ܕܒܠܢ	ダブリン
ܒܪܛܝܣܠܐܒܐ	ブラチスラヴァ
ܟܬܒܐ ܩܕܝܫܐ	聖書
ܥܕܬܐ ܫܪܝܪܬܐ ܕܝܫܘܥ	真イエス教会
ܠܫܢܐ ܐܢܓܠܝܐ	英語
ܩܘܢܣܦܣܝܘܢ (ܬܫܝܠܝ)	コンセプシオン (チリ)
ܐܘܢܛܐܪܝܘ	オンタリオ州
ܡܐܢܝܛܘܒܐ	マニトバ州
ܐܠܒܪܛܐ	アルバータ州
ܢܘܒܐ ܣܩܘܛܝܐ	ノバスコシア州
ܩܘܢܣܩܘܒܘܠܐ	コィンスコヴォラ
ܢܝܘ ܒܪܘܢܙܘܝܩ	ニューブランズウィック州
ܩܘܠܘܡܒܝܐ ܒܪܝܛܝܬܐ	ブリティッシュコロンビア州
ܓܙܪܬܐ ܕܐܡܝܪܐ ܐܕܘܐܪܕ	プリンスエドワードアイランド州
ܣܐܣܩܐܬܫܘܐܢ	サスカチュワン州
2012	2012年
2011	2011年
2010	2010年
2009	2009年
ܢܝܘܦܐܘܢܕܠܢܕ ܘܠܐܒܪܐܕܘܪ	ニューファンドランド・ラブラドール州
2008	2008年
ܐܘܚܕܢܐ ܓܪܒܝܝܐ-ܡܥܪܒܝܐ	ノースウエスト準州
ܝܘܩܘܢ	ユーコン準州
2005	2005年
2006	2006年
ܢܘܢܐܒܘܛ	ヌナブト準州
2007	2007年
ܡܐܟܘܠܬܐ	食品
ܚܘܝܐ	ヘビ
ܩܘܪܘܦ	クルフ
ܟܝܡܝܐ	化学
1968	1968年
ܩܛܠܥܡܐ ܝܗܘܕܝܐ	ホロコースト
ܡܕܪܝܕ (ܡܕܝܢܬܐ)	マドリード
ܗܘܦܪܟܝܣ ܘܐܘܚܕܢܐ ܕܩܢܕܐ	カナダの州
ܣܢܛܝܐܓܘ ܕܐ ܬܫܝܠܝ	サンティアゴ (チリ)
ܚܐܪܘܬܐ	自由
ܣܝܕܢܝ	シドニー
ܝܪܘܩܐ	緑
ܡܠܒܘܪܢ	メルボルン
ܣܘܡܩܐ	赤
ܢܘܪܐ (ܕܠܩܐ)	火
ܢܝܠܘܣ	ナイル川
ܓܙܐܐܪ (ܡܕܝܢܬܐ)	アルジェ
ܬܘܢܣ (ܡܕܝܢܬܐ)	チュニス
ܛܗܪܐܢ	テヘラン
ܐܢܩܪܐ	アンカラ
ܢܝܐܡܝ	ニアメ
ܒܡܩܘ	バマコ
ܕܪܡܣܘܩ	ダマスカス
ܥܡܐܢ	アンマン
ܒܝܪܘܬ	ベイルート
ܒܝܬ ܨܘܒܐ	大学
ܒܝܬܐ (ܒܢܝܢܐ)	家屋
ܐܘܣܛܪܠܝܐ (ܝܒܫܬܐ)	オーストラリア大陸
ܢܗܪܐ	川
ܪܝܫܐ ܕܣܒܪܐ ܛܒܐ	喜望峰
ܫܘܚܡܠܐ	投資
ܩܘܪܝܛܝܒܐ	クリチバ
ܥܒܐ	森林
ܩܘܢܦܘܫܝܘܣ	孔子
ܩܢܐ	巣
ܐܘܪܘ	ユーロ
ܝܡܐ ܚܘܪܐ ܡܨܥܝܐ	地中海
ܓܘܪܓܝܐ	ジョージア
ܡܫܝܚܝܘܬܐ	キリスト教
ܩܠܒܐ:ܐܘܝܐ	Template:賛成
ܪܘܙܐ	米
ܝܒܫܬܐ	大陸
ܛܝܪܐ	鳥類
ܐܪܫܟܝܬܐ	首都
ܠܫܢܐ ܦܘܪܛܘܓܠܝܐ	ポルトガル語
ܝܪܚܐ	月 (暦)
ܡܘܨܛܦܐ ܟܡܐܠ ܐܛܐܛܘܪܩ	ムスタファ・ケマル・アタテュルク
ܐܠܡܐܙܢ	アルマサン
ܠܫܢܐ ܝܦܢܝܐ	日本語
ܦܐܬܐ ܪܝܫܝܬܐ	メインページ
ܦܪܢܣܝܣܩܘ ܓܘܝܐ	フランシスコ・デ・ゴヤ
ܝܡܐ ܐܚܪܝܐ	カスピ海
ܝܡܬܐ ܕܐܝܪܝ	エリー湖
ܣܠܒܐܕܘܪ ܕܐܠܝ	サルバドール・ダリ
ܒܢܣܢܬ ܦܢ ܟܘܟ	フィンセント・ファン・ゴッホ
ܦܪܝܕܐ ܩܐܠܘ	フリーダ・カーロ
ܗܢܪܝ ܡܐܛܝܣ	アンリ・マティス
ܡܝܟܠܐܢܓܠܘ	ミケランジェロ・ブオナローティ
ܦܒܠܘ ܦܝܩܐܣܘ	パブロ・ピカソ
ܪܡܒܪܢܛ	レンブラント・ファン・レイン
ܐܢܕܝ ܘܘܪܗܘܠ	アンディ・ウォーホル
ܢܝܢܘܐ (ܡܕܝܢܬܐ)	ニネヴェ (メソポタミア)
ܒܒܠ	バビロン
ܐܝܪܝܚܘ	エリコ
ܩܛܠܘܢܝܐ	カタルーニャ州
ܡܕܪܝܕ (ܗܘܦܪܟܝܐ)	マドリード州
ܒܝܬ ܠܚܡ	ベツレヘム
ܣܕܪܐ:Candidates for speedy deletion	Category:即時削除対象のページ
ܪܫܡܠܘܬܐ	資本主義
ܐܘܡܬܐ	国民
ܩܪܬܐܓܘ	カルタゴ
ܣܕܪܐ:ܐܣܛܪܘܢܘܡܝܐ	Category:天文学
ܨܚܪܐܐ	サハラ砂漠
ܫܐܕܐ	悪魔
ܒܝܬ ܟܬܒܐ	図書館
ܫܘܠܛܢܘܬܐ (ܫܘܬܐܣܐ)	政府
ܬܫܝܢ ܫܝ ܗܘܐܢܓ	始皇帝
ܡܕܢܚܐ ܡܨܥܝܬܐ	中東
ܡܠܟܘܬܐ	君主制
ܩܘܛܢܝܘܬܐ	共和制
ܐܬܪܐ	国家
ܓܒܐ	政党
ܝܗܘܕܝܐ	ユダヤ人
ܝܡܡܬܐ ܪܘܪܒܬܐ	五大湖
ܐܘܩܝܢܘܣ ܬܝܡܢܝܐ	南極海
ܐܕܢܐ (ܝܘܠܦܢ ܨܪܘܝܘܬܐ)	耳
ܢܚܝܪܐ	鼻
ܥܝܢܐ (ܝܘܠܦܢ ܨܪܘܝܘܬܐ)	目
ܥܘܩܒܪܬܐ	筋肉
ܙܡܝܪܬܐ	歌
ܓܡܠܐ	ラクダ
ܫܘܫܡܢܐ	アリ
ܕܒܫܬܐ	ハナバチ
ܠܫܢܐ ܗܘܠܢܕܝܐ	オランダ語
ܐܡܐ (ܒܝܬܝܘܬܐ)	母親
ܐܒܐ (ܒܝܬܝܘܬܐ)	父親
1847	1847年
ܨܦܪܐ (ܙܒܢܐ)	朝
ܪܡܫܐ	夕
ܩܛܝܢܬܐ	分
ܠܫܢܐ ܪܘܣܝܐ	ロシア語
ܩܢܘܢܐ	法 (法学)
ܠܫܢܐ ܨܝܢܝܐ	中国語
ܕܡܐ	血液
ܬܓܪܘܡܬܐ	骨格
ܪܐܬܐ	肺
ܠܫܢܐ ܪܘܡܢܝܐ	ルーマニア語
ܡܛܪܐ	雨
ܢܠܣܘܢ ܡܐܢܕܝܠܐ	ネルソン・マンデラ
ܐܒܢܐ	岩石
ܥܢܢܐ	雲
ܩܢܘܢܐ ܕܠܥܙܐ	文法
ܠܫܢܐ ܓܘܪܓܝܐ	グルジア語
ܝܘܠܦܢ ܡܡܫܚܘܬܐ	経済学
ܙܘܙܐ	通貨
ܡܕܐܬܐ	租税
ܐܠܦܒܝܬ ܥܪܒܝܐ	アラビア文字
ܐܠܦܒܝܬ ܝܘܢܝܐ	ギリシア文字
ܐܠܦܒܝܬ ܠܐܛܝܢܝܐ	ラテン文字
ܣܕܪܐ:ܦܪܢܣܐ	Category:フランス
ܟܢܫܐ	社会
ܓܒܪܐ	男性
ܙܘܘܓܐ	結婚
ܙܕܩܐ ܕܒܪܢܫܐ	人権
ܩܪܒܐ ܓܘܝܐ	内戦
ܓܪܡܐ ܕܣܢܘܢܝܬܐ	胸骨
ܬܪܝܢܐ	ジュース
ܚܠܒܐ (ܕܝܘܒܐ)	乳
ܛܘܪܐ	山
ܡܕܒܪܐ	砂漠
ܠܫܢܐ ܐܠܒܢܝܐ	アルバニア語
ܠܫܢܐ ܐܪܡܢܝܐ	アルメニア語
ܝܘܗܐܢ ܓܘܛܢܒܪܓ	ヨハネス・グーテンベルク
ܠܫܢܐ ܣܘܝܕܝܐ	スウェーデン語
ܢܝܩܘܠܐ ܛܣܠܐ	ニコラ・テスラ
ܡܘܫܐ	モーセ
ܬܕܐ	乳房
ܢܘܗܪܐ (ܚܙܝܬܐ)	光
ܠܫܢܐ ܝܘܢܝܐ	ギリシア語
ܠܫܢܐ ܦܪܣܝܐ	ペルシア語
ܬܘܕܝܬܐ	宗教
ܐܒܪܗܡ	アブラハム
ܣܦܪܐ ܕܒܪܝܬܐ	創世記
ܠܫܢܐ ܩܢܛܘܢܝܐ	広東語
ܠܫܢܐ ܡܢܕܪܝܢܝܐ	官話
ܦܘܠܘܣ ܫܠܝܚܐ	パウロ
ܙܝܓܡܘܢܕ ܦܪܘܝܕ	ジークムント・フロイト
ܙܠܛܐ	サラダ
ܝܗܘܕܝܘܬܐ	ユダヤ教
ܠܫܢܐ ܥܒܪܝܐ	ヘブライ語
ܟܒܕܐ	肝臓
ܛܚܠܐ	脾臓
ܟܘܠܝܬܐ	腎臓
ܫܠܦܘܚܬܐ	膀胱
ܐܫܟܐ	精巣
ܐܘܩܝܢܘܣ	大洋
ܒܘܕܗܐ	釈迦
ܡܘܚܡܕ	ムハンマド・イブン＝アブドゥッラーフ
ܟܪܣܐ	腹
ܚܒܠܐ ܟܘܒܝܐ	脊髄
ܘܪܝܕܐ	静脈
ܡܪܒܥܐ	子宮
ܠܫܢܐ (ܗܕܡܐ)	舌
ܓܝܕܐ	神経
ܨܘܪܐ (ܝܘܠܦܢ ܨܪܘܝܘܬܐ)	首
ܦܘܡܐ	口
ܓܓܪܬܐ	喉頭
ܡܥܝܐ	腸
ܫܪܝܬܐ	関節
ܚܕܝܐ	胸
ܬܝܪܬܐ	腺
ܚܠܒܐ (ܝܘܠܦܢ ܨܪܘܝܘܬܐ)	横隔膜
ܫܪܝܢܐ	動脈
A	A
B	B
ܢܘܛܦܬܐ	精液
G	G
U	U
Z	Z
F	F
J	J
ܐܠܦܒܝܬ	アルファベット
T	T
C	C
R	R
D	D
Α	Α
Ω	Ω
I	I
Μ	Μ
E	E
H	H
ܗܐܪܠܡ (ܗܘܠܢܕܐ)	ハールレム
K	K
L	L
M	M
N	N
O	O
Q	Q
S	S
V	V
W	W
X	X
Y	Y
ܐܢܫܟܕܐ	エンスヘーデ
ܗܢܓܠܘ	ヘンゲロー
Φ	Φ
ܝܘܢܐ	ハト科
ܐܝܠܢܐ	木
Λ	Λ
ܓܒܬܐ	チーズ
ܥܢܒܬܐ	ブドウ
ܕܒܫܐ	蜂蜜
ܒܣܪܐ	食肉
ܫܟܪ	砂糖
ܣܦܪܙܒܢܐ	新聞
ܙܥܘܩܐ	電話機
ܡܪܕܘܬܐ	文化
ܡܥܝܐ ܥܒܝܐ	大腸
ܡܥܝܐ ܩܛܝܢܐ	小腸
ܣܘܪܓܕܐ ܝܘܠܝܝܐ	ユリウス暦
ܐܣܝܘܬܐ	医学
ܡܠܚܐ (ܐܨܪܐ)	塩
ܣܕܪܐ:ܒܪܐܙܝܠ	Category:ブラジル
ܙܘܝܬܐ (ܡܚܪܘܬܐ)	角度
ܬܘܩܦܐ	エネルギー
ܣܦܝܢܬܐ	船
ܩܠܐ (ܨܘܬܐ)	音
ܙܓܘܓܝܬܐ	ガラス
ܫܛܝܚܘܬܐ	面積
ܡܢܝܢܐ	数
ܪܦܦܐ	秒
ܣܥܪܬܐ	オオムギ
ܘܘܗܐܢ	武漢市
ܡܟܬܒܢܘܬܐ ܕܐܬܪܘܬܐ	国の一覧
ܒܝܬ ܢܗܪܝܢ	メソポタミア
ܕܒܐ	クマ
ܬܠܗܝܐ	悪性腫瘍
ܡܠܟܐ	王
ܚܛܬܐ	コムギ
ܣܘܪܓܕܐ	暦
ܟܘܪܗܢܐ	病気
ܣܘܪܓܕܐ ܓܪܝܓܘܪܝܐ	グレゴリオ暦
ܟܦܣܐ	月経
ܥܡܐ ܩܪܕܘܝܐ	クルド人
ܓܫܪܐ	橋
ܡܓܕܠܐ (ܒܢܝܢܐ)	塔
ܐܡܪܝܩܐ ܠܐܛܝܢܝܬܐ	ラテンアメリカ
ܟܗܪܒܐ	電気
ܡܙܝܥܢܐ ܕܩܝܕܐ ܓܘܝܐ	内燃機関
ܣܝܦܐ (ܙܝܢܐ)	剣
ܫܡܥܘܢ ܩܢܢܝܐ	熱心党のシモン
ܩܪܩܦܬܐ	頭蓋骨
ܓܘܡܠܐ!	Joomla!
ܐܦܫܬܐ	レーズン
ܠܫܢܐ ܕܗܣܝܐܢܓ	湘語
ܠܫܢܐ ܥܪܒܝܐ	アラビア語
ܠܫܢܐ ܐܦܪܝܩܐܢܝܐ	アフリカーンス語
Β	Β
Γ	Γ
Δ	Δ
Ε	Ε
Ζ	Ζ
Η	Η
Θ	Θ
Ι	Ι
Κ	Κ
Ν	Ν
Ξ	Ξ
Ο	Ο
Ρ	Ρ
Σ	Σ
Τ	Τ
Υ	Υ
Χ	Χ
Ψ	Ψ
ܐܬܐ	旗
ܟܪܦܬܐ	家具
ܟܘܪܣܝܐ	椅子
ܣܦܬܐ	唇
ܦܣܡܐ	口髭
ܥܩܠܐ	足
1000000000 (ܡܢܝܢܐ)	1 E9
ܓܪܡܐ ܕܨܕܥܐ	側頭骨
ܩܠܝܕܐ (ܓܪܡܐ)	鎖骨
ܟܬܦܐ	肩
ܦܟܐ ܬܚܬܝܐ	下顎骨
ܩܠܒܐ:Link FA	Template:Link FA
ܥܠܡܐ (ܐܪܥܐ)	世界
ܘܝܩܝܦܕܝܐ:ܬܪܥܐ ܕܟܢܫܐ	Wikipedia:井戸端
ܒܝܪܡܘܢܬ	バーモント州
ܩܘܣܛܢܛܝܢܘܦܘܠܝܣ	コンスタンティノープル
ܒܝܬ ܟܪܝܗܐ	病院
ܥܕܬܐ	教会堂
ܕܝܬܝܩܝ ܚܕܬܐ	新約聖書
9 (ܡܢܝܢܐ)	9
1002	1002年
ܦܘܕܘܠܣܟ	ポドリスク
ܦܐܦܐ	教皇
5	5年
4	4年
ܢܝܒܐ	犬歯
3	3年
2	2年
ܒܝܬ ܥܬܩܐ ܕܠܘܒܪ	ルーヴル美術館
ܓܒܐ ܕܚܐܪܘܬܐ ܕܦܘܐܪܛܘ ܪܝܩܘ	プエルトリコ独立党
6	6年
ܕܝܬܝܩܝ ܥܬܝܩܬܐ	旧約聖書
ܥܐܕܐ ܕܒܝܬ ܝܠܕܐ	クリスマス
ܠܫܢܐ ܪܘܡܐܢܣܝܐ	ロマンス諸語
ܡܬܠܬܐ	三角形
ܫܢܬܐ ܟܒܝܫܬܐ	閏年
ܡܘܥܡܪ ܐܠܩܕܐܦܝ	ムアンマル・アル＝カッザーフィー
ب	ب
ܥܐܕܐ ܕܩܝܡܬܐ	復活祭
ܢܝܘ ܝܘܪܩ	ニューヨーク (曖昧さ回避)
ܢܦܛܐ	石油
ܣܐܘܢܐ	靴
ܒܝܬ ܥܘܪܦܢܐ	銀行
ܟܪܡܐ	葡萄園
ܐܝܪܠܢܕ (ܓܙܪܬܐ)	アイルランド島
1	1年
ܠܘ ܫܘܢ	魯迅
10	10年
20	20年
9	9年
7	7年
8	8年
7 (ܡܢܝܢܐ)	7
8 (ܡܢܝܢܐ)	8
12	12年
ܡܠܐܐ ܘܬܘܒܐ	潮汐
ܫܒܘܥܐ	週
ܓܠܝܕܐ	氷
ܨܠܘܬܐ ܡܪܢܝܬܐ	主の祈り
ܝܡܬܐ	湖
ܝܡܐ ܣܘܡܩܐ	紅海
13	13年
ܩܛܘܬܐ (ܝܥܝܬܐ)	キュウリ
ܓܙܪܬܐ	島
ܚܘܪܐ	白
ܐܘܟܡܐ	黒
6 (ܡܢܝܢܐ)	6
ܠܫܢܐ ܪܘܫܡܝܐ	公用語
11	11年
15	15年
14	14年
17	17年
ܣܦܪ ܡܠܐ	辞典
18	18年
19	19年
16	16年
21	21年
ܦܠܣܛܝܢ	パレスチナ
10 (ܡܢܝܢܐ)	10
ܡܣܘܪܩܐ (ܡܐܢܐ)	櫛
ܠܝܠܐ ܕܘܢܤ	リラ・ダウンズ
ܝܡܐ ܕܡܠܚܐ	死海
ܫܘܚܠܦܐ ܕܫܢܬܐ	季節
ܠܝܒܪܦܘܠ	リヴァプール
ܩܘܦܬܐ (ܛܝܪܐ)	フクロウ目
ܫܥܬܐ	時間 (単位)
ܢܐܘܝ ܕܘܪ ܟܪܘܠܣܟܝ	ノヴィ・ドゥヴル・クルレフスキ
ܐܪܙܦܬܐ	槌
ܝܘܢܫܘܦܝܢ	ヨンショーピング市
ܥܘܠܐ ܚܝܐ	胎児
ܐܠܦܒܝܬ ܣܘܪܝܝܐ	シリア文字
ܐܠܦܒܝܬ ܐܪܡܝܐ	アラム文字
ܐܣܝܐ ܡܥܪܒܝܬܐ	西アジア
ܫܓܠܐ	石蹴り
ܩܠܦܬܐ ܕܒܣܡܐ	シナモン
ܡܙܬܐ	毛 (動物)
ܠܫܢܐ ܐܪܡܝܐ	アラム語
ܨܦܪܐ (ܛܝܪܐ)	スズメ科
ܐܦܣܩܘܦܐ	監督 (キリスト教)
ܨܝܢ (ܐܪܥܐ)	中国
ܓܒܐ ܕܝܡܘܩܪܛܝܐ (ܐܘܚܕܢܐ ܡܚܝܕܐ)	民主党 (アメリカ)
ܒܝܐܛܪܝܟܣ ܕܒܝܬ ܗܘܠܢܕܝܐ	ベアトリクス (オランダ女王)
ܡܠܟܘܬܐ ܕܗܘܠܢܕܐ	オランダ王国
ܐܒܪܝܠ ܠܐܒܝܢ	アヴリル・ラヴィーン
ܪܝܫ ܩܘܛܢܝܘܬܐ	大統領
ܐܚܐ (ܒܝܬܝܘܬܐ)	兄弟姉妹
ܐܪܒܝܐ	アラビア半島
ܡܪܩܘܣ ܐܘܢܓܠܣܛܐ	マルコ (福音記者)
ܥܘܠܐ	胚
ܠܫܢܐ ܕܗܟܐ	客家語
ܫܘܫܡܢܝܬܐ (ܝܥܝܬܐ)	カルダモン
ܠܫܢܐ ܕܓܐܢ	カン語
ܒܝܬ ܥܬܩܐ	博物館
ܐܠܦܒܝܬ ܥܒܪܝܐ	ヘブライ文字
ܠܫܢܐ ܣܘܪܝܝܐ	シリア語
ܒܪܩܐ	雷
ܐܝܕܐ	手
ܫܡܥܘܢ ܟܐܦܐ	ペトロ
ܬܠ ܐܒܝܒ	テルアビブ
ܒܐܠܦܐܪܐܝܣܘ	バルパライソ
ܛܘܪܝܐ	トゥロヨ語
ܠܫܢܐ ܫܝܡܝܐ	セム語派
ܚܘܣܢܝ ܡܘܒܐܪܟ	ホスニー・ムバーラク
ܘܐܟܐܩܐ	オアハカ州
ܚܐܘܬܐ	バター
ܐܘܢܓܠܝܘܢ	福音書
ܠܫܢܐ ܕܘܘ	呉語
ܪܘܛܪܕܐܡ	ロッテルダム
ܩܪܛܐ	クレタ島
ܐܘܪܚܐ	道路
ܩܘܪܨܐ ܚܠܝܨܐ	コンパクトディスク
ܨܒܥܐ	指
ܦܪܬ	ユーフラテス川
ܩܝܘܛܘ	京都市
ܥܣܪܐ ܦܘܩܕܢܐ	モーセの十戒
ܒܪܩܩܐ ܦܪܣܝܐ	ペルシア湾
ܚܠܐ (ܕܚܝܚܐ)	砂
ܘܪܕܐ	バラ
ܓܙܪܬܐ ܝܒܫܢܝܬܐ	半島
ܐܘܪܝܬܐ	トーラー
ܟܘܘܝܬ (ܡܕܝܢܬܐ)	クウェート市
ܡܚܙܝܬܐ	鏡
ܥܡܐ ܥܪܒܝܐ	アラブ人
ܟܘܬܐ	窓
ܠܫܢܐ ܝܘܢܝܐ ܥܬܝܩܐ	古代ギリシア語
ܠܫܢܐ ܐܟܕܝܐ	アッカド語
ܕܩܠܬ	チグリス川
ܐܬܪܘܬܐ ܕܐܬܪܘܬܐ ܡܚܝܕܐ ܕܐܡܪܝܩܐ	アメリカ合衆国の州
ܡܥܡܘܕܝܬܐ	洗礼
ܩܘܢܓܘ	コンゴ (曖昧さ回避)
ܐܝܢܛܪܠܝܢܓܘܐ	インターリングア
ܐܘܪܟܐ	長さ
ܚܠܡܐ	夢
ܠܫܢܐ ܩܪܕܘܝܐ	クルド語
ܩܡܚܐ	穀粉
ܕܢ ܗܐܟ	デン・ハーグ
ܠܫܢܐ ܦܘܢܝܩܝܐ	フェニキア語
ܣܝܢܝ (ܓܙܪܬܐ ܝܒܫܢܝܬܐ)	シナイ半島
ܟܪܘܙܘܬܐ ܕܝܘܚܢܢ	ヨハネによる福音書
ܬܪܥܐ (ܒܒܐ)	扉
ܪܝܗܐܢܐ	リアーナ
ܛܦܪܐ	爪
ܐܦܐ	顔
ܨܨܐ (ܨܢܥܬܐ)	釘
ܙܝܬܐ	オリーブ
ܬܠܝܬܝܘܬܐ	三位一体
ܓܠܠܐ	波動
ܟܬܒܬܐ	筆記
ܪܘܚܐ ܕܩܘܕܫܐ	聖霊
100 (ܡܢܝܢܐ)	100
ܒܘܪܟܐ	膝
ܫܘܩܐ (ܬܐܓܪܘܬܐ)	市場
ܠܫܢܐ ܥܪܒܝܐ ܝܗܘܕܝܐ	ユダヤ・アラビア語群
ܒܠܛܝ	バルツィ
1000000 (ܡܢܝܢܐ)	1000000
ܛܐܒܐ	ニュース
ܐܫܬܐ (ܐܣܝܘܬܐ)	発熱
ܩܫܬܐ ܓܪܒܝܝܬܐ ܕܐܪܥܐ	北半球
ܡܡܘܢܐ ܕܡܝܟܪܐ	ミクロ経済学
ܠܝܕܣ	リーズ
ܥܘܩܒܪܐ	ハツカネズミ属
ܦܘܪܬܩܠܐ	オレンジ色
ܒܪܩܩܐ	湾
ܒܝܬ ܩܒܘܪܐ	墓地
ܐܣܝܐ (ܫܕܬܐ)	医師
ܡܩܕܘܢܝܐ	マケドニア (曖昧さ回避)
ܦܢܛܝܩܘܣܛܝ	ペンテコステ
ܫܓܕܬܐ	アーモンド
ܟܪܘܙܘܬܐ ܕܠܘܩܐ	ルカによる福音書
ܩܘܢܣܦܣܝܘܢ (ܗܘܦܪܟܝܐ)	コンセプシオン県 (チリ)
ܢܗܪܐ ܕܝܘܪܕܢܢ	ヨルダン川
ܣܦܪ ܝܡܐ	砂浜
ܐܢܛܐܠܝܐ (ܗܘܦܪܟܝܐ)	アンタルヤ県
ܦܪܟܣܝܣ ܕܫܠܝܚܐ	使徒言行録
ܥܪܘܒܬܐ ܕܚܫܐ	聖金曜日
ܚܒܘܫܝܐ	刑務所
ܐܕܢܐ (ܗܘܦܪܟܝܐ)	アダナ県
ܝܘܚܢܢ ܡܥܡܕܢܐ	洗礼者ヨハネ
ܨܠܝܒܐ	十字
ܚܙܒܐܠܠܗ	ヒズボラ
ܒܝܬ ܓܒܝܢܐ	額
ܡܙܡܘܪܐ	詩篇
ܐܬܘܪ	アッシリア
ܒܢܝܢܐ	建築物
ܚܠܒ (ܡܕܝܢܬܐ)	アレッポ
ܩܫܬܐ ܬܝܡܢܝܬܐ ܕܐܪܥܐ	南半球
ܚܠܐ (ܚܡܪܐ)	酢
ܒܝܬ ܕܝܢܐ	裁判所
ܚܝܦܐ	ハイファ
ܪܡܕܐܢ	ラマダーン
ܫܛܪܐ ܬܐܒܝܠܝܐ ܕܓܝܢܝܣ	ギネス世界記録
ܟܘܕܢܝܐ	ラバ
ܒܪܩܩܐ ܕܥܕܢ	アデン湾
ܓܠܝܢܐ ܕܝܘܚܢܢ	ヨハネの黙示録
ܐܫܬܐ (ܝܘܠܦܢ ܨܪܘܝܘܬܐ)	尻
ܨܠܘܬܐ ܡܪܝܡܝܬܐ	アヴェ・マリア
ܝܩܕܐ	燃料
ܝܨܝܠܐ	肘
ܟܗܢܐ	司祭
ܕܩܢܐ	髭
ܢܒܝܐ	預言者
ܐܘܪܟܝܣܛܪܐ	オーケストラ
1000 (ܡܢܝܢܐ)	1000
ܣܘܦܝܐ ܪܘܛܐܪܘ	ソフィーヤ・ロタール
ܬܫܢܝܬܐ	保険
ܛܘܟܣܐ	組織 (社会科学)
ܣܦܪܓܠܐ	マルメロ
ܐܢܕܪܐܘܣ ܫܠܝܚܐ	アンデレ
ܬܪܥܣܪ ܫܠܝܚܐ	使徒
ܢܩܒܬܐ	メス (動物)
ܕܪܥܐ (ܗܕܡܐ)	腕
ܡܬܝ ܡܟܣܐ	マタイ
ܬܐܘܡܐ ܫܠܝܚܐ	トマス (使徒)
ܦܝܠܝܦܘܣ ܫܠܝܚܐ	フィリポ
ܒܘܪܨܐ (ܗܘܦܪܟܝܐ)	ブルサ県
ܐܝܘܐܢܢܝܣ ܦܘܡܐ ܕܕܗܒܐ	金口イオアン
ܒܢܝܡܝܢ ܢܬܢܝܗܘ	ベンヤミン・ネタニヤフ
ܐܪܬܒܝܢ (ܗܘܦܪܟܝܐ)	アルトヴィン県
ܓܒܝܢܐ	眉毛
ܫܘܪܬܐ	へそ
ܐܕܝܐܡܐܢ (ܗܘܦܪܟܝܐ)	アドゥヤマン県
ܝܗܘܕܐ ܫܠܝܚܐ	タダイ
ܒܪܬܘܠܡܝ ܫܠܝܚܐ	バルトロマイ
ܝܥܩܘܒ ܒܪ ܙܒܕܝ	ヤコブ (ゼベダイの子)
ܝܘܚܢܢ ܫܠܝܚܐ	ヨハネ (使徒)
ܡܬܝܐ ܫܠܝܚܐ	マティア
ܝܥܩܘܒ ܒܪ ܚܠܦܝ	ヤコブ (アルファイの子)
ܕܟܪܐ	オス
ܐܝܓܢܐܛܝܘܣ ܢܘܪܢܐ	アンティオキアのイグナティオス
ܪܕܝܘܗܕ	レディオヘッド
ܒܫܐܪ ܐܠܐܣܕ	バッシャール・アル＝アサド
ܪܚܝܐ	粉砕機
ܨܘܡܐ	断食
ܕܝܪܐ	僧院
ܠܡܐܢܐ	港湾
ܡܠܚܐ (ܢܘܛܐ)	船員
ܐܦܝܘܢ (ܗܘܦܪܟܝܐ)	アフィヨンカラヒサール県
ܡܝܟܐܝܠ (ܡܠܐܟܐ)	ミカエル
ܒܝܠܓܝܟ (ܗܘܦܪܟܝܐ)	ビレジク県
ܒܝܬ ܥܬܩܐ ܕܐܣܪܐܝܠ	イスラエル博物館
ܒܐܠܝܟܣܝܪ (ܗܘܦܪܟܝܐ)	バルケスィル県
ܒܝܬ ܝܠܕܐ	誕生日
ܬܘܠܥܐ	蠕虫
ܬܘܩܢ ܓܝܕܝܐ ܩܢܛܪܘܢܝܐ	中枢神経系
ܛܘܪܐ ܕܓܠܝܕܐ	氷山
ܡܫܠܡܢܐ	ムスリム
ܢܢܥܐ	ミント
ܩܠܒܐ:Commonscat	Template:Commonscat
ܒܨܪܐ (ܡܕܝܢܬܐ)	バスラ
ܐܓܪܬܐ ܕܠܘܬ ܪܗܘܡܝܐ	ローマの信徒への手紙
ܬܡܪܐ ܕܥܝܢܐ	まぶた
ܗܘܦܪܟܝܣ ܕܛܘܪܩܝܐ	トルコの地方行政区画
ܡܪܝ ܓܝܘܪܓܝܣ ܣܗܕܐ	ゲオルギオス (聖人)
ܐܣܘܬܐ ܕܠܐ ܬܚܘܡܐ	国境なき医師団
ܐܪܙܐ (ܡܫܝܚܝܘܬܐ)	サクラメント
ܐܓܪܬܐ ܕܠܘܬ ܦܝܠܝܦܣܝܐ	フィリピの信徒への手紙
ܐܢܛܘܠܝܐ	アナトリア半島
ܡܫܝܚܐ	メシア
ܚܫܡܝܬܐ ܐܚܪܝܬܐ	最後の晩餐
ܩܢܘܢܐ ܕܗܝܡܢܘܬܐ	使徒信条
ܒܢܝ ܐܝܣܪܐܝܠ	イスラエル (民族)
ܡܓܘܫܐ ܬܠܬܐ	東方の三博士
ܝܘܚܢܢ ܕܪܡܣܘܩܝܐ	ダマスコのイオアン
ܒܒܐ (ܬܪܥܐ)	門
ܣܕܪܐ:ܪܘܟܒ ܫܘܠܛܢܘܬܐ	Category:政体
ܠܫܢܐ ܕܡܝܢ	ビン語
ܥܘܪܡܫܐ	公害
ܒܒܠ (ܗܘܦܪܟܝܐ)	バービル県
ܫܘܡܪܐ	すす
ܐܫܩܠܘܢ	アシュケロン
ܕܘܢܒܐ	尾
ܩܐܕܣܝܐ (ܗܘܦܪܟܝܐ)	カーディーシーヤ県
ܡܪܝܡ ܡܓܕܠܝܬܐ	マグダラのマリア
ܡܪܪܬܐ	胆嚢
ܥܕܬܐ ܡܪܘܢܝܬܐ	マロン典礼カトリック教会
ܡܪܬܐ	胆汁
ܩܘܪܒܢܐ	聖餐
ܐܕܡ	アダム
ܐܘܘܫܐ	耳垢
ܕܡܥܬܐ	涙
ܥܡܬܐ (ܒܝܬܝܘܬܐ)	おば
ܥܡܐ (ܒܝܬܝܘܬܐ)	おじ
ܟܘܬܝܢܐ	シャツ
ܝܘܗܐܢ ܐܠܙܪ	ゲオルク・エルザー
ܒܝܢܓܘܠ (ܗܘܦܪܟܝܐ)	ビンギョル県
ܥܡܐ ܐܪܡܢܝܐ	アルメニア人
ܐܝܕܝܢ (ܗܘܦܪܟܝܐ)	アイドゥン県
ܩܛܠܥܡܐ ܐܪܡܢܝܐ	アルメニア人虐殺
ܐܡܐܣܝܐ (ܗܘܦܪܟܝܐ)	アマスィヤ県
ܦܪܝܙܘܢ ܒܪܝܟ	プリズン・ブレイク
ܐܓܪܝ (ܗܘܦܪܟܝܐ)	アール県
ܒܘܪܕܘܪ (ܗܘܦܪܟܝܐ)	ブルドゥル県
ܐܓܪܬܐ ܩܕܡܝܬܐ ܕܠܘܬ ܩܘܪܢܬܝܐ	コリントの信徒への手紙一
ܝܗܘܕܐ ܣܟܪܝܘܛܐ	イスカリオテのユダ
ܐܒܪܐ	羽毛
ܡܚܪܐ	技術者
ܚܪܛܘܡܢܐ	ヒヨコマメ
ܐܬܪܘܬܐ ܕܫܐܡ	レバント
ܬܪܘܕܐ	スプーン
ܓܒܪܐܝܠ (ܡܠܐܟܐ)	ガブリエル
ܓܪܡܦܝܠܐ	象牙
ܨܘܪ	ティルス
ܒܘܠܘ (ܗܘܦܪܟܝܐ)	ボル県
ܙܢܩܐ	おとがい
ܨܘܡܐ ܕܐܪܒܥܝܢ	四旬節
ܐܓܪܐ ܕܒܢܝܢܐ	屋根
ܒܝܛܠܝܣ (ܗܘܦܪܟܝܐ)	ビトリス県
ܓܠܝܠܐ	ガリラヤ
ܡܘܨܠ	モースル
ܟܪܬܐ	親指
ܥܡܐ ܛܘܪܩܝܐ	トルコ人
ܦܐܦܐ ܫܢܘܕܐ ܬܠܝܬܝܐ	シェヌーダ3世 (コプト教会アレクサンドリア総主教)
ܒܝܬ ܓܘܣܐ	掩体壕
ܒܣܕܝܐ	枕
ܙܓܐ (ܢܩܘܫܐ)	鐘
ܫܒܬܐ (ܝܗܘܕܝܘܬܐ)	安息日
ܫܡܝܪܡ	セミラミス
ܫܝܓܪܐ	歯肉
ܝܗ	主 (宗教)
ܡܫܝܚܝܐ	キリスト教徒
ܟܪܘܙܘܬܐ ܕܡܪܩܘܣ	マルコによる福音書
ܐܓܪܬܐ ܕܠܘܬ ܩܘܪܢܬܝܐ ܕܬܪܬܝܢ	コリントの信徒への手紙二
ܫܥܘܬܐ (ܡܠܘܐܐ)	蝋
ܛܥܡܐ	味覚
ܓܢܬ ܫܒܪܐ	幼稚園
ܝܡܬܐ ܕܓܠܝܠܐ	ガリラヤ湖
ܕܝܘܬܐ	インク
ܡܪܝ ܝܘܣܦ	ナザレのヨセフ
ܠܘܩܐ ܐܘܢܓܠܣܛܐ	ルカ
ܐܓܪܬܐ ܕܠܘܬ ܥܒܪܝܐ	ヘブライ人への手紙
ܐܓܪܬܐ ܕܠܘܬ ܓܠܛܝܐ	ガラテヤの信徒への手紙
Ϝ	Ϝ
Ϙ	Ϙ
ܥܛܡܐ	太股
ܬܢܢܐ	煙
ܡܘܚܘܢܐ	小脳
ܐܓܪܬܐ ܕܠܘܬ ܩܘܠܣܝܐ	コロサイの信徒への手紙
ܐܓܪܬܐ ܕܝܥܩܘܒ	ヤコブの手紙
ܐܓܪܬܐ ܩܕܡܝܬܐ ܕܝܘܚܢܢ	ヨハネの手紙一
ܐܓܪܬܐ ܕܠܘܬ ܦܝܠܡܘܢ	フィレモンへの手紙
ܐܓܪܬܐ ܕܠܘܬ ܬܣܠܘܢܝܩܝܐ ܕܬܪܬܝܢ	テサロニケの信徒への手紙二
ܐܓܪܬܐ ܩܕܡܝܬܐ ܕܠܘܬ ܬܣܠܘܢܝܩܝܐ	テサロニケの信徒への手紙一
ܐܓܪܬܐ ܩܕܡܝܬܐ ܕܦܛܪܘܣ	ペトロの手紙一
ܐܓܪܬܐ ܕܬܪܬܝܢ ܕܦܛܪܘܣ	ペトロの手紙二
ܐܓܪܬܐ ܩܕܡܝܬܐ ܕܠܘܬ ܛܝܡܬܐܘܣ	テモテへの手紙一
Ϛ	Ϛ
ܡܪܕܝܢ (ܗܘܦܪܟܝܐ)	マルディン県
ܚܡܨ (ܡܕܝܢܬܐ)	ホムス
Ͳ	サンピ
ܘܐܟܐܩܐ ܕܝ ܟܘܐܪܝܣ	オアハカ
ܐܓܪܬܐ ܕܬܪܬܝܢ ܕܝܘܚܢܢ	ヨハネの手紙二
ܐܓܪܬܐ ܕܬܠܬ ܕܝܘܚܢܢ	ヨハネの手紙三
ܐܓܪܬܐ ܕܝܗܘܕܐ	ユダの手紙
ܐܓܪܬܐ ܕܠܘܬ ܛܝܡܬܐܘܣ ܕܬܪܬܝܢ	テモテへの手紙二
ܐܓܪܬܐ ܕܠܘܬ ܛܛܘܣ	テトスへの手紙
ܐܟܪܐ	農家
ܓܘܣܢܐ	難民
Ϻ	Ϻ
ܩܠܝܕܐ (ܡܐܢܐ)	鍵
ܥܕܥܐܕܐ	祭
ܐܪܒܝܠ (ܡܕܝܢܬܐ)	アルビール
ܪܓܠܐ	脚
ܚܨܐ	背中
ܐܠܝܐ ܢܒܝܐ	エリヤ
ܙܚܘܪܝܬܐ (ܬܘܠܥܬܐ)	カイコ
ܚܘܦܝܐ	食 (天文)
ܡܚܛܐ	針
ܥܠܡܐ ܥܪܒܝܐ	アラブ世界
ܦܓܘܕܬܐ	頭絡
ܩܛܡܐ	灰
ܢܘܗܕܪܐ (ܡܕܝܢܬܐ)	ドホーク
ܨܒܥܐ ܕܪܓܠܐ	爪先
ܢܓܪܘܬܐ	大工
ܠܘܚܐ (ܚܫܘܒܬܐ)	タブレット (コンピュータ)
ܪܒܝܬܐ	高利貸し
ܡܟܝܪܘܬܐ	婚約
ܫܘܪܡܐ	直腸
ܐܪܡܝܐ (ܢܒܝܐ)	エレミヤ
ܬܐܡܐ	双生児
ܬܠܝܦܐ	まつげ
ܫܥܬܐ ܕܐܪܥܐ	アース・アワー
ܦܪܡܝܬܐ	ボタン (服飾)
ܟܘܟܒܐ ܕܕܘܝܕ	ダビデの星
ܡܪܝ ܐܣܛܦܢܘܣ	ステファノ
ܡܫܡܫܢܐ	執事 (キリスト教)
ܢܓܒ	ネゲヴ
ܟܢܥܢ	カナン
ܢܘܨܦܐ	薄明
ܒܝܢܐ	ギョリュウ
ܬܓܪܝܬ	ティクリート
ܚܠܐ (ܥܦܪܐ)	粉塵
ܬܪܥܐ ܕܕܡܐ	出血
ܥܪܒܐ ܕܫܡܫܐ	日没
ܐܡܝܫܐ	沼地
ܡܨܥܝܬܐ (ܨܒܥܐ)	中指
ز	ز
ܩܘܪܨܠܐ	足関節
ܒܪ ܐܝܕܐ	手袋
ܢܫܒܐ ܕܥܝܢܐ	網膜
ܬܘܩܢ ܓܝܕܝܐ ܡܚܕܘܪܝܐ	末梢神経系
ܛܝܢܐ	泥
ܓܓܘܠܬܐ	ゴルゴタの丘
ܗܢܝܢܐ (ܡܡܫܚܘܬܐ)	利子
ܐܫܘܪ ܒܢܐܦܠ	アッシュールバニパル
ܓܕܫܐ	事故
ܦܛܪܝܪܟܐ	総主教
ا	ا
ܚܟܐ	口蓋
ت	ت
ث	ث
ج	ج
ح	ح
خ	خ
د	د
ذ	ذ
ر	ر
ܪܓܫܐ	感覚
س	س
ܟܪܟ ܣܠܘܟ (ܡܕܝܢܬܐ)	キルクーク
ܒܒܬܐ	瞳孔
ܩܒܪܐ	墓穴
ܠܒܘܢܬܐ	乳香
ܚܡܬ (ܡܕܝܢܬܐ)	ハマー (都市)
ܝܫܛܐ	食道
ܟܝܣܐ ܕܐܫܟܐ	陰嚢
ܕܒܪܐ	田舎
ܚܪܘܫܬܐ	気管
ܓܪܡܐ ܕܥܛܡܐ	大腿骨
ܒܪܐ (ܒܝܬܝܘܬܐ)	息子
ܫܚܘܪܐ	木炭
ܐܘܟܡܐ ܕܥܝܢܐ	虹彩
ܫܦܠܘܗܝ ܕܢܝܠܘܣ	ナイル川デルタ
ܐܘܪܡܝܐ	オルーミーイェ
Ϸ	Ϸ
ܓܙܪܬܐ ܐܝܘܠܝܬܐ	エオリア諸島
ܓܒܐ ܕܒܥܬ	バアス党
ܦܩܪܐ	椎骨
ܒܪ ܩܠܐ	反響
ܟܝܡܪܐ	キマイラ
ܠܘܓܡܐ	上顎骨
ܛܪܘܢܐ	独裁者
ܬܝܒܘܬܐ	告解
ܡܛܘܚܬܐ	人差し指
ܩܒܠܘܬܐ	助産師
ܐܪܙܝܪܐ	ムクドリ科
ܣܦܪܐ (ܩܢܘܢܝܐ)	法曹
Ͱ	ヘータ
ܥܡܐ ܐܪܡܝܐ	アラム人
ܟܢܘܢܬܐ (ܫܪܝܬܐ)	手首
ܐܒܐ (ܐܠܗܐ)	父なる神
ܐܢܒܐܪ (ܗܘܦܪܟܝܐ)	アンバール県
ܡܪܕܝܢ (ܡܕܝܢܬܐ)	マルディン
ܣܪܛܢܐ	キャンサー
ܡܘܪܘܢ	堅信
ܚܠܡܬܐ	乳首
ܢܘܠܐ ܕܓܘܓܝ	クモの網
ܐܫܥܝܐ	イザヤ
ܒܝܬ ܟܬܒܐ ܐܬܪܝܐ ܕܐܣܪܐܝܠ	イスラエル国立図書館
ܥܪܫܐ	大臼歯
ܢܝܢܘܐ (ܗܘܦܪܟܝܐ)	ニーナワー県
ܢܘܗܕܪܐ (ܗܘܦܪܟܝܐ)	ドホーク県
ܘܐܣܛ (ܗܘܦܪܟܝܐ)	ワーシト県
ܨܠܐܚ ܐܠܕܝܢ (ܗܘܦܪܟܝܐ)	サラーフッディーン県
ܥܘܕ	ウード
ܒܓܕܐܕ (ܗܘܦܪܟܝܐ)	バグダード県
ܣܪܓܐ	鞍
ܒܨܪܐ (ܨܒܥܐ)	薬指
ܩܛܝܣܦܘܢ	クテシフォン
ܟܒܘܫܐ	悪夢
ܢܓܦ (ܗܘܦܪܟܝܐ)	ナジャフ県
ܟܪܟ ܣܠܘܟ (ܗܘܦܪܟܝܐ)	キルクーク県
ܕܢܚܐ ܕܫܡܫܐ	天体の出没
ܬܐܪܬܐ	良心
ܒܨܪܐ (ܗܘܦܪܟܝܐ)	バスラ県
ܡܫܚܐ ܕܟܪܝܗܐ	病者の塗油
ܦܠܫܬ	ペリシテ人
ܐܠܥܐ (ܝܘܠܦܢ ܨܪܘܝܘܬܐ)	肋骨
ܥܕܬܐ ܐܝܓܘܦܛܝܬܐ	コプト正教会
ܐܢܛܝܘܟܝܐ	アンティオキア
ܐܦܪܝܡ ܣܘܪܝܝܐ	シリアのエフレム
ܐܝܙܝܕܝܐ	ヤズィーディー
ܪܝܫܘܢ ܠܬܣܝܘܢ	リション・レジオン
ܟܢܪܐ	ライアー
ܥܕܬܐ ܕܡܕܢܚܐ ܕܐܬܘܪܝܐ	アッシリア東方教会
ܬܠܐ ܕܚܕ ܐܝܠܢ	One Tree Hill
ܡܘܪܐ	没薬
ܦܕܪܠܝܐ	連邦主義
ܐܠܝܫܥ	エリシャ
ܗܟܐܪܝ (ܡܕܝܢܬܐ)	ハッキャリ
ܣܢܚܪܝܒ	センナケリブ
ܩܘܪܝܐܠܝܣܘܢ	キリエ
ܣܘܟܢܐ	舵
ܥܕܬܐ ܣܘܪܝܝܬܐ ܐܪܬܘܕܟܣܝܬܐ	シリア正教会
ܟܣܬܐ	飼料
ܩܡܫܠܝ	カーミシュリー
ܡܘܬܢܐ (ܗܘܦܪܟܝܐ)	ムサンナー県
ܡܝܫܢ (ܗܘܦܪܟܝܐ)	マイサーン県
ܣܘܠܝܡܐܢܝܐ (ܗܘܦܪܟܝܐ)	スレイマニヤ県
ܐܪܒܝܠ (ܗܘܦܪܟܝܐ)	アルビール県
ܚܠܒ (ܗܘܦܪܟܝܐ)	アレッポ県
ܟܪܒܠܐܐ (ܗܘܦܪܟܝܐ)	カルバラー県
ܦܪܨܘܦܐ	人間
ܕܝ ܩܐܪ (ܗܘܦܪܟܝܐ)	ジーカール県
ܐܢܕܪܢܝܩ ܡܐܪܓܐܪܝܐܢ	アンドラニク・マルカリャン
ܡܡܠܠܘܬ ܐܠܗܘܬܐ	キリスト教神学
ܓܘܙܐ	クルミ科
ܕܝܐܠܐ (ܗܘܦܪܟܝܐ)	ディヤーラー県
ܟܒܒ	ハバブ
ش	ش
ܩܪܫܬܐ	天井
ص	ص
ض	ض
ظ	ظ
ع	ع
غ	غ
ف	ف
ق	ق
ܚܨܪܐ	小指
ܬܐܘܡܐ	トマス
ܐܝܒܪܝܐ	イベリア
ܚܡܬ (ܗܘܦܪܟܝܐ)	ハマー県
ܡܠܐܟܐ	天使
ܫܢܬܐ ܦܫܝܛܬܐ	平年
ܡܣܘܪܩܐ ܕܐܝܕܐ	中手骨
ܕܪܥܐ (ܡܕܝܢܬܐ)	ダルアー
ܨܕܥܐ	こめかみ
ܩܠܐ	音符
ܛܘܘܝܐ	グリル
ܓܪܡܐ	骨
ܒܪܝܐܢܝ	ビリヤニ
ܠܒܠܒܬܐ	口蓋垂
ك	ك
ل	ل
م	م
ن	ن
ه	ه
و	و
ي	ي
ܥܪܒܝܐ	アラブ (曖昧さ回避)
ܓܝܕܐ ܕܓܢܫܝܐ	坐骨神経
ܒܪܬܐ (ܒܝܬܝܘܬܐ)	娘
ܗܪܗܪܐ	蜃気楼
ܚܣܟܗ (ܡܕܝܢܬܐ)	ハサカ
ܒܝܬ ܢܗܪܝܢ ܥܠܝܬܐ	ジャズィーラ
ܛܐܪܩ ܥܙܝܙ	ターリク・ミハイル・アズィーズ
ܡܣܘܪܩܐ ܕܪܓܠܐ	中足骨
ܥܪܩ	アラック
ܫܠܦܐ	刃
ܛܘܪ ܠܒܢܢ	レバノン山脈
ܐܘܛܪܝܟܛ	ユトレヒト (曖昧さ回避)
ܩܪܕܘܝܐ	クルド
ܓܐܝܘܣ	ガイウス
ܩܝܒܩ	ケベック
ܩܕܠܐ	うなじ
ܥܡܐ ܐܬܘܪܝܐ/ܣܘܪܝܝܐ	アッシリア人
ܛܘܪܐ ܕܣܝܢܝ	シナイ山
ܦܘܪܬܥܢܐ	ノミ
ܟܪܘܙܘܬܐ ܕܡܬܝ	マタイによる福音書
ܐܓܪܬܐ ܕܠܘܬ ܐܦܣܝܐ	エフェソの信徒への手紙
10000 (ܡܢܝܢܐ)	10000
ܒܢܦܫܐ	菫色
ܢܨܪܬ	ナザレ
ܟܬܒܐ ܕܡܘܪܡܘܢ	モルモン書
ܥܡܘܕܐ ܦܩܪܝܐ	脊椎
ܒܝܬ ܫܥܝܐ	スタジアム
ܓܘܕ ܫܪܠܘܛ	グッド・シャーロット
ܒܪ ܨܘܪܐ	襟
ܚܣܚܘܣܐ	軟骨
ܐܝܣܛܢܒܘܠ (ܗܘܦܪܟܝܐ)	イスタンブル県
ܝܘܢܝܐ	ギリシャ人
ܓܗܢܐ	ゲヘナ
ܬܠܫܝܬܐ ܕܩܛܠܐ ܕܐܕܘܠܦ ܗܝܛܠܪ	ヒトラー暗殺計画
ܬܐܓܘܪܬܐ	取引
ܫܝܪܢܐܟ (ܗܘܦܪܟܝܐ)	シュルナク県
ܥܘܩܣܐ	針 (生物)
ܟܗܢܘܬܐ	神品機密
ܚܒܘܪ	ハブール川
ܗܕܡܐ ܓܘܝܐ	器官
ܚܡܬܐ (ܒܝܬܝܘܬܐ)	義親
ܡܥܠܘܠܐ	マアルーラ
ܐܘܪܘܦܐ	ヨーロッパ (曖昧さ回避)
ܐܘܣܛܪܠܝܐ	オーストラリア (曖昧さ回避)
ܡܦܩܬܐ ܦܫܝܛܬܐ	ペシタ訳
ܐܪܚܘܬܐ	サービス精神
ܚܘܐ	イヴ
ܗܘܦܪܟܝܣ ܕܥܝܪܐܩ	イラクの地方行政区画
ܒܝܬ ܟܬܒܐ ܕܐܫܘܪ ܒܢܐܦܠ	アッシュールバニパルの図書館
ܒܕܘܩܐ	ボーイスカウト
ܥܘܕܪܢܐ:ܚܒܝܫܬ̈ܐ	Help:目次
ܓܦܬܐ	つる植物
ܡܝܟܐܝܠ	マイケル
ܐܣܛܘܡܟܐ	胃
ܓܢܬܐ	庭園
ܕܪܓܘܫܬܐ	ゆりかご
ܘܝܩܝܦܕܝܐ:ܐܝܙܓܕܘܬܐ	Wikipedia:大使館
ܫܠܝܬܐ	胎盤
ܒܝܬ ܛܘܣܐ	空港
ܒܝܬ ܫܡܪܝܐ	サマリア
ܐܓܢܣ ܡܘ	アグネス・モニカ
ܣܕܪܐ:ܓܪܡܢ	Category:ドイツ
ܣܕܪܐ:ܐܝܛܠܝܐ	Category:イタリア
ܣܕܪܐ:ܐܬܪܘܬܐ ܡܚܝܕܐ ܕܐܡܪܝܩܐ	Category:アメリカ合衆国
ܣܕܪܐ:ܪܘܣܝܐ	Category:ロシア
ܣܕܪܐ:ܩܢܕܐ	Category:カナダ
ܣܕܪܐ:ܐܝܣܪܐܝܠ	Category:イスラエル
ܣܕܪܐ:ܛܘܪܩܝܐ	Category:トルコ
ܣܕܪܐ:ܡܨܪܝܢ	Category:エジプト
ܣܕܪܐ:ܐܝܪܐܢ	Category:イラン
ܥܐܕܐ	祝日
ܣܕܪܐ:ܥܝܪܐܩ	Category:イラク
ܣܕܪܐ:ܗܘܠܢܕܐ	Category:オランダ
ܣܕܪܐ:ܦܘܠܢܕ	Category:ポーランド
ܣܕܪܐ:ܛܝܪܐ	Category:鳥類
ܣܕܪܐ:ܝܥܝܬܐ	Category:植物
ܣܕܪܐ:ܬܘܕܝܬܐ	Category:宗教
ܣܕܪܐ:ܝܕܥܬܐ	Category:科学
ܕܪܥܐ (ܗܘܦܪܟܝܐ)	ダルアー県
ܩܠܒܐ:Box-footer	Template:Box-footer
ܢܩܘܕ	ニクダー
ܚܝܠܐ	体力
ܡܪܝܡ (ܚܬܗ ܕܡܘܫܐ)	ミリアム
ܣܕܪܐ:ܬܘܚܡܐ ܐܚܪܢܐ	Category:曖昧さ回避
ܣܕܪܐ:ܡܫܝܚܝܘܬܐ	Category:キリスト教
ܣܕܪܐ:ܐܣܠܐܡ	Category:イスラム教
ܣܕܪܐ:ܝܗܘܕܝܘܬܐ	Category:ユダヤ教
ܠܩܐ ܕܣܦܝܢܬܐ	櫂
ܙܚܘܪܝܬܐ (ܓܘܢܐ)	スカーレット
ܐܢܩܪܐ (ܗܘܦܪܟܝܐ)	アンカラ県
ܐܢܕܪܐܘܣ	アンドレ
ܐܝܪܠܢܕ	アイルランド (曖昧さ回避)
ܝܘܢܢ	ヨナ
ܐܨܪܐ	調味料
ܕܝܪܝܟ	マリキヤ
ܫܘܫܡܬܐ	ゴマ
ܣܕܪܐ:ܘܝܩܝܦܕܝܐ	Category:カテゴリを集めたカテゴリ
ܣܕܪܐ:ܝܒܫܬܐ	Category:大陸
ܝܙܦܬܐ	債務
ܦܨܝܕܐ	池
ܐܪܓܘܢܐ	紫
ܢܘܪܢܝܐ	角錐
ܘܝܩܝܦܕܝܐ:HotCat	Wikipedia:HotCat
ܒܛܐ	カモ
ܗܝܟܠܐ ܕܫܠܝܡܘܢ	エルサレム神殿
ܩܠܒܐ:ܓܕܫܐ ܗܫܝܐ	Template:最近の出来事
ܣܕܪܐ:ܡܟܬܒܢܘܬܐ ܕܐܬܪܘܬܐ	Category:国
ܘܝܩܝܦܕܝܐ:ܡܕܒܪܢܐ	Wikipedia:管理者
ܣܕܪܐ:ܫܕܬܐ	Category:職業
ܘܝܩܝܦܕܝܐ:ܒܘܬ̈ܐ	Wikipedia:Bot
ܣܕܪܐ:ܙܒܢܐ	Category:時間
ܣܕܪܐ:ܙܘܙܐ	Category:貨幣
ܣܕܪܐ:ܝܘܠܦܢ ܨܪܘܝܘܬܐ	Category:解剖学
ܣܕܪܐ:ܐܣܝܘܬܐ	Category:医学
ܫܡܥܘܢ (ܫܡܐ)	シモン
ܡܨܪܝܢ	エジプト
ܩܠܒܐ:Bot	Template:Bot
ܩܢܕܐ	カナダ
ܣܕܪܐ:ܝܘܢ	Category:ギリシャ
ܣܕܪܐ:ܣܘܝܕ	Category:スウェーデン
ܩܠܒܐ:ܐܫܛܪܘܬܐ	Template:Documentation
ܣܕܪܐ:User languages	Category:言語別の利用者
ܦܘܠܚܢܐ	企業
ܩܠܒܐ:Softredirect	Template:Softredirect
ܩܠܒܐ:Delete	Template:即時削除
ܡܓܕܠܐ (ܩܪܝܬܐ)	マグダラ
ܣܕܪܐ:ܛܟܢܘܠܘܓܝܐ	Category:技術
ܓܒܪܐܝܠ (ܫܡܐ)	ガブリエル (曖昧さ回避)
ܡܝܟܐܝܠ (ܫܡܐ)	ミカエル (曖昧さ回避)
ܣܕܪܐ:ܠܫܢܐ	Category:諸言語
ܣܕܪܐ:ܩܢܘܢܐ ܕܠܥܙܐ	Category:文法
ܘܝܩܝܦܕܝܐ:General disclaimer	Wikipedia:免責事項
ܣܕܪܐ:Noindexed pages	Category:検索エンジンに収集されないページ
ܘܝܩܝܦܕܝܐ:ܕܘܒܪܐ	Wikipedia:スタイルマニュアル
ܩܠܒܐ:Navbox	Template:Navbox
ܩܠܒܐ:!	Template:!
ܣܕܪܐ:ܩܠܒܐ ܐܬܘܬܐ ܕܐܝܣܘ	Category:旗のテンプレート
ܩܠܒܐ:ܡܦܐܬܐ ܩܠܒܐ	Template:Tnavbar
ܩܠܒܐ:Clear	Template:Clear
ܘܝܩܝܦܕܝܐ:ܡܟܬܒܘܬܐ ܕܡܓܠܐ ܠܟܠ ܘܝܩܝܦܕܝܐ	Wikipedia:すべての言語版にあるべき項目の一覧
ܣܕܪܐ:ܝܪܚܐ ܕܫܢܬܐ	Category:月 (暦)
ܩܠܒܐ:Babel	Template:Babel
ܩܠܒܐ:Commons	Template:Commons
ܩܠܒܐ:Reflist	Template:Reflist
ܩܠܒܐ:User ar-1	Template:User ar-1
ܩܠܒܐ:User az	Template:User az
ܩܠܒܐ:See also	Template:See also
ܩܠܒܐ:User de	Template:User de
ܩܠܒܐ:User es	Template:User es
ܩܠܒܐ:User en-3	Template:User en-3
ܩܠܒܐ:User en-1	Template:User en-1
ܩܠܒܐ:User en-2	Template:User en-2
ܩܠܒܐ:User en-4	Template:User en-4
ܩܠܒܐ:User en-0	Template:User en-0
ܩܠܒܐ:User en	Template:User en
ܩܠܒܐ:User fa	Template:User fa
ܩܠܒܐ:User fr-1	Template:User fr-1
ܩܠܒܐ:User he-2	Template:User he-2
ܩܠܒܐ:User he-1	Template:User he-1
ܩܠܒܐ:User sk	Template:User sk
ܩܠܒܐ:User tr	Template:User tr
ܩܠܒܐ:User ja	Template:User ja
ܩܠܒܐ:User fr	Template:User fr
ܩܠܒܐ:User he	Template:User he
ܣܕܪܐ:ܐܣܝܐ	Category:アジア
ܣܕܪܐ:ܕܪܐ ܕܥܣܪܝܢ ܘܚܕ	Category:21世紀
ܩܠܒܐ:Mod	Template:Mod
ܩܠܒܐ:User sv	Template:User sv
ܩܠܒܐ:Infobox language/codelist	Template:Infobox Language/codelist
ܩܠܒܐ:User it	Template:User it
ܣܕܪܐ:ܝܘܡܐ ܕܫܒܘܥܐ	Category:曜日
ܣܕܪܐ:ܐܨܪܐ	Category:調味料
ܩܠܒܐ:ܝܗܘܝܬܐ Peru	Template:Country data Peru
ܩܠܒܐ:ܝܗܘܝܬܐ Paraguay	Template:Country data Paraguay
ܩܠܒܐ:Edit	Template:Edit
ܩܠܒܐ:ܝܗܘܝܬܐ French Guiana	Template:Country data Guyana
ܩܠܒܐ:ܝܗܘܝܬܐ Argentina	Template:Country data Argentina
ܩܠܒܐ:Navbox suite	Template:Navbox suite
ܩܠܒܐ:Category other	Template:Category other
ܩܠܒܐ:ܡܟܬܒܢܘܬܐ ܕܝܦܬܐ	Template:Collapsible list
ܩܠܒܐ:Sidebar	Template:Sidebar
ܩܠܒܐ:Ambox	Template:Ambox
ܩܠܒܐ:Navigation templates	Template:Navigational templates
ܩܠܒܐ:ܐܬܪܐ	Template:基礎情報 国
ܩܠܒܐ:ܝܬܝܪ	Template:Catmore2
ܩܠܒܐ:/box-header	Portal:Box-header
ܣܕܪܐ:User en	Category:User en
ܣܕܪܐ:User zh	Category:User zh
ܩܠܒܐ:ܐܠܦܒܝܬ ܥܪܒܝܐ	Template:アラビア文字 (語末形のみ)
ܣܕܪܐ:User zh-N	Category:User zh-N
ܩܠܒܐ:ܨܢܕܘܩ ܪܡܙܐ2	Template:Infobox
ܩܠܒܐ:User zh	Template:User zh
ܩܠܒܐ:Navbox/core	Template:Navbox/core
ܩܠܒܐ:ܐܫܛܪܘܬܐ/ܨܢܕܘܩ ܫܪܝܬܐ	Template:Documentation/start box
ܩܠܒܐ:Documentation/end box2	Template:Documentation/end box2
ܩܠܒܐ:Documentation/start box2	Template:Documentation/start box2
ܩܠܒܐ:ܩܠܒܐ ܐܚܪܝܢܐ	Template:Template other
ܩܠܒܐ:ܐܠܦܒܝܬ ܠܐܛܝܢܝܐ	Template:A-Z
ܣܕܪܐ:ܦܐܦܐ	Category:教皇
ܩܠܒܐ:Pp-template	Template:Pp-template
ܩܠܒܐ:User nl-1	Template:User nl-1
ܩܠܒܐ:User nl-2	Template:User nl-2
ܣܕܪܐ:ܪܝܫܝ ܩܘܛܢܝܘܬܐ	Category:大統領
ܩܠܒܐ:User ru	Template:User ru
ܩܠܒܐ:IPA	Template:IPA2
ܣܕܪܐ:ܗܪܘܡܐ	Category:香辛料
ܣܕܪܐ:ܦܠܫܬ	Category:パレスチナ
ܣܕܪܐ:ܡܠܐܟܐ	Category:天使
ܣܕܪܐ:ܢܒܝܐ	Category:預言者
ܩܠܒܐ:Rellink	Template:Rellink
ܩܠܒܐ:Category redirect	Template:Category redirect
ܩܠܒܐ:ܝܗܘܝܬܐ Venezuela	Template:Country data Venezuela
ܩܠܒܐ:ܨܢܕܘܩ ܡܕܒܪܢܐ	Template:Infobox Officeholder
ܩܠܒܐ:Sortname	Template:Sortname
ܩܠܒܐ:Border	Template:Border
ܩܠܒܐ:ܡܢܝܢܐ ܕܝܪܚܐ	Template:MONTHNUMBER
ܩܠܒܐ:ܪܕ	Template:Fmbox
ܩܠܒܐ:ܝܗܘܝܬܐ Chile	Template:Country data Chile
ܩܠܒܐ:GUA	Template:GTM
ܩܠܒܐ:User nl	Template:User nl
ܩܠܒܐ:Navbox years	Template:NavboxYears
ܩܠܒܐ:ܡܣܦܩ ܩܐܫ	Template:Purge
ܩܠܒܐ:ܨܢܕܘܩ ܐܡܢܐ	Template:Infobox 芸術家
ܩܠܒܐ:ܡܦܠܚܢܐ	Template:User
ܣܕܪܐ:ܬܘܢܣ	Category:チュニジア
ܩܠܒܐ:Sec link auto	Template:Sec link auto
ܩܠܒܐ:Cmbox	Template:Cmbox
ܩܠܒܐ:Mbox	Template:Mbox
ܩܠܒܐ:Oppose	Template:反対
ܩܠܒܐ:COL	Template:COL
ܩܠܒܐ:PER	Template:PER
ܩܠܒܐ:ܨܢܕܘܩ ܡܕܥܐ ܕܝܒܫܬܐ	Template:Infobox Continent
ܩܠܒܐ:User ar-2	Template:User ar-2
ܩܠܒܐ:User ar-3	Template:User ar-3
ܩܠܒܐ:User ar	Template:User ar
ܩܠܒܐ:ܝܘܡܐ ܕܫܒܘܥܐ	Template:曜日
ܣܕܪܐ:ܡܕܝܢܬܐ ܒܐܘܚܕܢܐ ܡܚܝܕܐ	Category:アメリカ合衆国の都市
ܩܠܒܐ:ܬ.ܐ.	Template:Aimai
ܩܠܒܐ:No	Template:中止
ܣܕܪܐ:ܩܠܒܐ ܨܢܕܘܩܐ	Category:基礎情報テンプレート
ܩܠܒܐ:Partial	Template:Partial
ܩܠܒܐ:ܩܘܕܝܟܘܣ ܕܣܕܪܐ	Template:CategoryTOC
ܩܠܒܐ:?	Template:?
ܩܠܒܐ:ܝܗܘܝܬܐ Colombia	Template:Country data Colombia
ܣܕܪܐ:User yue	Category:User zh-yue
ܣܕܪܐ:User az	Category:User az
ܣܕܪܐ:User sk	Category:User sk
ܣܕܪܐ:User fr	Category:User fr
ܣܕܪܐ:User ja	Category:User ja
ܣܕܪܐ:User la	Category:User la
ܣܕܪܐ:User pt	Category:User pt
ܣܕܪܐ:User ro	Category:User ro
ܣܕܪܐ:User sv	Category:User sv
ܣܕܪܐ:User ko-N	Category:User ko-N
ܩܠܒܐ:User yue	Template:User zh-yue
ܣܕܪܐ:ܗܘܦܪܟܝܣ ܕܥܝܪܐܩ	Category:イラクの県
ܩܠܒܐ:Cat main	Template:Catmore
ܣܕܪܐ:User ar	Category:User ar
ܣܕܪܐ:User arc	Category:User arc
ܣܕܪܐ:User da	Category:User da
ܣܕܪܐ:User sk-N	Category:User sk-N
ܣܕܪܐ:User de	Category:User de
ܣܕܪܐ:User el	Category:User el
ܣܕܪܐ:User en-N	Category:User en-N
ܣܕܪܐ:User es	Category:User es
ܣܕܪܐ:User fa	Category:User fa
ܣܕܪܐ:User fi	Category:User fi
ܣܕܪܐ:User he	Category:User he
ܩܠܒܐ:N/a	Template:N/a
ܣܕܪܐ:User hy	Category:User hy
ܣܕܪܐ:ܠܫܢܐ ܥܒܪܝܐ	Category:ヘブライ語
ܣܕܪܐ:ܡܕܝܢܬܐ ܒܐܝܣܪܐܝܠ	Category:イスラエルの都市
ܣܕܪܐ:User it	Category:User it
ܣܕܪܐ:User ko	Category:User ko
ܣܕܪܐ:ܒܬܫܪܝܢ ܐܚܪܝ	Category:11月
ܣܕܪܐ:ܝܡܡܐ	Category:海
ܩܠܒܐ:ܐܠܦܒܝܬ ܝܘܢܝܐ	Template:ギリシア文字
ܩܠܒܐ:No2	Template:No2
ܩܠܒܐ:Rh	Template:Rh
ܩܠܒܐ:ܢܒܝܐ ܕܕܝܬܝܩܝ ܥܬܝܩܬܐ	Template:旧約聖書の預言者
ܩܠܒܐ:ܣܡܘܩܐ	Template:Red-text
ܣܕܪܐ:ܒܝܬܝܘܬܐ	Category:親族
ܩܠܒܐ:ܝܗܘܝܬܐ Brazil	Template:Country data Brazil
ܩܠܒܐ:Yes2	Template:Yes2
ܩܠܒܐ:Yes-No	Template:Yes-No
ܬܪܥܐ:ܬܘܕܝܬܐ	Portal:宗教
ܣܕܪܐ:ܪܝܫܝ ܩܘܛܢܝܘܬܐ ܥܠ ܐܬܪܐ	Category:各国の大統領
ܣܕܪܐ:User ru	Category:User ru
ܣܕܪܐ:User ru-3	Category:User ru-3
ܣܕܪܐ:User tl	Category:User tl
ܣܕܪܐ:User tr	Category:User tr
ܣܕܪܐ:ܙܡܪܐ	Category:音楽家
ܩܠܒܐ:Lang	Template:Lang
ܣܕܪܐ:ܪܫܘܡܐ	Category:画家
ܩܠܒܐ:ܫܠܝܚܐ ܕܡܫܝܚܐ	Template:使徒
ܩܠܒܐ:Busy/Doc	Template:Busy
ܣܕܪܐ:ܐܡܢܐ ܥܠ ܐܕܫܐ	Category:種類別の職業
ܩܠܒܐ:ܚܡܫܐ ܐܘܩܝܢܘ	Template:五大洋
ܩܠܒܐ:CHI	Template:CHL
ܣܕܪܐ:ܡܕܝܢܬܐ ܒܐܢܓܠܢܕ	Category:イングランドの居住地 (カウンティ別)
ܣܕܪܐ:ܢܝܓܪ	Category:ニジェール
ܣܕܪܐ:ܝܘܠܦܢ ܩܢܘܢܝܐ	Category:法学
ܩܠܒܐ:Infobox language/family-color	Template:Infobox Language/family-color
ܣܕܪܐ:ܣܥܪܐ	Category:髪型
ܣܕܪܐ:ܢܗܪܘܬܐ	Category:河川
ܩܠܒܐ:User he-3	Template:User he-3
ܩܠܒܐ:User ko	Template:User ko
ܩܠܒܐ:User pt	Template:User pt
ܣܕܪܐ:User nl	Category:User nl
ܣܕܪܐ:User no	Category:User no
ܣܕܪܐ:ܣܘܪܝܐ	Category:シリア
ܣܕܪܐ:ܕܪܐ ܩܕܡܝܐ	Category:1世紀
ܣܕܪܐ:ܓܙܪܬܐ ܝܒܫܢܝܬܐ	Category:半島
ܣܕܪܐ:ܗܘܦܪܟܝܣ ܕܗܘܠܢܕܐ	Category:オランダの州
ܣܕܪܐ:ܡܢܝܢܐ	Category:整数
ܣܕܪܐ:ܡܕܝܢܬܐ ܕܥܝܪܐܩ	Category:イラクの都市
ܣܕܪܐ:ܥܝܢܐ (ܨܪܘܝܘܬܐ)	Category:目
ܣܕܪܐ:ܓܘܪܓܝܐ	Category:グルジア
ܣܕܪܐ:ܟܘܘܝܬ	Category:クウェート
ܣܕܪܐ:ܠܒܢܢ	Category:レバノン
ܣܕܪܐ:ܪܝܫܝ ܩܘܛܢܝܘܬܐ ܕܐܬܪܘܬܐ ܡܚܝܕܐ ܕܐܡܪܝܩܐ	Category:アメリカ合衆国の大統領
ܣܕܪܐ:ܝܘܪܕܢܢ	Category:ヨルダン
ܣܕܪܐ:ܦܐܪܐ	Category:果物
ܣܕܪܐ:ܝܘܠܦܢ ܟܘܪܗܢܐ	Category:病理学
ܣܕܪܐ:ܓܒܐ	Category:政党
ܣܕܪܐ:ܕܝܬܝܩܝ ܚܕܬܐ	Category:新約聖書
ܣܕܪܐ:ܕܝܬܝܩܝ ܥܬܝܩܬܐ	Category:旧約聖書
ܣܕܪܐ:ܐܘܩܝܢܘ	Category:大洋
ܣܕܪܐ:ܓܪܡܐ	Category:骨
ܣܕܪܐ:ܗܘܦܪܟܝܣ ܘܐܘܚܕܢܐ ܕܩܢܕܐ	Category:カナダの州
ܣܕܪܐ:ܚܝܘܬܐ	Category:動物
ܣܕܪܐ:ܛܘܪܐ	Category:山地
ܣܕܪܐ:ܣܘܥܪܢܐ	Category:事件
ܣܕܪܐ:ܟܘܪܗܢܐ	Category:病気
ܣܕܪܐ:User pl	Category:User pl
ܣܕܪܐ:ܡܕܒܪܐ	Category:砂漠
ܣܕܪܐ:ܝܡܡܬܐ	Category:湖
ܩܠܒܐ:ܨܢܕܘܩ ܡܚܡܝܬܐ ܡܨܥܝܐ	Template:ディスクメディア
ܩܠܒܐ:ܨܢܕܘܩ ܪܡܙܐ ܕܠܫܢܐ	Template:Infobox Language
ܣܕܪܐ:ܩܛܠܥܡܐ	Category:大量虐殺
ܣܕܪܐ:ܡܠܟܘܬܐ ܕܗܘܠܢܕܐ	Category:オランダ王国
ܨܝܢ	チャイナ
ܣܕܪܐ:ܠܫܢܐ ܘܠܥܙܐ ܨܝܢܝܐ	Category:中国語の方言
ܛܪܘܝܐܢܝ	トロヤニ (マゾフシェ県)
ܫܪܓܐ	ランプ
ܩܠܒܐ:Sister	Template:Sister
ܩܠܒܐ:ܝܗܘܝܬܐ Falkland Islands	Template:Country data Falkland Islands
ط	ط
ܣܕܪܐ:ܒܝܬ ܟܬܒܐ	Category:図書館
ܣܕܪܐ:ܐܪܙܐ	Category:サクラメント
ܣܕܪܐ:ܒܝܬ ܢܗܪܝܢ	Category:古代メソポタミア
ܣܕܪܐ:ܓܘܢܐ	Category:色
ܣܕܪܐ:ܦܣܩܐ ܕܝܘܡܐ	Category:一日の部分
ܕܒܘܪܐ (ܪܚܫܐ)	ハチ
ܩܠܒܐ:ܣܘܪܓܕܐ ܚܘܫܒܢܐ	Template:Year in other calendars
ܣܕܪܐ:ܩܕܝܫܐ	Category:聖人
ܩܪܕܐ (ܪܚܫܐ)	マダニ
ܩܠܒܐ:ܣܝܩܘܡ ܫܘܪܝܐ	Template:Start date
ܩܠܒܐ:User nl-3	Template:User nl-3
ܩܠܒܐ:Tim	Template:Tim
ܩܠܒܐ:ܠܫܢܐ ܨܝܢܝܐ	Template:中国語
ܩܠܒܐ:P1	Template:P1
ܢܘܓܗܐ	明け方
ܩܠܒܐ:Sec link/normal link	Template:Sec link/normal link
ܩܠܒܐ:Sec link/text	Template:Sec link/text
ܘܝܩܝܦܕܝܐ:NavFrame	Help:ダイナミック・ナビゲーション・ボックス
ܩܠܒܐ:Infobox language/genetic	Template:Infobox Language/genetic
ܟܘܕܐ	悪露
ܕܝܠܢܝܐ:ܫܘܚܠܦ̈ܐ ܚܕ̈ܬܐ	特別:最近の更新
ܘܙܐ	雁
