Noowe	ノルウェー
Amereka	アメリカ合衆国
Finilandi	フィンランド
Swiiden	スウェーデン
Denimaaka	デンマーク
Bupoolo	ポーランド
Lithueenia	リトアニア
Yitale	イタリア
Buyonaani	ギリシャ
Buturuki	トルコ
Bulaaya	ヨーロッパ
Wikipedia	ウィキペディア
Berlin	ベルリン
Paris	パリ
Gatonnya	1月
Kenya	ケニア
Mbwa	イヌ
Rwasha	ロシア
Girimane	ドイツ
Isilandi	アイスランド
Emu	1
Bbiri	2
Ssatu	3
Nnya	4
Ttaano	5
Zeero	0
Vilnius	ヴィリニュス
Chile	チリ
Jesu Kristo	イエス・キリスト
Mathematics	数学
Napooleon Bonapat	ナポレオン・ボナパルト
Moosko	モスクワ
Ebimera	植物
Nepal	ネパール
Tanzania	タンザニア
Yuganda	ウガンダ
Uetersen	ユーテルゼン
Helsinki	ヘルシンキ
Baibuli	聖書
Ho Chi Minh City	ホーチミン市
Kkanisa ya Yeso Eyannamaddala	真イエス教会
Dong Hoi	ドンホイ
Concepción	コンセプシオン (チリ)
Kurów	クルフ
Santiago, Chile	サンティアゴ (チリ)
Kampala	カンパラ
Osasco	オザスコ (サンパウロ州)
Curitiba	クリチバ
Category:Okubala	Category:数学
Olupapula Olusooka	メインページ
Saratov	サラトフ
Category:Candidates for speedy deletion	Category:即時削除対象のページ
Kilimanjaro	キリマンジャロ
Ekiwandiiko Eky'abantu Bonna Ekifa ku Ddembe Ly'obunto	世界人権宣言
Ronald Reagan	ロナルド・レーガン
Fernando Alonso	フェルナンド・アロンソ
Ennamba	数
Template:Link FA	Template:Link FA
Wikipedia:Community Portal	Wikipedia:井戸端
Mwenda	9
Bien Hoa	ビエンホア
Nha Trang	ニャチャン
Breinigerberg	ブライニガーベルク
Vung Tau	ブンタウ
Musanvu	7
Munaana	8
Mukaaga	6
Moshchena	モシュチェナ
Paltoga	パルトガ
Entrena	エントレナ
Las Vegas	ラスベガス
Kkumi	10
Nowy Dwór Królewski	ノヴィ・ドゥヴル・クルレフスキ
Ca Mau	カマウ
Pichilemu	ピチレム
Phan Thiet	ファンティエット
Reverse transcriptase	逆転写酵素
Luganda	ガンダ語
Buon Ma Thuot	バンメトート
Anastacia	アナスタシア (歌手)
Thanh Hoa	タインホア
Ben Tre	ベンチェ
Kkumi na bbiri	12
Kkumi n'emu	11
Kkumi na ssatu	13
Kikumi	100
Kakadde kamu	1000000
Kkumi na nnya	14
Sekazzi	スイカ
Kkumi na ttaano	15
Kkumi na munaana	18
Kkumi na mwenda	19
Kkumi na musanvu	17
Kkumi na mukaaga	16
Amakumi abiri	20
Amakumi ana	40
Amakumi asatu	30
Lukumi	1000
Lacuna Coil	ラクーナ・コイル
Amakumi abiri mu ssatu	23
Ekirwadde ky’ebola	エボラ出血熱
Amakumi abiri mu ttaano	25
Amakumi abiri mu nnya	24
Nkaaga	60
Coronel Fabriciano	コロネル・ファブリシアーノ
Amakumi abiri mu mukaaga	26
Caayi	チャノキ
Mbogo	アフリカスイギュウ
Ntaulira	ラーテル
Retrovirus	レトロウイルス科
Bikumi bitaano	500
Kyenda	90
Nkumi bbiri	2000
Lukaaga	600
Amakumi ana mu ssatu	43
Mutwalo gumu	10000
Amakumi abiri mu musanvu	27
Amakumi asatu mu ttaano	35
Paramore	パラモア
Buganda	ブガンダ
Amakumi abiri mu mwenda	29
Breuberg	ブロイベルク
Amakumi abiri mu munaana	28
Amakumi asatu mu munaana	38
Amakumi ana mu ttaano	45
Kinaana	80
Abiri mu emu	21
Abiri mu bbiri	22
Nsanvu	70
Amakumi ataano	50
Amakumi ana mu emu	41
Amakumi asatu mu nnya	34
Amakumi asatu mu ssatu	33
Amakumi ana mu musanvu	47
Amakumi asatu mu emu	31
Amakumi asatu mu bbiri	32
Amakumi ana mu nnya	44
Amakumi ana mu mukaaga	46
Amakumi asatu mu musanvu	37
Amakumi asatu mu mwenda	39
Amakumi asatu mu mukaaga	36
Bikumi bibiri	200
Lusanvu	700
Nkumi nnya	4000
Lwenda	900
Jonava	ヨナヴァ
Lunaana	800
Klaipėda	クライペダ
Pigazzano	ピガッツァーノ
Amakumi ana mu bbiri	42
Nkumi ssatu	3000
Hosjö	ホーショー
Nkumi ttaano	5000
Kenda	9000
Kanaana	8000
Kakaaga	6000
Kasanvu	7000
Bikumi bisatu	300
Category:Girimane	Category:ドイツ
Category:Yitale	Category:イタリア
Category:Rwasha	Category:ロシア
Category:Buturuki	Category:トルコ
Category:Bupoolo	Category:ポーランド
Category:Vietnam	Category:ベトナム
Category:Ebimera	Category:植物
Category:Okumanya	Category:科学
Bikumi bina	400
Category:Stub	Category:スタブ
Mitwalo ebiri	20000
Category:Ensi	Category:国
Wikipedia:Administrators	Wikipedia:管理者
Kaunas	カウナス
Template:Bot	Template:Bot
Category:Denimaaka	Category:デンマーク
Category:Finilandi	Category:フィンランド
Category:Isilandi	Category:アイスランド
Category:Lithueenia	Category:リトアニア
Category:Swiiden	Category:スウェーデン
Category:Bulaaya	Category:ヨーロッパ
Template:Documentation	Template:Documentation
Category:Wikipedians by language	Category:言語別の利用者
Wikipedia:Userbox	Wikipedia:ユーザーボックス
Template:Softredirect	Template:Softredirect
Template:Delete	Template:即時削除
Category:Wikipedia	Category:ウィキペディア
Wikipedia:Statistics	Wikipedia:統計
Template:Col-break	Template:Col-break
Template:Col-begin	Template:Col-begin
Template:Col-end	Template:Col-end
Wikipedia:Vital articles	Wikipedia:すべての言語版にあるべき項目の一覧
Category:Aafrika	Category:アフリカ
Category:Ennamba	Category:数
Template:Babel	Template:Babel
Template:Stub	Template:Stub
Template:See also	Template:See also
Template:User de	Template:User de
Template:User de-1	Template:User de-1
Template:User de-3	Template:User de-3
Template:User en-3	Template:User en-3
Template:User en-2	Template:User en-2
Template:User lg-4	Template:User en-4
Template:User en-0	Template:User en-0
Template:User en	Template:User en
Template:User tr	Template:User tr
Category:Eezia	Category:アジア
Template:Esoteric	Template:複雑なテンプレート
Template:Mod	Template:Mod
Template:User sv	Template:User sv
Template:SIL	Template:Infobox Language/codelist
Template:Image label	Template:Image label
Template:Done	Template:済
Template:Documentation/docname	Template:Documentation/docname
Category:User en	Category:User en
Category:User en-2	Category:User en-2
Template:Infobox	Template:Infobox
Template:User nl-2	Template:User nl-2
Category:Byabulimi	Category:農業
Category:Language user templates	Category:バベル
Template:User nl	Template:User nl
Template:Image label end	Template:Image label end
Template:POL	Template:POL
Template:Image label small	Template:Image label small
Template:Bulaaya	Template:ヨーロッパ地図
Template:User lt	Template:User lt
Template:User is	Template:User is
Template:User fr-5	Template:User fr-5
Template:User en-5	Template:User en-5
Category:Infobox templates	Category:基礎情報テンプレート
Template:FRA	Template:FRA
Category:User lt	Category:User lt
Template:User ru-2	Template:User ru-2
Category:User sv-3	Category:User sv-3
Category:User tr	Category:User tr
Category:User tr-N	Category:User tr-N
Template:Lang	Template:Lang
Template:User sv-3	Template:User sv-3
Template:User lb-2	Template:User lb-2
Template:User zh-4	Template:User zh-4
Category:Yuganda	Category:ウガンダ
Category:Noowe	Category:ノルウェー
Category:Capitals of the World	Category:首都
Template:UGA	Template:UGA
Template:Lang-pl	Template:Lang-pl
Trojany	トロヤニ (マゾフシェ県)
Template:User sw	Template:User sw
Template:Image label begin	Template:Image label begin
Wikipedia:VisualEditor	Wikipedia:ビジュアルエディター
Special:RecentChanges	特別:最近の更新
