ທະວີບອາຟະລິກ	アフリカ
ປະເທດຍີ່ປຸ່ນ	日本
ທະວີບອາເມລິກາໃຕ້	南アメリカ
ປະເທດນອກແວດ	ノルウェー
ປະເທດອັງກິດ	イングランド
ປະເທດເອກົດ	スコットランド
ປະເທດການ	ウェールズ
ປະເທດອຽກລັງ	アイルランド
ປະເທດຮົງກະລີ	ハンガリー
ປະເທດແອສະປາຍ	スペイン
ສະຫະລັດອາເມລິກາ	アメリカ合衆国
ປະເທດແບນຊິກ	ベルギー
ປະເທດລູກຊຳບວກ	ルクセンブルク
ໂລກ	地球
ປະເທດແຟງລັງ	フィンランド
ປະເທດຊູແອດ	スウェーデン
ປະເທດດານມາກ	デンマーク
ປະເທດໂປໂລຍ	ポーランド
ປະເທດລີຕົວນີ	リトアニア
ປະເທດອິຕາລີ	イタリア
ປະເທດສະວິດ	スイス
ປະເທດໂອຕະລິດ	オーストリア
ປະເທດກະແລັດ	ギリシャ
ປະເທດຕວກກີ	トルコ
ເບຍ	ビール
ປະເທດປອກຕຸຍການ	ポルトガル
ທະວີບເອີລົບ	ヨーロッパ
ອາຊີ	アジア
ທະວີບອາເມລິກາເໜືອ	北アメリカ
ທະວີບອັງຕາກຕິກ	南極大陸
ວິກິພີເດຍ	ウィキペディア
ປະເທດໂຮນລັງ	オランダ
ຄອມພິວເຕີ	コンピュータ
ອິນເຕີເນັດ	インターネット
ບາຣັກ ໂອບາມາ	バラク・オバマ
ປະເທດອູຣູກວາຍ	ウルグアイ
ຈັກພິມ	プリンター
ລອນດອນ	ロンドン
ປາລີ	パリ
ແອນດຣອຍດ໌	Android
ກູໂກລ	Google
ປະເທດເມັກຊິກ	メキシコ
ມະຫາສະໝຸດອັດລັງຕິກ	大西洋
ມະຫາສະໝຸດປາຊີຟິກ	太平洋
ວັນຈັນ	月曜日
ເດືອນມັງກອນ	1月
ກຸມພາ	2月
ມີນາ	3月
ເມສາ	4月
ພຶດສະພາ	5月
ມິຖຸນາ	6月
ກໍລະກົດ	7月
ສິງຫາ	8月
ກັນຍາ	9月
ຕຸລາ	10月
ພະຈິກ	11月
ທັນວາ	12月
ວັນອັງຄານ	火曜日
ວັນພຸດ	水曜日
ວັນພະຫັດ	木曜日
ວັນສຸກ	金曜日
ວັນເສົາ	土曜日
ວັນອາທິດ	日曜日
ປະເທດຝະລັ່ງ	フランス
ໝາ	イヌ
ສະຫະລາຊະອານາຈັກ	イギリス
ແມວ	ネコ
ປະເທດຈີນ	中華人民共和国
ພາສາຝະລັ່ງ	フランス語
ປະເທດບະເຣຊິນ	ブラジル
ປະເທດລັດເຊຍ	ロシア
ຮູບຈັດຕຸລັດ	正方形
ທະເລ	海
ແຂວງເກແບັກ	ケベック州
ປະເທດເຢຍລະມັນ	ドイツ
ປະເທດບີເອໂລລຸດ	ベラルーシ
ປະເທດອີສະລັງ	アイスランド
ປະເທດແອສະໂຕນີ	エストニア
ຍົນ	飛行機
ຮູບສີ່ແຈສາກ	長方形
ມຸມສາກ	直角
ປະເທດແລດໂຕນີ	ラトビア
ປະເທດອູກະແລນ	ウクライナ
ສາທາລະນະລັດແຊັກ	チェコ
ປະເທດສະໂລວາກີ	スロバキア
ປະເທດສະໂລເວນີ	スロベニア
ປະເທດລູມານີ	ルーマニア
ປະເທດບູນກາລີ	ブルガリア
ປະເທດມາເຊດວນ	マケドニア共和国
ປະເທດກະໂລອາຊີ	クロアチア
ປະເທດບົດສະນີແຮກເຊໂກວີນ	ボスニア・ヘルツェゴビナ
ປະເທດອາແຊກບາຍຊັງ	アゼルバイジャン
ປະເທດອັງດອກ	アンドラ
ປະເທດຊີບ	キプロス
ປະເທດເຊອັອກຊີ	グルジア
ປະເທດມານ	マルタ
ປະເທດໂມນາໂກ	モナコ
ປະເທດແຊັງມາແລງ	サンマリノ
ຫໍແອບແຟນ	エッフェル塔
ຄີບອດ	キーボード (コンピュータ)
ປະເທດອິນໂດເນເຊຍ	インドネシア
ໂທລະພາບ	テレビ
ປະເທດຈີເລ	チリ
ພຣະເຢຊູ	イエス・キリスト
ປະຫວັດສາດ	歴史
ພາສາ	言語
ລະບອບຜະເດັດການ	独裁政治
ບິກແບງ	ビッグバン
ດາຣາສາດ	天文学
ປະເທດສິງກະໂປ	シンガポール
ວິທະຍາສາດ	科学
ມົງເລອານ	モントリオール
ປະເທດລິກເຕນສະຕາຍ	リヒテンシュタイン
ກິລາ	スポーツ
ອາໂດນ ຮິດແລ	アドルフ・ヒトラー
ເຟດບຸກ	Facebook
ສົງຄາມໂລກຄັ້ງທີສອງ	第二次世界大戦
ໂມງ	時計
ອຸບຸນຕູ	Ubuntu
ລິນຸກຊ໌	Linux
ຄະນິດສາດ	数学
ພາສາລາແຕັງ	ラテン語
ປະເທດອາກເມນີ	アルメニア
ປະເທດແຊກບີ	セルビア
ດວງຈັນ	月
ປະເທດອົດສະຕະຣາລີ	オーストラリア
ວັດຖຸວິທະຍາ	物理学
ປະເທດອາກຊັງຕິນ	アルゼンチン
ໂທລະຄົມມະນາຄົມ	電気通信
ປະເທດເປຣູ	ペルー
ຊີວະສາດ	生物学
ປະເທດກຳປູເຈຍ	カンボジア
ໄດໂນເສົາ	恐竜
ສາສະໜາອິສະລາມ	イスラム教
ຈິດ	心
ສັນຕິພາບ	平和
ກາບກອນ	詩
ຈັກກະພັດນາໂປເລອົງທີ 1	ナポレオン・ボナパルト
ປີແສງ	光年
ໂອເຊອານີ	オセアニア
ລະບົບສຸລິຍະ	太陽系
ປຶ້ມ	本
ມື້	日
ປີ	年
ອົກຊີແຊນ	酸素
ດົນຕີ	音楽
ພາສາອິຕາລີ	イタリア語
ອາລູມິນຽມ	アルミニウム
ປະເທດນູແວນເຊລັງ	ニュージーランド
ປະເທດປາປົວຊີນູແວນກີເນ	パプアニューギニア
ປະເທດເວເນຊູເອລາ	ベネズエラ
ສັດ	動物
ປະເທດຊູຣີນາມ	スリナム
ປະເທດປາຣາກວາຍ	パラグアイ
ປະເທດກຸຍຢານ	ガイアナ
ສິລະປະ	芸術
ປະເທດເອກົວເຕີ	エクアドル
ປະເທດໂກລົມບີ	コロンビア
ພຸດທະສາສະໜາ	仏教
ປະເທດໂບລີວີ	ボリビア
ປະເທດກົວເຕມາລາ	グアテマラ
ປະເທດອີຣານ	イラン
ປະເທດກົດສະຕາລິກາ	コスタリカ
ປະເທດລາວ	ラオス
ທະວີບອາເມລິກາ	アメリカ州
ງົວ	ウシ
ປະເທດມາເລເຊຍ	マレーシア
ປະເທດມຽນມາ	ミャンマー
ປະລາຕົງ	プラトン
ຢູທູບ	YouTube
ປະເທດໄທ	タイ王国
ລົດໄຟ	列車
ປະເທດຫວຽດນາມ	ベトナム
ປະເທດເກົາຫຼີໃຕ້	大韓民国
ປະເທດບັງກະລາເທດ	バングラデシュ
ປະເທດອັງໂກລາ	アンゴラ
ທະວິດເຕີ	Twitter
ປະເທດບູໄນ	ブルネイ
ປະເທດຟີລິບປິນ	フィリピン
ປັກກິ່ງ	北京市
ວິວັດທະນາການ	進化
ສະຫະປະຊາຊາດ	国際連合
ທໍລະນີສາດ	地質学
ພູມສາດ	地理学
ສີ	色
ຄຳນາມ	名詞
ປະເທດໂກໂຊໂວ	コソボ
ໝວດ:ມູນຖານ	Category:主要カテゴリ
ລະດູໜາວ	冬
ລະດູບານໃໝ່	春
ລະດູຮ້ອນ	夏
ລະດູໃບໄມ້ຫຼົ່ນ	秋
ພາສາແອສະປາໂຍນ	スペイン語
ໝາກໄມ້	果実
ເງິນ	貨幣
ລັດນີວຢອກ	ニューヨーク州
Uetersen	ユーテルゼン
Microsoft Windows	Microsoft Windows
ໄທບີຣຽສ	ティベリウス
ລົດ	自動車
ບອກໂດ	ボルドー
ໂຕກຽວ	東京都
ບາກເຊໂລນ	バルセロナ
ໝາກນັດ	パイナップル
ກາໂຕລິກ	カトリシズム
ພະຄຳພີ	聖書
ພະນົມເປັນ	プノンペン
ນິກາຍໂບດທູຈີຊັດ	真イエス教会
ພາສາອັງກິດ	英語
ບາງກອກ	バンコク
ດົງເຮີຍ	ドンホイ
ໂກຣິສໂກໂວລາ	コィンスコヴォラ
ປີ 2009	2009年
ປີ 2008	2008年
ອາຫານ	食品
XML	Extensible Markup Language
ການປະຕິວັດອຸດສາຫະກຳ	産業革命
ໄມໂຄຼຊອຟທ໌	マイクロソフト
ຄູໂຣ	クルフ
ເຄມີສາດ	化学
14 ກຸມພາ	2月14日
22 ມີນາ	3月22日
16 ເມສາ	4月16日
ອາໂນນ ຊວາເຊເນກເກີ	アーノルド・シュワルツェネッガー
19 ກໍລະກົດ	7月19日
ເຕະບານ	サッカー
ໄອໂຟນ	IPhone
ເຮືອດຳນ້ຳ	潜水艦
ໄມເຄິ້ນ ແຈັກຊັ້ນ	マイケル・ジャクソン
ພະລາຊະວັງແວກໄຊ	ヴェルサイユ宮殿
ມະຫາວິຫານນົດ-ດາມ	ノートルダム大聖堂 (パリ)
ໝວດ:ແມ່ແບບ	Category:ウィキペディアのテンプレート
ແມ່ນ້ຳອາມາຊົນ	アマゾン川
ໂຮງຮຽນ	学校
ມະຫາວິທະຍາໄລ	大学
ວິກິພີເດຍ:Sandbox	Wikipedia:サンドボックス
ວິກິພີເດຍ:ເລີ່ມຕົ້ນ	Wikipedia:ウィキペディアへようこそ
ເຮືອນ	家屋
ທະວີບອົດສະຕະຣາລີ	オーストラリア大陸
ຮາດແວ	ハードウェア
ພຶດຊະຄະນິດ	代数学
ສະໜາມບິນດົງເຮີຍ	ドンホイ空港
ອາວະກາດ	宇宙空間
ປ່າໄມ້	森林
ຂົງຈື້	孔子
ມາຣິລິນ ມອນໂຣ	マリリン・モンロー
ໝວດ:ຄະນິດສາດ	Category:数学
ເອີໂລ	ユーロ
ທະເລເມດີແຕກລາເນ	地中海
ຄິດຕະສາສະໜາ	キリスト教
Windows 8	Microsoft Windows 8
ເຂົ້າຈ້າວ	米
ທະວີບ	大陸
ສັດປີກ	鳥類
ນະຄອນຫຼວງ	首都
ພາສາປອກຕຸຍການ	ポルトガル語
ເດືອນ	月 (暦)
1949	1949年
ຕາກດີກະລາດາ	緩歩動物
ພາສາຍີ່ປຸ່ນ	日本語
ໜ້າຈໍ	ディスプレイ (コンピュータ)
ສາລານຸກົມ	百科事典
ໜ້າຫຼັກ	メインページ
ຊີພີຢູ	CPU
ເຣົາເຕີຣ໌	ルーター
ໂຕຕ້ານໄຟຟ້າ	抵抗器
ທຣານຊິສເຕີ	トランジスタ
ເບດບອນ	野球
ບານບ້ວງ	バスケットボール
ກິລາໂອແລມປິກ	近代オリンピック
ລົດເມ	バス (交通機関)
ແຄວ້ນກາຕາໂລຍ	カタルーニャ州
ການຮ່ວມເພດ	性行為
ປັດຊະຍາ	哲学
ຈິມິ ເຮນດຣິກຊ໌	ジミ・ヘンドリックス
ໝວດ:Candidates for speedy deletion	Category:即時削除対象のページ
ອະນາທິປະໄຕ	アナキズム
ລັດທິທຶນນິຍົມ	資本主義
ປະເທດ	国
ເວັບເບຣົາວ໌ເຊີຣ໌	ウェブブラウザ
Boeing 737	ボーイング737
ໝວດ:ດາຣາສາດ	Category:天文学
ການປະຕິວັດຝະລັ່ງ	フランス革命
ຮັກຮ່ວມເພດ	同性愛
ອາຫານຝະລັ່ງ	フランス料理
ໂຮແມ	ホメーロス
ພາສາກາຕາລັງ	カタルーニャ語
ພຣະພຸດທະເຈົ້າ	仏陀
ອະເທວະນິຍົມ	無神論
ຫໍສະໝຸດ	図書館
ນິເວດສາດ	生態学
ການເມືອງ	政治
ລະບອບປະຊາທິປະໄຕ	民主主義
ໂລກາພິວັດ	グローバリゼーション
ແຊນ	遺伝子
ລັດຖະບານ	政府
ຄວາມສວຍງາມ	美
ລາຊາທິປະໄຕ	君主制
ລັດ	国家
ດັງ	鼻
ເພງ	歌
ເດິນຟິນ	イルカ
ສັດລ້ຽງລູກດ້ວຍນ້ຳນົມ	哺乳類
ໂລຊີຊີແອນ	ソフトウェア
ອາເດແອັນ	デオキシリボ核酸
ແອສະແປດ	種 (分類学)
ພາສາລັດເຊຍ	ロシア語
ກົດໝາຍ	法 (法学)
ລັດຖະທຳມະນູນ	コンスティチューション (法学)
ສະມາຄົມປະຊາຊາດແຫ່ງອາຊີຕາເວັນອອກສຽງໃຕ້	東南アジア諸国連合
ກອງທືນການເງີນລະຫວ່າງປະເທດ	国際通貨基金
ພາສາສະວາຮີລີ	スワヒリ語
ພາສາຈີນ	中国語
ທຳມະຊາດ	自然
ນ້ຳດື່ມ	飲料水
ພາສາລູມານີ	ルーマニア語
ສຶກສາສາດ	教育学
ແຮ່ທາດ	鉱物
ເຊັນ	禅
ເມົາສ໌	マウス (コンピュータ)
ປະໂລເຕອິນ	タンパク質
ພະຍຸໂທຣນາໂດ	竜巻
ໄຕມຸມ	三角法
ເລຂາຄະນິດ	幾何学
ໄວຍະກອນ	文法
ນິນເທັນໂດ	任天堂
ເສດຖະສາດ	経済学
ທຶນ	資本
ເງິນຕາ	通貨
ເຢນ	円 (通貨)
ອຸດສາຫະກຳ	産業
ພາສີ	租税
ພາສາສາດ	言語学
ຄຳ (ພາສາສາດ)	語
ໂຕໜັງສືເກຣັກ	ギリシア文字
ວັນນະຄະດີ	文学
ໝວດ:ປະເທດຝະລັ່ງ	Category:フランス
ໝວດ:ດົນຕີ	Category:音楽
ໝວດ:ວັນນະຄະດີ	Category:文学
ຂັ້ນຕອນວິທີ	アルゴリズム
ການສຶກສາ	教育
ຄອບຄົວ	家族
ກາເຟ	コーヒー
ນົມ	乳
ສົງຄາມເຢັນ	冷戦
ຊຽງໄຮ້	上海市
ອິນເຕີຣ໌ເນັຕ ໂປຣໂຕໂຄລ	Internet Protocol
ໄບຕ໌	バイト (情報)
ບິຕ	ビット
ຄວາມຮູ້	知識
ສາສະໜາພາມ	ヒンドゥー教
ປະລະມະນູ	原子
ພາສາກະເລັກ	ギリシア語
ລະບົບປະຕິບັດການ	オペレーティングシステム
ອີແມລ	電子メール
ສາສະໜາ	宗教
ພາສາເກົາຫຼີ	朝鮮語
ຕຶກແອັມພາຍສະເຕດ	エンパイア・ステート・ビルディング
ອະນຸສາວະລີເທພີເສລີພາບ	自由の女神像 (ニューヨーク)
ພາສາລາວ	ラーオ語
ພາສາໄທ	タイ語
ສາສະໜາຊູດາ	ユダヤ教
ພາສາການ	ウェールズ語
ສາສະໜາຊິກ	シク教
ຈອນ ເມນາດ ເຄນ	ジョン・メイナード・ケインズ
ວຽງຈັນ	ヴィエンチャン
ພຶຕິກຳ	行動
ອາລົມ	感情
ຈິຕະວິທະຍາ	心理学
ຄວາມຄຶດ	思考
ມະຫາສະໝຸດ	大洋
ຈະລິຍະທຳ	倫理学
ຍານວິທະຍາ	認識論
ເຈດຈຳນົງເສລີ	自由意志
ແກນກາງ	カーネル
ສົມເດັດພະລາຊິນີນາດເອລີຊາແບັດທີ 2 ແຫ່ງສະຫະລາຊະອານາຈັກ	エリザベス2世
ຄວາມທຸກຍາກ	貧困
ຕາລາງທາດ	周期表
ເດິນຟິນໜູ	ネズミイルカ科
ກົກໄມ້	木
ເນີຍແຂງ	チーズ
ຜັກ	野菜
ໂຣບົດ	ロボット
ເຕັກໂນໂລຊີ	テクノロジー
ກົນຈັກ	機械
ວິສະວະກຳ	工学
ສານສົນເທດ	情報
ໜັງສືພິມ	新聞
ໂທລະສັບ	電話機
ວັດທະນະທຳ	文化
ຫມາຍເລກໄອພີ	IPアドレス
ແພດສາດ	医学
ອົງກອນນິຕິບັນຍັດ	立法府
ຫ້ຽນ	荒らし
ສົມຜົນ	方程式
ຕຳລາ (ຄະນິດສາດ)	関数 (数学)
ກະລູຊິດ	炭水化物
ຮອກມົນ	ホルモン
ເກມ	ゲーム
ຂອງຫຼິ້ນ	玩具
ຮູບເງົາ	映画
ລົດຖີບ	自転車
ກຳປັ່ນ	船
ກະສິກຳ	農業
ລາຍຊື່ໜ່ວຍນັບເວລາ	時間
ເຈ້ຍ	紙
ປະລາສະຕິກ	合成樹脂
ເນື້ອທີ່	面積
ຈຳນວນ	数
ຈຳນວນສົນ	複素数
ແມັດ	メートル
ຈິຕະກຳ	絵画
ນັກອາວະກາດ	宇宙飛行士
ການຖ່າຍຮູບ	写真
ການຟ້ອນລຳ	ダンス
ເອເລັກໂຕຣນິກ	電子機器
ສ່ວນປະກອບເອເລັກໂຕຣນິກ	電子部品
ດີອົດ	ダイオード
ເຕັກໂນໂລຊີຂໍ້ມູນຂ່າວສານ	情報技術
ຕະຫລາດຫລັກຊັບ	証券取引所
ຮ້ານອາຫານ	レストラン
ອາຊີຕາເວັນອອກສຽງໃຕ້	東南アジア
ບະລັງແນດ	白雪姫
ຊັງດີຢົງ	シンデレラ
ປະຕິທິນ	暦
ເຂດເວລາ	時間帯 (標準時)
ສຸຂະພາບ	健康
ເອດສ໌	後天性免疫不全症候群
ສະຖາປັດຕະຍະກຳ	建築
ຂົວ	橋
ເຂົ້າໜົມມາກາຣົງ	マカロン
ສະຖິຕິສາດ	統計学
ຈຳນວນຖ້ວນ	整数
ເຂື່ອນສາມຜາ	三峡ダム
ຍຸກແສງສະຫວ່າງ	啓蒙時代
ສະໄໝກາງ	中世
ລວມຍອດຜະລິດຕະພັນພາຍໃນ	国内総生産
ແຟຊັ້ນ	ファッション
ລູກຄິດ	アバカス
ຄາບສະໝຸດອີເບລີ	イベリア半島
ຈຳນວນຈິງ	実数
ໝາກຟະແລດ	イチゴ
ໝາກກ້ຽງ	オレンジ
ພາສາຈ້ວງ	チワン語
ພາສານາວາເທິນ	ナワトル語
ສິ່ງແວດລ້ອມສໍາລັບການພັດທະນາແບບຮວບຮວມ	統合開発環境
ພາສາອາຣັບ	アラビア語
ພາສາອົກຊີຕັງ	オック語
ນາຍົກລັດຖະມົນຕີ	首相
ສໍດຳ	鉛筆
ໂຕະ	テーブル (家具)
ແທັງເກີ	タンカー
ກວາງຄໍຍາວ	キリン
ພາສາເຊ	C言語
ວິກິພີເດຍ:ບົດຄວາມດີເດັ່ນ	Wikipedia:秀逸な記事
ແມ່ແບບ:Link FA	Template:Link FA
ວິກິພີເດຍ:Village pump	Wikipedia:井戸端
ກວ່າງໂຈວ	広州市
ໂຮງໜໍ	病院
ການສົມລົດເພດດຽວກັນ	同性結婚
ໂທລະສັບມືຖື	携帯電話
ລົດສະນິຍົມທາງເພດ	性的指向
ງົວປ່າອາເມລິກາ	バイソン属
ບານເຕະໂລກ	FIFAワールドカップ
ຍາຈາງ	ニャチャン
ສາທາລະນະສົມບັດ	パブリックドメイン
ກຸ່ມພາສາໂລມັງ	ロマンス諸語
ຮູບສາມແຈ	三角形
ຈຳນວນທຳມະຊາດ	自然数
ສັດທະອັກສອນສາກົນ	国際音声記号
ສະມາດໂຟນ	スマートフォン
ພິກັດພູມສາດ	地理座標系
ເກີບ	靴
ເສລີພາບໃນການເວົ້າ	表現の自由
ສວນສາທາລະນະ	公園
ສັບປະດາ	週
ຜັກທຽມ	ニンニク
ມະນຸດສາດ	人類学
ເອແດມບວກ	エディンバラ
កោះ	島
ພາສາລັດຖະການ	公用語
ບູຮານວິທະຍາ	考古学
ອຸດທະຍານແຫ່ງຊາດຟົງ ງາ-ເຄ ບັງ	フォンニャ＝ケバン国立公園
ແຂວງກວາງບິນ	クアンビン省
ເສັ້ນສູນສູດ	赤道
ປະໂລແຕສະຕັງ	プロテスタント
ວັດຈະນານຸກົມ	辞典
ເພງຊາດ	国歌
ຄຳກຳມະ	動詞
ພາສາແຟໂລ	フェロー語
ສັດກິນຊີ້ນ	ネコ目
ເກາະຊີແລນ	シェラン島
ເຮືອຂ້າມຟາກ	フェリー
ປະດິດໃຊ້ເອງ	DIY
ເສັ້ນຜົມ	毛 (動物)
ວິຊາຊີບ	専門職
ສິນຄ້າ	財
ຜົນຕຳລາ	微分法
ບລອກ	ブログ
ນົກແກ້ວ	オウム目
ຊື່ໂດເມນ	ドメイン名
ມ້າລາຍ	シマウマ
ເລກມາຕະຖານສາກົນປະຈຳປຶ້ມ	ISBN
ພາສາຈາໂມໂລ	チャモロ語
ພາສາເຈໂລກີ	チェロキー語
ຈິຕະນິຍົມ	観念論
ຫົວສີໄຄ	レモングラス
ເສັ້ນຂະໜານ	緯度
ໝວດ:ພາສາໂປແກມ	Category:プログラミング言語
ຈັດສະຕິນ ບີເບີ	ジャスティン・ビーバー
ກຸ່ມພາສາໄທ-ກະໄດ	タイ・カダイ語族
ເນີຍ	バター
ເທວະວິທະຍາ	神学
ນ້ຳຕົກຕາດນີອາກາລາ	ナイアガラの滝
ໂຫລາສາດ	占星術
ຫົງ	ハクチョウ属
ຫົນທາງ	道路
ເຮລີກົບແຕ	ヘリコプター
ລົດຈັກ	オートバイ
ມ້າແມ່ນ້ຳ	カバ
ສັງຄົມສາດ	社会科学
ແຫຼມ	半島
ລະຫັດໂທລະສັບລະຫວ່າງປະເທດ	国際電話番号の一覧
ຟົວກາ	フォアグラ
ມົນທົນ	プロヴィンス
ໝາກຫຸ່ງ	パパイア
ວິຕາມິນ	ビタミン
ເວັບໄຊຕ໌	ウェブサイト
ກວາງອູດ	ヘラジカ
ເສືອອາເມລິກາ	ジャガー
ສະພາ	議会
ສະພາວະເງິນເຟີ້	インフレーション
ເຮືອ	ボート
ໂປລີເນຊີ	ポリネシア
ດຽນບຽນຟູ	ディエンビエンフー
ໝີໄຮ້ຫາງ	コアラ
ເສັ້ນແວງ	経度
ສະຫັດສະວັດ	ミレニアム
ຊ້າງຂົນຍາວ	マンモス
ອອງ ຊານ ຊຸຈີ	アウンサンスーチー
ໄຂ້ຫວັດຫມູ	豚インフルエンザ
ເສິນຫຼົງ	ジャッキー・チェン
ເອກະລາດ	独立
ມະຣິວຸລ	マリウポリ
ມະຫາປີລະມິດ ແຫ່ງ ກິຊາ	ギザの大ピラミッド
ISO 4217	ISO 4217
ຕະຫຼາດ	市場
ກະໂລໂມຊົມ	染色体
ມັນດ້າງ	サツマイモ
ພະຍັນຊະນະ	子音
ນ້ຳຕົກຕາດຄອນພະເພັງ	コーンパペンの滝
ຟີລຳ	門 (分類学)
ພະເຈົ້າຮົງລີທີ 8 ແຫ່ງອັງກິດ	ヘンリー8世 (イングランド王)
ຂ່າວ	ニュース
ດັດສະນີການພັດທະນາມະນຸດ	人間開発指数
ເສດຖະສາດຈຸນລະພາກ	ミクロ経済学
ສັດລ້ຽງ	ペット
ເລເຈບ ໄຕຢິບ ແອໂດກັນ	レジェップ・タイイップ・エルドアン
ນໍ້າມັນເຊື້ອໄຟ	ガソリン
ເສດຖະສາດມະຫາພາກ	マクロ経済学
ສະໜວນກາຊາ	ガザ地区
ເຄື່ອງດື່ມ	飲料
ປະໂລກະລຳ ແອງຟອກມາຕິກ	プログラム (コンピュータ)
ຍານອາວະກາດ	宇宙機
ເຈັນນິເຟີຣ໌ ໂລເປສ	ジェニファー・ロペス
ມີດຕັດ	はさみ
ຊ້າງທະເລ	セイウチ
ຕຶກ	建築物
ແມ່ນ້ຳຂອງ	メコン川
ວາລະສານ	雑誌
ສານ	裁判所
Rupiah ອິນໂດເນເຊຍ	ルピア
ປະໂຫຍກ	文
.la	.la
ສວນລອຍຟ້າບາບິລອນ	バビロンの空中庭園
ໝາແຜງ	ハイエナ
ພິ່ນອິ່ນ	ピン音
ເຊື້ອໄຟ	燃料
ອູດແກະໃຫຍ່	リャマ
ຄວາຍ	スイギュウ
Long Thanh International Airport	ロンタイン国際空港
ຍານພາຫະນະ	乗り物
ນ້ຳມັນ	油
ວິນຍານນິຍົມ	アニミズム
ບໍລິການຂໍ້ຄວາມສັ້ນ	ショートメッセージサービス
ເຮືອນຄົວ	台所
ຮັກຮ່ວມສອງເພດ	両性愛
ເອສົບ	アイソーポス
ສິ່ງແວດລ້ອມ	自然環境
ໂກແລສະເຕໂລນ	コレステロール
ສະຫະພັນທະລັດ	連邦
ໄຂ້ຫວັດນົກ	鳥インフルエンザ
ມາຕຣິກ	行列
ຕຳນານ	伝説
ເທວາທິປະໄຕ	神権政治
ຂົວໂກນເດນເກດ	ゴールデンゲートブリッジ
ໝາກສຸກ ໝາກໃສ	水痘
ທ່າເຮືອ	港湾
Vaishnavism	ヴィシュヌ派
ໝາກມີ້	パラミツ
ທຸງຊາດລາວ	ラオスの国旗
ໃບສະຫຼຸບຊັບສົມບັດ	貸借対照表
ສາຍການບິນ	航空会社
ເສດຖະສາດສາກົນ	国際経済学
ວັນກຳມະກອນສາກົນ	メーデー
ລາດາ	レーダー
ແມ່ແບບ:Commonscat	Template:Commonscat
ຈັກກະວັດແອສະປາຍ	帝国
ມະຫາຍານ	大乗仏教
ກະສວຍອາວະກາດ	スペースシャトル
ການທ່ອງທ່ຽວ	観光
ຕູ້ໄປສະນີ	郵便ポスト
Visual Basic .NET	Microsoft Visual Basic .NET
ແຂວງ	ラオスの地方行政区画
ຕຳລາຂັ້ນສອງ	二次関数
ອີໂບລາ	エボラ出血熱
ໝວດ:ລັດຖະບານ	Category:政府
ໝວດ:ຄວາມຮັກ	Category:愛
ສະຖານີລົດໄຟ	鉄道駅
ພາສາໂຮປີ	ホピ語
ພາສາເຮົາຊາ	ハウサ語
ພາສາໄທເໜືອ	シャン語
ຈູມມະລີ ໄຊຍະສອນ	チュンマリー・サイニャソーン
ຫງວຽນເຕິນຢຸງ	グエン・タン・ズン
ຍິ່ງລັກ ຊິນນະວັດ	インラック・シナワトラ
ທອງສິງ ທຳມະວົງ	トーンシン・タムマヴォン
ກ້ອງດິຈິຕອນ	デジタルカメラ
ອັດຕາແລກປ່ຽນ	為替レート
ທະນາຄານກາງ	中央銀行
ການຜັງເມືອງ	都市計画
ຮອບບິດ (ປຶ້ມ)	ホビットの冒険
ຄະນາທິປະໄຕ	寡頭制
Current events	Wikipedia:発表
ບານເຕະໂລກ 2014	2014 FIFAワールドカップ
ການແຍກໃຊ້ອຳນາດ	権力分立
ໝາກກ້ຽງໃຫຍ່	ブンタン
ວົງຈອນພອນ	マングース科
ໄຟຟ້າພະລັງນໍ້າ	水力発電
ວິສະວະກຳໂລຊີຊີແອນ	ソフトウェア工学
ອູດແກະ	アルパカ
ຄວາມກົດອາກາດ	気圧
ບ່ວງ	スプーン
VoIP	VoIP
ໄມ້ຖູ່	箸
ກຳລັງຊື້ທຽບຖານ	購買力平価説
ເຄື່ອງໝາຍວັກ	句読点
ຕັກຊີ	タクシー
ຄຳອຸທານ	感動詞
ພຽງພອນເໝັນ	スカンク
ເຊລີນ້າ ໂກເມຊ	セレーナ・ゴメス
ໂຮງງານ	工場
ບານເຕະທີມຊາດບະເລຊິນ	サッカーブラジル代表
ບານໂປໂລຍ	ポーランドボール
ຕຳລາໄຕມຸມ	三角関数
ຄຣິສຕະຈັກເຊເວັນເດ ແອັດເວັນຕິສ	セブンスデー・アドベンチスト教会
PAL	PAL
ອຳນາດຕຸລາການ	司法
ຄວາມສະເໝີພາກທາງເພດ	男女同権
ເຂົ້າຫນຽວ	もち米
ລັດທິ	ドクトリン
ກະລັງກັງຢົງ	グランド・キャニオン
ແມ່ນ້ຳເຈົ້າພະຍາ	チャオプラヤー川
ຊຸບເປີຄອມພິວເຕີ	スーパーコンピュータ
ໂຄງສ້າງພື້ນຖານ	インフラストラクチャー
ໜູລ້າງນ້ຳ	アライグマ
ຕົ້ນໂຣສ ເມຣີ	ローズマリー
ປະເທດທີ່ບໍ່ມີທາງອອກສູ່ທະເລ	内陸国
ເວັກເຕີ	ベクトル空間
ປຶ້ມເອເລັກໂຕຣນິກ	電子書籍
ພາສີມູນຄ່າເພີ່ມ	消費税
ພະເຈົ້າເອດູອາກທີ 3 ແຫ່ງອັງກິດ	エドワード3世 (イングランド王)
Mikoyan MiG-29	MiG-29 (航空機)
ການພັດທະນາແບບຍືນຍົງ	持続可能な開発
ອ່າວໄທ	タイランド湾
ການວາງແຜນຊັບພະຍາກອນຂອງອົງກອນ	企業資源計画
ນິກາຍເຖຣະວາດ	上座部仏教
ໂທລະພາບຄວາມລະອຽດສູງ	高精細度テレビジョン放送
ທຸງຊາດໄທ	タイの国旗
ພະຍຸໄຕ້ຝຸ່ນ	台風
ດຸນການຊຳລະ	国際収支統計
ລະດູແລ້ງ	乾季
Phu Quoc	フーコック島
ປະເທດລາວໃນໂອລິມປິກລະດູຮ້ອນ 2008	北京オリンピックラオス選手団
ວິກິພີເດຍ:ຂໍໃຫ້ຂະຫຍາຍ	Help:ページの編集
Leopard 2	レオパルト2
ວົງຜື	カヤツリグサ科
ເດຈາວູ	既視感
ເຄື່ອງຮັບວິທະຍຸ	受信機
Eurocopter Tiger	ティーガー (航空機)
ເສດຖະກິດ	経済
ເອໂຄໂນເມທຣິກ	計量経済学
ລາຄາ	価格
ມະຫາວິທະຍາໄລເອແດມບວກ	エディンバラ大学
ທາງລົດໄຟ	線路 (鉄道)
ສຳປະສິດຈິນີ	ジニ係数
ກາຕະລີນແຫ່ງອາລາກົງ	キャサリン・オブ・アラゴン
ໝາກເຜັດ	唐辛子
ບິກ	ペン
ໝາກກ້າຍ	プランテン
ທືນສັບພະຍາກອນມະນຸດ	ヒューマン・キャピタル
ການສະໜອງ ແລະ ຄວາມຕ້ອງການ	需要と供給
ຊອດໄຂ່ແດງ	マヨネーズ
ENIAC	ENIAC
ຊຸດຈຳນວນ	級数
ພັດທະຍາ	パッタヤー
ດອກເບ້ຍ	利子
ຫຸ່ນຍົນສາດ	ロボット工学
Boeing AH-64 Apache	AH-64 アパッチ
ອຸປະຕິເຫດ	事故
ຢາງລຶບ	消しゴム
ເຂື່ອນຮູເວີ	フーバーダム
ນູເມລິກ	デジタル
ລະບົບມາດຕະຖານຄຳ	金本位制
Sukhoi Su-27	Su-27 (航空機)
ການບັນເທີງ	エンターテインメント
កាំ	半径
ມະຫາວິຫານແຊັງໂປນ	セント・ポール大聖堂
ຍິວວິທະຍາໄລຂອງເຢຣູຊາເລັມ	ヘブライ大学
ມະຫາວິທະຍາໄລແຄລິຟໍເນຍ ລອດແອນເຈລິດ	カリフォルニア大学ロサンゼルス校
ຊັງຕີແມັດ	センチメートル
ມິລີແມັດ	ミリメートル
ມິໂກຣແມັດ	マイクロメートル
ລາຍຊື່ປະເທດຮຽງຕາມຄວາມໜ້າແໜ້ນຂອງປະຊາກອນ	国の人口密度順リスト
ເສດຖະກິດຕົກຕໍ່າ	景気後退
ເມນເຟຣມ	メインフレーム
ບໍ່ນ້ຳຮ້ອນ	熱水泉
ເນັຕບຸກ	ネットブック
ນະໂຍບາຍເງິນຕາ	金融政策
ນາໂນແມັດ	ナノメートル
ການຄ້າສາກົນ	貿易
ຈອຍສະຕິກ	ジョイスティック
ເທວະດາ	神性
ລົດໂຮງໝໍ	救急車
ຈັງຫວັດພູເກັດ	プーケット県
ເສັ້ນສະແດງ	グラフ (関数)
ສູດເຮລົງ	ヘロンの公式
ບັນທັດຖານວັດແທກ ລາຍໄດ້ ແລະ ຜົນຜະລິດ ແຫ່ງຊາດ	国民総生産
ຕົ້ນທຶນໂອກາດ	機会費用
ວົງເຫງັນ	ジャコウネコ科
ນະໂຍບາຍການເງິນ	財政政策
ເຄື່ອງໝາຍຊາດຂອງໄທ	タイの国章
ຕຳລາເສັ້ນຊື່	一次関数
ປະຊາທິປະໄຕແບບມີຜູ້ແທນ	間接民主制
ທະນາຄານພັດທະນາອາຊີ	アジア開発銀行
ເນີຍແຂງລົກຟອກ	ロックフォール (チーズ)
ການຂະຫຍາຍໂຕທາງເສດຖະກິດ	経済成長
ເມືອງຫຼວງພະບາງ	ルアンパバーン郡
ສົມເດັດພະລາຊາທິບະດີເຟລີເປທີ 6 ແຫ່ງແອສະປາຍ	フェリペ6世 (スペイン王)
ວັນນະຍຸດ	声調
ນ້ຳເຕົ້າຮູ້	豆乳
ການຊົມໃຊ້	消費
ປິໂກແມັດ	ピコメートル
ເພດສຶກສາ	性教育
ການຕ່ຳ	織り
ກະຊວງ	省
ວັດຖຸດິບ	原材料
ຄອມພິວເຕີຣ໌ຈໍາລອງ	仮想機械
ຈອງ	お玉杓子
ລົດພະລັງງານໄຟຟ້າ	電気自動車
ຫີນະຍານ	小乗
Dassault Mirage 2000	ミラージュ2000 (戦闘機)
ເງີນກີບລາວ	キープ (通貨)
ເດຊີແມັດ	デシメートル
ຄວາມຮັ່ງມີ	富
ເຄື່ອງໝາຍຊາດລາວ	ラオスの国章
ພະຍາດໄລມ	ライム病
ທໍ	Tor
ໂທລະພາບແບບດິຈິຕໍລ໌	デジタルテレビ放送
ຕານ ສ່ວຍ	タン・シュエ
ຮູບເງົາກາຕູນ	アニメーション映画
ປະໂລແວງ	プロヴァン
ຕຳລາຂັ້ນສາມ	三次関数
Sukhoi Su-30	Su-30 (航空機)
ໂວນຟຣາມອານຟາ	Wolfram Alpha
ຈັງຫວັດຊົນບຸລີ	チョンブリー県
ສິລະປະປະຍຸກ	応用美術
ແວງກາແບກເນໂຊວີຍົງ	カベルネ・ソーヴィニヨン
‍ໃບອະນຸຍາດຂອງຊອຟຕ໌ແວຣ໌	ソフトウェアライセンス
ເພງຊາດໄທ	タイの国歌
ອາຊີອາຕິກ	モンゴロイド
กงสุล	領事
ລົດອັກຄີໄຟ	消防車
ເຟັມໂຕແມັດ	フェムトメートル
ການທົດສອບສົມມຸດຕິຖານສະຖິຕິ	仮説検定
ປັດໃຈການຜະລິດ	生産要素
ສຸລິຍະຄະຕິ	太陽暦
ລັດຖະບານເອເລັກໂຕຣນິກ	電子政府
ວາຈົກ	態
ຜູ້ຊົມ	観客
ແບບຈຳລອງ IS/LM	IS-LM分析
ຟຣີແລນເຊີຣ	フリーランス
ຄວາມໄດ້ປຽບທຽບຖານ	比較優位
ພຣະໄຕຣປິດົກ	パーリ語経典
ຄະລາວາດນິຍົມ	世俗主義
ນັກໂທດການເມືອງ	政治犯
ສະໜາມບິນສາກົນວັດໄຕ	ワットタイ国際空港
າເປັນ	アングン
ຄວາມຍືດຍຸ່ນ	弾力性
ຂະບວນການຄືນສູ່ເຢລູຊາເລມ	バック・トゥー・エルサレム
ຂົວມິດຕະພາບ ລາວ-ໄທ ແຫ່ງທີສອງ	第2タイ＝ラオス友好橋
ຈັງຫວັດຊຽງໃໝ່	チエンマイ県
ໂດລາເອມອນ	ドラえもん
ຈັງຫວັດສົງຂາ	ソンクラー県
ຊາຍບອກ	サイボーグ
ຈັງຫວັດສະຕູນ	サトゥーン県
ອັກສອນໄທ	タイ文字
ຈັງຫວັດຊຽງຮາຍ	チエンラーイ県
ຈັງຫວັດກະບີ່	クラビー県
ຈັງຫວັດປັດຕານີ	パッターニー県
ຈັງຫວັດລະນອງ	ラノーン県
T-80	T-80
ຈັງຫວັດພິຈິດ	ピチット県
ຈັງຫວັດນະຄອນສະຫວັນ	ナコーンサワン県
ຈັງຫວັດສຸລາດທານີ	スラートターニー県
ຈັງຫວັດລຳປາງ	ラムパーン県
ຈັງຫວັດເພັດຊະບູນ	ペッチャブーン県
ຈັງຫວັດລຳພູນ	ラムプーン県
ຈັງຫວັດຕາດ	トラート県
ຈັງຫວັດນົນທະບຸລີ	ノンタブリー県
ຈັງຫວັດຍະລາ	ヤラー県
ປະທານປະເທດ ແຫ່ງ ສປປ ລາວ	内閣総理大臣の一覧
ໃບລາຍງານຜົນໄດ້ຮັບ	損益計算書
ຈັງຫວັດອຳນາດຈະເລີນ	アムナートチャルーン県
ຈັງຫວັດອ່າງທອງ	アーントーン県
ຈັງຫວັດຕັງ	トラン県
ຈັງຫວັດພັດທະລຸງ	パッタルン県
ຈັງຫວັດພະເຍົາ	パヤオ県
ຈັງຫວັດປະຈວບຄີລີຂັນ	プラチュワップキーリーカン県
ຈັງຫວັດອຸໄທທານີ	ウタイターニー県
ຈັງຫວັດແພ່	プレー県
ຈັງຫວັດນະຄອນສີທຳມະລາດ	ナコーンシータンマラート県
ຈັງຫວັດຊຸມພອນ	チュムポーン県
ຈັງຫວັດນ່ານ	ナーン県
ຈັງຫວັດເພັດຊະບຸລີ	ペッチャブリー県
ຄຳນາມປະສົມ	複合語
ອ໋າວຢາຍ	アオザイ
ທາທາ ຢັງ	タタ・ヤン
ໂທລະພາບແບບອະນາລ໊ອກ	アナログ放送
ລາຍຊື່ປະເທດລຽງຕາມພື້ນທີ່	国の面積順リスト
ຈັງຫວັດໜອງບົວລຳພູ	ノーンブワラムプー県
ການເກີນທາງດ້ານເສດຖະກິດ	社会的余剰
ຈັງຫວັດແມ່ຮ່ອງສອນ	メーホンソーン県
ລັດວິສາຫະກິດ	国有企業
ຈັງຫວັດນະລາທິວາດ	ナラーティワート県
ຈັງຫວັດສະໝຸດປາການ	サムットプラーカーン県
ຈັງຫວັດນະຄອນລາຊະສີມາ	ナコーンラーチャシーマー県
ຈັງຫວັດສຸພັນບຸລີ	スパンブリー県
ຈັງຫວັດພັງງາ	パンガー県
ປາຂ່າ(ໂລມາອີຣະວະດີ)	カワゴンドウ
ແລປົງ	ラプンツェル
ຈັງຫວັດອຸຕະລະດິດ	ウッタラディット県
ຈັງຫວັດກຳແພງເພັດ	カムペーンペット県
Externality	外部性
ຈັງຫວັດໄຊຍະພູມ	チャイヤプーム県
ຈັງຫວັດເລີຍ	ルーイ県
ຈັງຫວັດການຈະນະບຸລີ	カーンチャナブリー県
ຈັງຫວັດຕາກ	ターク県
ຈັງຫວັດພິສະນຸໂລກ	ピッサヌローク県
ດຸນຍະພາບທົ່ວໄປ	一般均衡
ບໍລິການລົດເຊົ່າ	レンタカー
AIDC F-CK-1 Ching-kuo	F-CK-1 (航空機)
ເສດຖະວັດຖຸສາດ	経済物理学
ຂົວເອີລັນ	エーランド橋
ເກໂກລີ ເລີມາກຊານ	グレゴリー・ルマルシャル
ແຂວງສາລະວັນ	サーラワン県
ກ້ອງຖ່າຍວິດີໂອ	ビデオカメラ
ຄັງສຳຮອງເງິນຕາຕ່າງປະເທດ	外貨準備
ຜູ້ໂດຍສານ	旅客
ສົມເດັດພະເຈົ້າກຸງທົນບຸລີ	タークシン
ໄກສອນ ພົມວິຫານ	カイソーン・ポムウィハーン
ສຸພານຸວົງ	スパーヌウォン
ຈັງຫວັດປາຈີນບຸລີ	プラーチーンブリー県
ອຳນາດບໍລິຫານ	官庁
ຈັງຫວັດບຸລີລຳ	ブリーラム県
ຈັງຫວັດຂອນແກ່ນ	コーンケン県
ຈັງຫວັດຈັນທະບຸລີ	チャンタブリー県
ຈັງຫວັດໜອງຄາຍ	ノーンカーイ県
ຈັງຫວັດສະໝຸດສາຄອນ	サムットサーコーン県
ຈັງຫວັດສິງບຸລີ	シンブリー県
ຈັງຫວັດນະຄອນປະຖົມ	ナコーンパトム県
ແຂວງຜົ້ງສາລີ	ポンサーリー県
ແຂວງບໍ່ແກ້ວ	ボーケーオ県
ແຂວງຈໍາປາສັກ	チャンパーサック県
ຈັງຫວັດສະເຊີງເຊົາ	チャチューンサオ県
ຈັງຫວັດມຸກດາຫານ	ムックダーハーン県
ຈັງຫວັດລະຍອງ	ラヨーン県
ຈັງຫວັດລາຊະບຸລີ	ラーチャブリー県
ຈັງຫວັດລົບບຸລີ	ロッブリー県
ຈັງຫວັດສະລະບຸລີ	サラブリー県
ບັນຊີແຫ່ງຊາດ	国民経済計算
ອາຍແກັສແຫຼວ	液化石油ガス
ສະຫະພາບໂທລະຄົມມະນາຄົມ	国際電気通信連合
ເຈົ້າມະຫາຊີວິດສີສະຫວ່າງວົງ	シーサワーンウォン
ເຈົ້າສີສະຫວ່າງວັດທະນາ	サワーンワッタナー
ໜູຮັກ ພູມສະຫວັນ	ヌーハック・プームサワン
ຈັງຫວັດອຸດອນທານີ	ウドーンターニー県
ຈັງຫວັດສຸລິນ	スリン県
ຈັງຫວັດສີສະເກດ	シーサケート県
ຈັງຫວັດສຸໂຂໄທ	スコータイ県
ຈັງຫວັດສະແກ້ວ	サケーオ県
ຈັງຫວັດສະກົນນະຄອນ	サコンナコーン県
ຈັງຫວັດກາລະສິນ	カーラシン県
ເມືອງປາກເຊ	パークセー郡
ລາວ (ຊົນເຜົ່າ)	ラーオ族
ມີແຊນ ຟານ	ミシェル・ファン
ເສດຖະສາດຕົວເມືອງ	都市経済学
ການກໍ່ສ້າງ	建設
ນະຄອນຫຼວງວຽງຈັນ	ヴィエンチャン都
ແອຣ໌ເອເຊຍ	エアアジア
ສົມເດັດພະສັນຕະປາປາຟຣັງຊົວ	フランシスコ (ローマ教皇)
ຈັງຫວັດສະໝຸດສົງຄາມ	サムットソンクラーム県
ຈັງຫວັດປະທຸມທານີ	パトゥムターニー県
ຈັງຫວັດໄຊນາດ	チャイナート県
ໜີ້ຕ່າງປະເທດ	対外債務
ແຂວງໄຊຍະບູລີ	サイニャブーリー県
ໝາກຂີ້ຫູດ	コブミカン
ແຂວງສະຫວັນນະເຂດ	サワンナケート県
ແຂວງຊຽງຂວາງ	シエンクワーン県
ແຂວງອຸດົມໄຊ	ウドムサイ県
ຈັງຫວັດນະຄອນນາຍົກ	ナコーンナーヨック県
ສົມເດັດພະເຈົ້າພີ່ນາງເທີ ເຈົ້າຟ້າກັນລະຍານິວັດທະນາ	ナラーティワートラーチャナカリン
ເສັ້ນໂຄ້ງບໍ່ຈຳແນກ	無差別曲線
ຈັງຫວັດນະຄອນພະນົມ	ナコーンパノム県
ຈັງຫວັດມະຫາສາລະຄາມ	マハーサーラカーム県
ທ່ານ ບຸນຍັງ ວໍລະຈິດ	ブンニャン・ウォーラチット
ພະເຈົ້າບຸເຣງນອງ	バインナウン
ອຳເພີ	アムプー
ອຳເພີເມືອງຊົນບຸລີ	ムアンチョンブリー郡
ຈັງຫວັດພະນະຄອນສີອະຍຸທະຍາ	アユタヤ県
ຕຳລາຂັ້ນສີ່	四次方程式
ສະໜາມບິນສາກົນເຕິນເຊິນເຍິດ	タンソンニャット国際空港
KAI T-50 Golden Eagle	T-50 (航空機)
ປ່ອງຢ້ຽມປີ 2000	Microsoft Windows 2000
ການຈັດການລູກຄ້າສໍາພັນ	顧客関係管理
Sukhoi Superjet 100	スホーイ・スーパージェット100
7 ສິ່ງມະຫັດສະຈັນ	世界の七不思議
ໂສມງາມກັບເຈົ້າຊາຍອະສູນ	美女と野獣
ແຂວງຫົວພັນ	フアパン県
ແຂວງອັດຕະປື	アッタプー県
ອົງການ ຄວບຄຸມໄພສຸກເສີນລັດຖະບານກາງ	アメリカ合衆国連邦緊急事態管理庁
ຈັງຫວັດຍະໂສທອນ	ヤソートーン県
ແຂວງຄຳມ່ວນ	カムムアン県
ຕຳລາການຜະລິດ	生産関数
ມະຫາວິທະຍາໄລແຫ່ງຊາດລາວ	ラオス国立大学
ມາລິໂອ້ ເມົາເລີ້	マリオ・マウラー
ຄຳເມືອງ	北タイ語
ຜາສາດຫີນວັດພູ	プラーサート・ワット・プー
ຂົວມິດຕະພາບລາວ - ໄທ ແຫ່ງທີ 4	第4タイ・ラオス友好橋
ແຂວງເຊກອງ	セーコーン県
ການຄ້າ	取引
ຈຳນວນອະປົກກະຕິ	無理数
ຈຳປາສັກ	チャンパーサック
ຄວາມລົ້ມເຫຼວຂອງຕະຫຼາດ	市場の失敗
ກາເຟອຽກລັງ	アイリッシュ・コーヒー
ເພງຊາດລາວ	ラオスの国歌
ໜູຖົງຊາຍ	ワラビー
ສວນຄົວ	家庭菜園
ຈັງຫວັດຮ້ອຍເອັດ	ローイエット県
ໝັງກາຕູນ	カートゥーン
ຈັກຂັ້ນ	階差機関
ຈັງຫວັດອຸບົນລາຊະທານີ	ウボンラーチャターニー県
ການແລກປ່ຽນ	トレードオフ
ກູແຊກ	グジェール
ເມືອງຫຼວງນໍ້າທາ	ルアンナムター郡
ເອັນຣິໂຄ ເລັດຕາ	エンリコ・レッタ
Squadron (ການບິນ)	飛行隊
Pilatus PC-7	ピラタス PC-7
ລາຍຊື່ປະເທດຮຽງຕາມຈຳນວນປະຊາກອນ	国の人口順リスト
7 ສິ່່ງມະຫັດສະຈັນຂອງໂລກ	新・世界七不思議
ຄຳຂວັນປະຈຳຊາດ	国と地域の標語の一覧
ເສັ້ນເຂົ້າປຸ້ນ	ビーフン
ຫ້ວຍຊາຍ	フアイサーイ郡
ແຂວງວຽງຈັນ	ヴィエンチャン県
ໄຮ້ເພດ	無性愛
ກອງປະຊຸມອາເຊັມ	アジア欧州会合
ໂຈດຊິງລາງວັນມິເລນຽມ	ミレニアム懸賞問題
ການຜະລິດ, ຕົ້ນທຶນ ແລະ ລາຄາ	生産
ໂຜນ ກິ່ງເພດ	ポーン・キングピッチ
ວັນ ລະຫວ່ງປະເທດ ຜູ້ໄຊ້ ມືຂ້າຍ	左利きの日
ໄທໃຫຍ່	シャン族
ເນີຍແຂງຟ້າແກ່	ブルーチーズ
ເສດຖະຄະນິດສາດ	数理経済学
ແຂວງຫຼວງພະບາງ	ルアンパバーン県
ເມືອງໄກສອນ ພົມວິຫານ	カイソーン・ポムウィハーン郡
ການບິນອະວະກາດ	有人宇宙飛行
ການບິນລາວ	ラオス国営航空
ພັກປະຊາຊົນປະຕິວັດລາວ	ラオス人民革命党
ອາຊີໃຕ້	南アジア
ສະໜາມບິນສາກົນເຫຼ້າສຸດ	ダナン国際空港
Harvard Mark I	Harvard Mark I
ນາຍົກລັດຖະມົນຕີ ແຫ່ງ ສປປ ລາວ	ラオス人民民主共和国首相
BM-30 Smerch	BM-30
ສະຖານນີທ່ານາແລ້ງ	ターナレーン駅
ສາມຫຼ່ຽມຄຳ	黄金の三角地帯
ຄວາມຈຳກັດ	希少性
ເຂົ້າຈີ່ປາເຕ້	パテ (料理)
ກິໂລແມັດ	キロメートル
ລົດມ້າ	馬車鉄道
ທິດສະດີຜູ້ຊົມໃຊ້	消費者行動分析
ດຸນຍະພາບເສດຖະກິດ	均衡
Halo effect	ハロー効果
ອານາຈັກອະຍຸທະຍາ	アユタヤ王朝
ຄອມພິວເຕີຣ໌ນ້ອຍຕໍ່ເດັກນ້ອຍຫນຶ່ງຄົນ	OLPC
ປະລິມານເງິນ	マネーサプライ
ຜົນປະໂຫຍດຂອບເຂດ (ເສດຖະສາດ)	限界効用
ເຮັກໂຕແມັດ	ヘクトメートル
McDonnell Douglas F-15E Strike Eagle	F-15E (航空機)
ເຂດພິເສດໄຊສົມບູນ	サイソムブーン県
ເດກາແມັດ	デカメートル
ເສດຖະສາດສະຫວັດດີການ	厚生経済学
ອານາຈັກລ້ານຊ້າງ	ラーンサーン王朝
VietJet Air	ベトジェットエア
ກິກາແມັດ	ギガメートル
ຮູບສອງແຈ	二角形
ຈຸລາລົງກອນມະຫາວິທະຍາໄລ	チュラーロンコーン大学
ອານາຈັກສຸໂຂໄທ	スコータイ王朝
ມະຫາວິທະຍາໄລລັດ	公立大学
ຊີເກມສ໌	東南アジア競技大会
ພູພຽງບໍລະເວນ	ボーラウェン高原
ຊ່ວຍເຫຼືອ:ເນື້ອໃນ	Help:目次
ຂົວມິດຕະພາບ ລາວ-ໄທ ແຫ່ງທຳອິດ	タイ＝ラオス友好橋
List of ISO 639-1 codes	ISO 639-1コード一覧
AgustaWestland Apache	WAH-64 アパッチ
ຊຸດໂຣບົດ	パワードスーツ
ແຂວງຫຼວງນໍ້າທາ	ルアンナムター県
ບ່ອນຈອດລົດເມ	バス停留所
ເຈົ້າຟ້າຊາຍມົງກຸດລາຊະກຸມານວົງສະຫວ່າງ	ウォンサワーン
ດູ່	カリン (マメ科)
ເຂົາຊາຍ ແກແລັກຊີ້	カオサイ・ギャラクシー
ເຄື່ອງເຮັດເຂົ້າຈີ່	ホームベーカリー
ຈັງຫວັດບຶງການ	ブンカーン県
ບຸນບັ້ງໄຟ	ロケット祭り (東南アジア)
ວັງວຽງ	ヴァンヴィエン
ທ່າແຂກ	ターケーク郡
ລົດຮັບສົ່ງເດີ່ນຍົນ	リムジンバス
ຮັກຕ່າງເພດ	異性愛
ສີລ	戒
ຕົ້ມຍຳ	トムヤムクン
ເມກາແມັດ	メガメートル
ក	クメール文字
ອານາຈັກລ້ານນາ	ラーンナー
ພະທາດຫຼວງ	タート・ルアン
ຮູບໜຶ່ງແຈ	一角形
ກິເລດ	煩悩
ຕຳບົນ	タムボン
ສະໜາມບິນສາກົນຫຼວງພະບາງ	ルアンパバーン国際空港
ເສືອແຂ້ວດາບ	剣歯虎
ອານາຈັກທົນບຸລີ	トンブリー王朝
ການວິໄຈການຕະຫລາດ	マーケティングリサーチ
ຫຼັກເກນ ເຮັກເຊີ=ໂອລີນ	ヘクシャー＝オリーンの定理
ການນັ່ງ	座法
ມະຫາວິທະຍາໄລພາສາຕ່າງປະເທດປັກກິ່ງ	北京外国語大学
ໂດລາເອມອນ (ໂຕລະຄອນ)	ドラえもん (架空のキャラクター)
ສະພາແຫ່ງຊາດ	国民議会 (ラオス)
ພິດຕີ້ຄຽວ	プリキュアシリーズ
ອັດຕາດອກເບ້ຍທະນາຄານກາງ	政策金利
ເໝ້ນ	ヤマアラシ
ໂຣບົດທະຫານ	軍事用ロボット
ຈຳນວນປົກກະຕິ	有理数
ເດີ່ນຍົນ	空港
ຂົວມິດຕະພາບລາວ-ໄທ ແຫ່ງທີ 3	第3タイ・ラオス友好橋
ລະບອບການປົກຄອງ	政治体制
ອັກສອນທໍາລ້ານນາ	ラーンナー文字
ເມືອງ	ムアン
ພຣະໄຕປິດົກ	三蔵
El Chavo del 8	エル・チャボ・デル・オチョ
ຕຳໝາກຫຸ່ງ	ソムタム
ທົງໄຊ ແມກອິນໄຕ	トンチャイ・メーキンタイ
ກີ່ຄິດໄລ່ Jacquard	ジャカード織機
ອາຫານລາວ	ラオス料理
ເນື້ອທີ່ໜ້າພຽງ	表面積
ໝວດ:ປະເທດເຢັຽລະມັນ	Category:ドイツ
ໝວດ:ສະຫະລັດອາເມລິກາ	Category:アメリカ合衆国
ໝວດ:ປະເທດການາດາ	Category:カナダ
ໝວດ:ສະຫະລາຊະອານາຈັກ	Category:イギリス
ໝວດ:ປະເທດແອສະປາຍ	Category:スペイン
ໝວດ:ປະເທດຍີ່ປຸ່ນ	Category:日本
ຈຸດແລກປ່ຽນທາງອິນເຕີຣ໌ເນັຕ	インターネットエクスチェンジ
ເສດຖະປະຫວັດສາດ	数量経済史
ປະຕູໄຊ	アヌサーワリー・パトゥーサイ
ໝວດ:ປະເທດເກົາຫຼີໃຕ້	Category:大韓民国
ໝວດ:ປະເທດໄທ	Category:タイ王国
ໝວດ:ປະເທດຫວຽດນາມ	Category:ベトナム
ໝວດ:ສັດລ້ຽງລູກດ້ວຍນ້ຳນົມ	Category:哺乳類
ໝວດ:ພືດ	Category:植物
ໝວດ:ວັດຖຸວິທະຍາ	Category:物理学
ໝວດ:ຊີວະສາດ	Category:生物学
ໝວດ:ປະຫວັດສາດ	Category:歴史
ໝວດ:ພູມສາດ	Category:地理
ໝວດ:ສັງຄົມ	Category:社会
ໝວດ:ສາສະໜາ	Category:宗教
ໝວດ:ກິລາ	Category:スポーツ
ໝວດ:ສາດ	Category:科学
ໝວດ:ສະຫະປະຊາຊາດ	Category:国際連合
ໝວດ:ຮູບເງົາ	Category:映画
ໝວດ:ມໍລະດົກໂລກ	Category:世界遺産
ໝວດ:ໂລກ	Category:地球
ໝວດ:ຂໍ້ມູນຂ່າວສານ	Category:情報
ລາຍໄດ້	収入
ໂມເດລຄວາມດຶງດູດການຄ້າ	貿易における重力モデル
Airbus A318	エアバスA318
ອັກສອນລາວ	ラーオ文字
ໝວດ:ນິເວດສາດ	Category:生態学
ຊາດຊາຍ ຊ່ຽວນ້ອຍ	チャチャイ・チオノイ
ໝວດ:ພຸດທະສາສະໜາ	Category:仏教
ໝວດ:ຄຣິສຕະສາດສະໜາ	Category:キリスト教
ໝວດ:ສາສະໜາອິສະລາມ	Category:イスラム教
ລວມຕຳລາຄະນິດສາດ	関数一覧
ການຂາຍເມຍໃນປະເທດອັງກິດ	妻売り
ໂຮງຮຽນອະຍຸດທະຍາວິທະຍາໄລ	アユタヤウィッタヤーライ学校
ໂພຊະນາການ	栄養
ດັດຊະນີ (ເສດຖະກິດ)	指数 (経済)
ແຂວງບໍລິຄຳໄຊ	ボーリカムサイ県
ສິນຄ້າ (ທຸລະກິດ)	商品
ລັດອິດສະລາມອີຣັກແລະເຣເວນທ໌	ISIL
ການຄົມມະນາຄົມໃນປະເທດລາວ	ラオスの交通
ພະມະຫາກະສັດໄທ	タイの国王
ປາກແບ່ງ	パークベン
ວັດຊຽງທອງ	ワット・シエントーン
ເຈົ້າຊາຍ ສຸລິວົງ ສະຫວ່າງ	スリウォンサワーン
ປຸຖຸຊົນ	結 (仏教)
ການຈັດການ	経営管理論
ໝວດ:ວັດທະນະທຳ	Category:文化
ໝວດ:ຄວາມຮູ້	Category:知識
ໝວດ:ທະວີບ	Category:大陸
ໝວດ:ທໍລະນີສາດ	Category:地質学
ໝວດ:ພາສາ: ເຮືອບິນ	Category:航空機
ຮູດີສ	フーシ
ລາບ	ラープ (料理)
ລະດູຝົນ	雨季
ເບຍລາວ	ビア・ラオ
ບັນຫາການເຮັດໃຫ້ເກີດຜົນປະໂຫຍດສູງສຸດ	効用最大化
ສິ້ນ	シン (民族衣装)
ວົງຍ່ອຍສິງທະເລ	アシカ
ໝວດ:ນັກສະແດງ	Category:俳優
ແມ່ແບບ:Tl	Template:Tl
ແມ່ແບບ:Wikipedialang	Template:メインページ/他言語版
ໝວດ:ປະເທດ	Category:国
ໝວດ:ເສດຖະສາດ	Category:経済学
ວິກິພີເດຍ:ຜູ້ບໍລິຫານ	Wikipedia:管理者
ໝວດ:ອາຊີບ	Category:職業
ໝວດ:ເວລາ	Category:時間
ໝວດ:ທຳມະຊາດ	Category:自然
ໝວດ:ອິນເຕີເນັດ	Category:インターネット
ໝວດ:ວັດສະດຸ	Category:材料
ໝວດ:ແພດສາດ	Category:医学
ໝວດ:ການເມືອງ	Category:政治
ໝວດ:ການສຶກສາ	Category:教育
ໝວດ:ສິລະປະ	Category:芸術
ໝວດ:ຊອຟແວ	Category:ソフトウェア
ແມ່ແບບ:Bot	Template:Bot
ປະເທດການາດາ	カナダ
ສະຖານີໂທລະພາບແຫ່ງຊາດລາວ	ラオス国営テレビ
ໝວດ:ບົດຄວາມດີເດັ່ນ	Category:秀逸な記事
ເກມຄອມພິວເຕີ	パソコンゲーム
ແມ່ແບບ:Flagicon	Template:Flagicon
ໝວດ:ເອີລົບ	Category:ヨーロッパ
ແມ່ແບບ:ຄູ່ມືການໃຊ້ງານ	Template:Documentation
ໝວດ:ຜູ້ໃຊ້ແບ່ງຕາມພາສາ	Category:言語別の利用者
ວິກິພີເດຍ:ຫ້າຫຼັກການ	Wikipedia:五本の柱
ໝວດ:ແນວປະຕິບັດວິກິພີເດຍ	Category:ウィキペディアのガイドライン
ວິກິພີເດຍ:ກ່ອງຜູ້ໃຊ້	Wikipedia:ユーザーボックス
ຊໂງ ໃຈ-ກກິ	成在基
ທຸລະກິດ	企業
ແມ່ແບບ:Softredirect	Template:Softredirect
ແມ່ແບບ:ລຶບ	Template:即時削除
ໝວດ:ພາສາ: ເຕັກໂນໂລຊີ	Category:技術
ໝວດ:ພັນທຸສາດ	Category:遺伝学
ໝວດ:ພາສາ	Category:諸言語
ໝວດ:ໄວຍາກອນ	Category:文法
ໝວດ:ປະຕິທິນ	Category:暦法
ໝວດ:ວິກິພີເດຍ	Category:ウィキペディア
ວິກິພີເດຍ:ຂໍ້ປະຕິເສດຄວາມຮັບຜິດຊອບ	Wikipedia:免責事項
ໝວດ:Pages with broken file links	Category:壊れたファイルへのリンクがあるページ
ແມ່ແບບ:Navbox	Template:Navbox
ໝວດ:ພາສາໝາຍ	Category:マークアップ言語
ການບໍລິຫານ	経営学
ໝວດ:ການບຳລຸງຮັກສາວິກິພີເດຍ	Category:ウィキペディアのメンテナンス
ໝວດ:ຄອມພິວເຕີ	Category:コンピュータ
ແມ່ແບບ:!	Template:!
ໝວດ:ແມ່ແບບທຸງ	Category:旗のテンプレート
ແມ່ແບບ:!-	Template:!-
ແມ່ແບບ:Tnavbar	Template:Tnavbar
ແມ່ແບບ:Fontie	Template:Unicode
ແມ່ແບບ:Clear	Template:Clear
ແມ່ແບບ:Col-begin	Template:Col-begin
ແມ່ແບບ:Col-end	Template:Col-end
ໝວດ:ອາຟຣິກກາ	Category:アフリカ
ໝວດ:ປຶ້ມ	Category:書物
ແມ່ແບບ:ບາເບລ	Template:Babel
ແມ່ແບບ:Commons	Template:Commons
ແມ່ແບບ:Reflist	Template:Reflist
ວິກິພີເດຍ:ການອ້າງອີງແຫຼ່ງທີ່ມາ	Wikipedia:出典を明記する
ວິກິພີເດຍ:ຊອກຫາ	Help:検索
ແມ່ແບບ:Stub	Template:Stub
ແມ່ແບບ:User eo-1	Template:User eo-1
ແມ່ແບບ:User de	Template:User de
ແມ່ແບບ:User de-1	Template:User de-1
ແມ່ແບບ:User es	Template:User es
ແມ່ແບບ:User de-3	Template:User de-3
ແມ່ແບບ:User en-3	Template:User en-3
ແມ່ແບບ:User en-1	Template:User en-1
ແມ່ແບບ:User en-2	Template:User en-2
ແມ່ແບບ:User en-4	Template:User en-4
ແມ່ແບບ:User en	Template:User en
ແມ່ແບບ:User de-2	Template:User de-2
ແມ່ແບບ:User fr-1	Template:User fr-1
ແມ່ແບບ:User ja-4	Template:User ja-4
ແມ່ແບບ:User ja	Template:User ja
ແມ່ແບບ:User ja-1	Template:User ja-1
ແມ່ແບບ:User fr	Template:User fr
ໝວດ:ອາຊີ	Category:アジア
ແມ່ແບບ:Esoteric	Template:複雑なテンプレート
ໝວດ:ປະເທດມາເລເຊຍ	Category:マレーシア
ແມ່ແບບ:Lang-ja	Template:Lang-ja
ແມ່ແບບ:Mod	Template:Mod
ແມ່ແບບ:User es-2	Template:User es-2
ແມ່ແບບ:ຍິນດີຕ້ອນຮັບ	Template:Welcome
ແມ່ແບບ:Sisterprojects	Template:WikipediaSister
ໝວດ:ດວງຈັນ	Category:月
ແມ່ແບບ:USA	Template:USA
ແມ່ແບບ:Country data Thailand	Template:Country data Thailand
ແມ່ແບບ:Country data Indonesia	Template:Country data Indonesia
ແມ່ແບບ:Country data Cambodia	Template:Country data Cambodia
ໝວດ:ພາສາສາດ	Category:言語学
ແມ່ແບບ:ດັດແກ້	Template:Edit
ແມ່ແບບ:Wikiatlas	Template:Wikiatlas
ແມ່ແບບ:Click	Template:Click
ໝວດ:User fr-1	Category:User fr-1
ແມ່ແບບ:Country showdata	Template:Country showdata
ແມ່ແບບ:Image label	Template:Image label
ແມ່ແບບ:Country data Brunei	Template:Country data Brunei
ໝວດ:ແມວ	Category:ネコ
ໝວດ:ນາຊີ	Category:ナチ党
ແມ່ແບບ:Sidebar	Template:Sidebar
ແມ່ແບບ:Country data France	Template:Country data France
ແມ່ແບບ:ປັບປຸງການອ້າງອີງ	Template:未検証
ແມ່ແບບ:ກ່ອງຜູ້ໃຊ້ລຸ່ມ	Template:Boxboxbottom
ແມ່ແບບ:ຂໍ້ມູນປະເທດ	Template:基礎情報 国
ແມ່ແບບ:Country data Laos	Template:Country data Laos
ແມ່ແບບ:Px	Template:Px
ແມ່ແບບ:Documentation/docname	Template:Documentation/docname
ແມ່ແບບ:ກ່ອງຜູ້ໃຊ້ເທິງ	Template:Boxboxtop
ແມ່ແບບ:Infobox Political party	Template:政党
ແມ່ແບບ:ກ່ອງຂ້ໍມູນ ປະຊາຄົມອາຊຽນ	Template:Navbox with columns
ແມ່ແບບ:ກ່ອງຂໍ້ມູນ ນັກມວຢ	Template:Boxing statsbox
ແມ່ແບບ:Infobox ບໍລິສັດ	Template:Infobox Company
ແມ່ແບບ:Country data Vietnam	Template:Country data Vietnam
ແມ່ແບບ:ປ້າຍບົດຄວາມດີເດັ່ນ	Template:Featured article
ແມ່ແບບ:Infobox ຈັກກະພັດໂຣມັນ	Template:基礎情報 君主
ໝວດ:ປາລີ	Category:パリ
ໝວດ:User en	Category:User en
ໝວດ:User zh	Category:User zh
ໝວດ:User en-2	Category:User en-2
ແມ່ແບບ:Infobox	Template:Infobox
ແມ່ແບບ:User zh	Template:User zh
ໝວດ:ອັກສອນ	Category:アルファベット
ແມ່ແບບ:Navbox/core	Template:Navbox/core
ແມ່ແບບ:Template other	Template:Template other
ໝວດ:ພາສາ: ບິນ	Category:航空
ແມ່ແບບ:Country data	Template:Country data
ໝວດ:ອາຫານແລະເຄື່ອງດື່ມ	Category:飲食
ແມ່ແບບ:Pp-template	Template:Pp-template
ແມ່ແບບ:ວິກິວັດຈະນານຸກົມ	Template:Wiktionary
ແມ່ແບບ:Languageicon	Template:Languageicon
ແມ່ແບບ:User ru	Template:User ru
ໝວດ:ອະເມລິກາ	Category:アメリカ
ໝວດ:ເຂົ້າຈີ່	Category:パン
ແມ່ແບບ:ກັບສາງ	Template:Archive box
ວິກິພີເດຍ:ຂ້ອຄວາມຂວງ GNU Free Documentation License	Wikipedia:Text of GNU Free Documentation License
ແມ່ແບບ:Sisterlinks	Template:Sisterlinks
ແມ່ແບບ:Border	Template:Border
ແມ່ແບບ:Fmbox	Template:Fmbox
ໝວດ:ພາສາທະຫານ	Category:軍事
ແມ່ແບບ:Country data Philippines	Template:Country data Philippines
ແມ່ແບບ:Country data Malaysia	Template:Country data Malaysia
ແມ່ແບບ:Country data Myanmar	Template:Country data Myanmar
ແມ່ແບບ:Increase	Template:Increase
ແມ່ແບບ:Image label end	Template:Image label end
ແມ່ແບບ:Tlx	Template:Tlx
ແມ່ແບບ:CAN	Template:CAN
ແມ່ແບບ:Earth Labelled Map	Template:Earth Labelled Map
ໝວດ:ຄຳສັບ	Category:語彙
ແມ່ແບບ:Lang-my	Template:Lang-my
ໝວດ:ຄຳ	Category:語
ແມ່ແບບ:Country flag2	Template:Flag2
ແມ່ແບບ:ກ່ອງຜູ້ໃຊ້ຄັ່ນ	Template:Boxboxbreak
ໝວດ:ແຫຼ່ງນ້ຳ	Category:水域
ແມ່ແບບ:ຕ້ອງການອ້າງອີງ	Template:出典の明記
ໝວດ:ສະໜາມບິນໃນຫວຽດນາມ	Category:ベトナムの空港
ແມ່ແບບ:Image label small	Template:Image label small
ໝວດ:ພະມະຫາກະສັດອັງກິດ	Category:イングランドの君主
ແມ່ແບບ:Infobox Language/pronunciation	Template:Infobox Language/pronunciation
ໝວດ:ສານອາຫານ	Category:栄養素
ແມ່ແບບ:SUL Box	Template:User SUL
ໝວດ:ພາຫະນະການທະຫານ	Category:軍用車両
ໝວດ:ວິທະຍາສາດສຸຂະພາບ	Category:健康科学
ໝວດ:ໂທລະສັບມືຖື	Category:携帯電話端末
ໝວດ:ພາສາ: ເຮືອບິນທະຫານ	Category:軍用機
ແມ່ແບບ:Lang-en	Template:Lang-en
ໝວດ:ເນີຍແຂງ	Category:チーズ
ແມ່ແບບ:Lower	Template:Lower
ແມ່ແບບ:Politicsboxend	Template:Politicsboxend
ແມ່ແບບ:UK	Template:GBR
ໝວດ:ສະຖາປັດຕະຍະກຳ	Category:建築
ໝວດ:ລົດໄຟ	Category:鉄道
ແມ່ແບບ:Interwiki	Template:Wikipedia
ໝວດ:ໂພຊະນາການ	Category:栄養学
ແມ່ແບບ:ບໍ່ເປັນກາງ	Template:観点
ແມ່ແບບ:Dmoz	Template:Dmoz
ໝວດ:ເມືອງໃນແຂວງເກແບັກ	Category:ケベック州の都市
ໝວດ:User eo	Category:User eo
ໝວດ:User fr	Category:User fr
ໝວດ:User ja	Category:User ja
ໝວດ:User th	Category:User th
ໝວດ:User ja-2	Category:User ja-2
ໝວດ:User fr-N	Category:User fr-N
ໝວດ:ແມ່ນ້ຳອາມາຊົນ	Category:アマゾン川
ໝວດ:ແຂວງກວາງບິນ	Category:クアンビン省
ໝວດ:User en-3	Category:User en-3
ໝວດ:User en-N	Category:User en-N
ໝວດ:User eo-1	Category:User eo-1
ໝວດ:User es	Category:User es
ແມ່ແບບ:EU	Template:EU
ໝວດ:User es-2	Category:User es-2
ໝວດ:User es-3	Category:User es-3
ນິກາຍອັງກະລິກັງ	聖公会
ແມ່ແບບ:Country data United Kingdom	Template:Country data United Kingdom
ແມ່ແບບ:Cite encyclopedia	Template:Cite encyclopedia
ໝວດ:ສິລະປິນ	Category:美術家
ໝວດ:ເວັບໄຊຕ໌	Category:ウェブサイト
ໝວດ:User ko	Category:User ko
ໝວດ:User ko-1	Category:User ko-1
ແມ່ແບບ:ແປ	Template:翻訳中途
ໝວດ:ຫົວໜ່ວຍການປົກຄອງ	Category:行政区画
ໝວດ:ພາສາວັນນະຍຸດ	Category:声調言語
ໝວດ:ເມືອງໃນປະເທດຝະລັ່ງ	Category:フランスの都市
ແມ່ແບບ:Wikivoyage	Template:Wikivoyage-inline
ໝວດ:ວັນນະຄະດີເດັກນ້ອຍ	Category:児童文学
ແມ່ແບບ:ພາສາທາງການຂອງສະຫະປະຊາຊາດ	Template:国際連合公用語
ໝວດ:ອຸບປະກອນເຂົ້າອອກ	Category:入力機器
ແມ່ແບບ:ຮູບຫຼາຍແຈ	Template:多角形
ໝວດ:ທະເລ	Category:海
ໝວດ:ປະເທດອັງກິດ	Category:イングランド
ໝວດ:ນັກສະແດງແບ່ງຕາມສັນຊາດ	Category:各国の俳優
ໝວດ:ລະບົບສຸລິຍະ	Category:太陽系
ຊ່ວຍເຫຼືອ:ຫ້ອງສາງ	Help:過去ログ
ແມ່ແບບ:ຮູບແບບແຫ່ງລັດ	Template:統治体制
ໝວດ:ອຸດສາຫະກຳ	Category:工業
ໝວດ:ນ້ຳ	Category:水
ໝວດ:ສັດກິນຊີ້ນ	Category:食肉目
ໝວດ:ແຂວງ	Category:ラオスの県
ແມ່ແບບ:ແຂວງຂອງລາວ	Template:ラオスの地方行政区画
ໝວດ:ເຮລີກົບແຕ	Category:ヘリコプター
ໝວດ:ນາຍົກລັດຖະມົນຕີ	Category:首相
ໝວດ:ນັກຮ້ອງການາດາ	Category:カナダの歌手
ແມ່ແບບ:User cs	Template:User cs
ແມ່ແບບ:User es-3	Template:User es-3
ໝວດ:User ru	Category:User ru
ໝວດ:User ru-3	Category:User ru-3
ໝວດ:User th-3	Category:User th-3
ໝວດ:User th-N	Category:User th-N
ແມ່ແບບ:Lang	Template:Lang
ໝວດ:ສາຂາວິຊາວິທະຍາສາດ	Category:科学的専門分野
ໝວດ:ຊາວພະມ້າ	Category:ミャンマーの人物
ໝວດ:ມະນຸດ	Category:人間
ແມ່ແບບ:ບົດຄວາມຫຼັກ	Template:Main
ແມ່ແບບ:ໃຜກ່າວ	Template:誰
ໝວດ:ວົງເສືອແລະແມວ	Category:ネコ科
ໝວດ:ແມ່ນ້ຳແບ່ງຕາມປະເທດ	Category:各国の河川
ໝວດ:ສະກຸນເງິນ	Category:通貨
ແມ່ແບບ:Infobox Language/family-color	Template:Infobox Language/family-color
ໝວດ:ແມ່ນ້ຳ	Category:河川
ໝວດ:ແມ່ນ້ຳໃນປະເທດບະເລຊິນ	Category:ブラジルの河川
ໝວດ:ແມ່ນ້ຳໃນປະເທດເປລູ	Category:ペルーの河川
ໝວດ:ນັກຮ້ອງແບ່ງຕາມສັນຊາດ	Category:各国の歌手
ໝວດ:ນ້ຳມັນ	Category:油脂
ໝວດ:ນັກຮ້ອງໄທ	Category:タイの歌手
ໝວດ:User zh-1	Category:User zh-1
ໝວດ:User zh-3	Category:User zh-3
ໝວດ:ພະມະຫາກະສັດໄທ	Category:タイの君主
ໝວດ:ຊັບສິນທາງປັນຍາ	Category:知的財産権
ໝວດ:ນັກສະແດງຈີນ	Category:中国の俳優
ໝວດ:ນັກສະແດງໄທ	Category:タイの俳優
ໝວດ:ປະທານປະເທດລາວ	Category:ラオス人民民主共和国主席
ໝວດ:ຈັງຫວັດໃນປະເທດໄທ	Category:タイの県
ໝວດ:ຊາວໄທ	Category:タイの人物
ໝວດ:ນັກຮ້ອງຈີນ	Category:中国の歌手
ໝວດ:ນິກາຍໃນສາສະໜາຄິດ	Category:キリスト教の教派
ໝວດ:ມໍລະດົກໂລກແບ່ງຕາມປະເທດ	Category:各国の世界遺産
ໝວດ:ແມ່ນ້ຳໃນປະເທດໂກລົມບີ	Category:コロンビアの河川
ໝວດ:ນາຍົກລັດຖະມົນຕີແບ່ງຕາມປະເທດ	Category:各国の首相
ໝວດ:ປະເທດລາວ	Category:ラオス
ໝວດ:ແມ່ແບບການລຶບ	Category:削除関連のテンプレート
ວິກິພີເດຍ:ຕ້ອງການອ້າງອີງ	Wikipedia:「要出典」をクリックされた方へ
ໝວດ:ຜັກ	Category:野菜
ໝວດ:ໝາກໄມ້	Category:果物
ໝວດ:ພາສາໃນປະເທດລາວ	Category:ラオスの言語
ໝວດ:ພາສາຄອມພິວເຕີ	Category:コンピュータ言語
ໝວດ:ພາສາລາແຕັງ	Category:ラテン語
ໝວດ:ມໍລະດົກໂລກໃນປະເທດຝະລັ່ງ	Category:フランスの世界遺産
ໝວດ:ມະຫາສະໝຸດ	Category:大洋
ໝວດ:ມະນຸດສາດ	Category:人類学
ໝວດ:ລົດສະນິຍົມທາງເພດ	Category:性的指向
ໝວດ:ລະບົບປະຕິບັດການ	Category:オペレーティングシステム
ໝວດ:ລະດູ	Category:季節
ໝວດ:ແຮ່ທາດສາດ	Category:鉱物学
ໝວດ:ວິວັດທະນາການ	Category:進化
ໝວດ:ວິທີໃຊ້ວິກິພີເດຍ	Category:ウィキペディアの手引き書
ໝວດ:ສັດ	Category:動物
ໝວດ:ສັດທະສາດ	Category:音声学
ໝວດ:ສະເຕໂລອິດ	Category:ステロイド
ໝວດ:ອົງການລະຫວ່າງລັດຖະບານ	Category:国際機関
ພູສີ	プーシーの丘
ໝວດ:ປະໂລເຕອິນ	Category:タンパク質
ໝວດ:ອາຫານລາວ	Category:ラオスの食文化
ໝວດ:ເຄື່ອງໝາຍວັກ	Category:記号
ໝວດ:ເພງ	Category:歌
ໝວດ:ເພດສຶກສາ	Category:性教育
ໝວດ:ນະຄອນຫຼວງ	Category:首都
ໝວດ:ເມືອງໃນລາວ	Category:ラオスの都市
ໝວດ:ວຽງຈັນ	Category:ヴィエンチャン
ໝວດ:ເອດສ໌	Category:HIV/AIDS
ໝວດ:ອາຊີຕາເວັນອອກສຽງໃຕ້	Category:東南アジア
ໝວດ:ແຂວງຫຼວງພະບາງ	Category:ルアンパバーン県
ໝວດ:ໄດໂນເສົາ	Category:恐竜
ໝວດ:User th-4	Category:User th-4
ໝວດ:ກຸ່ມພາສາໂລມັງ	Category:ロマンス諸語
ໝວດ:ພາສາ: ການຂົນສົ່ງ	Category:交通
ໝວດ:ການຟ້ອນລຳ	Category:ダンス
ໝວດ:ກະລູຊິດ	Category:糖類
ໝວດ:ປະເພດຄຳເວົ້າ	Category:品詞
ໝວດ:ນັກເສດຖະສາດ	Category:経済学者
ແມ່ແບບ:Flagcountry	Template:Flagcountry
ແມ່ແບບ:ກ່ອງຂໍ້ມູນ ພາສາ	Template:Infobox Language
ໝວດ:ພືດທີ່ກິນໄດ້	Category:食用植物
ໝວດ:ກາເຟ	Category:コーヒー
ໝວດ:ພາສາອິຕາລີ	Category:イタリア語
ໝວດ:ພາສາແອສະປາໂຍນ	Category:スペイン語
ໝວດ:ພາສາໃນປະເທດໄທ	Category:タイの言語
ໝວດ:ແຊນ	Category:遺伝子
ໝວດ:ຍານພາຫະນະ	Category:輸送機器
ໝວດ:ລົດ	Category:自動車
ໝວດ:Tanks	Category:戦車
ແມ່ແບບ:ລາຍການຫ້ອງສາງ	Template:Archive list
ໝວດ:ພາສາໃນປະເທດຫວຽດນາມ	Category:ベトナムの言語
ໝວດ:ອາຫານຝະລັ່ງ	Category:フランスの食文化
ໝວດ:ເນີຍແຂງຝະລັ່ງ	Category:フランスのチーズ
ການບໍລິການ	サービス
ໝວດ:ສະໄໝກາງ	Category:中世ヨーロッパ
ແມ່ແບບ:Wikia	Template:Wikia
ໝວດ:ສຸຂະພາບ	Category:健康
ແມ່ແບບ:Country data Burma	Template:Country data Burma
ແມ່ແບບ:Country data Quebec	Template:Country data Quebec
ແມ່ແບບ:Country data Singapore	Template:Country data Singapore
ແມ່ແບບ:G8	Template:G8
ແມ່ແບບ:User wa	Template:User wa
ໝວດ:ເສດຖະສາດມະຫາພາກ	Category:マクロ経済学
ໝວດ:ຄຳກຳມະ	Category:動詞
ໝວດ:ພາສາ:ສາຍການບິນ	Category:旅客機
ໝວດ:ແຂວງເກແບັກ	Category:ケベック州
ໝວດ:ພາສາປືນໃຫຍ່	Category:砲兵
ໝວດ:ຂົວ	Category:橋
ໝວດ:ພາສາກາຕາລັງ	Category:カタルーニャ語
ສິດທິເດັກ	子どもの権利
ໝວດ:ເອແດມບວກ	Category:エディンバラ
ໝວດ:ຮາດແວ	Category:ハードウェア
ໝວດ:ພະລັງງານ	Category:エネルギー
ໝວດ:ລິກຂະສິດ	Category:著作権法
ໝວດ:ພາສາຝະລັ່ງ	Category:フランス語
ໝວດ:ວາຈົກ	Category:態
ແມ່ແບບ:Lts	Template:Lts
ໝວດ:ສຽງມະນຸດ	Category:音声
ໝວດ:ຫຼັກ້ຮົບ tanks	Category:主力戦車
ຊ່ວຍເຫຼືອ:ເຈ້ຍກ່າຍ	Help:早見表
ໝວດ:ເຮືອບິນຄູຝຶກທະຫານ	Category:練習機
ໝວດ:ຫຸ່ນຍົນສາດ	Category:ロボット工学
ໝວດ:ໂຣບົດ	Category:ロボット
ໝວດ:ພາສາລູມານີ	Category:ルーマニア語
ໝວດ:ພາສາອົກຊີຕັງ	Category:オック語
ໝວດ:ຕາກດີກະລາດາ	Category:緩歩動物
ໝວດ:ສັດມີແກນສັນຫຼັງ	Category:脊索動物
ໝວດ:ມົງເລອານ	Category:モントリオール
ໝວດ:ໂທລະສັບ	Category:電話
ໝວດ:ໜ່ວຍນັບເວລາ	Category:時間の単位
ໝວດ:ວິທະຍາສາດປະຍຸກ	Category:応用科学
ໝວດ:ທາດ	Category:信仰塔
ແມ່ແບບ:Image label begin	Template:Image label begin
ໝວດ:ພາສາກໍາລັງທາງອາກາດ	Category:空軍
ໝວດ:ໂຣບົດທະຫານ	Category:軍用ロボット
ແມ່ແບບ:Infobox Language/statesregion	Template:Infobox Language/statesregion
ແມ່ແບບ:Infobox Language/IPA notice	Template:Infobox Language/IPA notice
ໝວດ:User en-1	Category:User en-1
ໝວດ:ນັກສະແດງອາເມລິກັນ	Category:アメリカ合衆国の俳優
ໝວດ:ບົດຄວາມຕ້ອງຂະຫຍາຍ	Category:加筆依頼
ແມ່ແບບ:Infobox Language/official	Template:Infobox Language/official
ແມ່ແບບ:Infobox Language/quilt	Template:Infobox Language/quilt
ເສດຖະສາດກາງຫາວ	空間経済学
ແມ່ແບບ:ກ່ອງຂໍ້ມູນ ແຂວງໃນປະເທດໄທ	Template:Infobox Thai Province
ແມ່ແບບ:ແຂວງປະເທດລາວ	Template:基礎情報 ラオスの県
ແມ່ແບບ:QC	Template:QUE
ແມ່ແບບ:Infobox file format	Template:Infobox file format
ວິກິພີເດຍ:ຄຳຖາມມີເລື້ອຍ ກ່ຽວກັບ ການປະກອບສ່ວນ	Wikipedia:FAQ 投稿者向け
ວິກິພີເດຍ:ຄຳຖາມມີເລື້ອຍ ກ່ຽວກັບ ການດັດແປງ	Wikipedia:FAQ 編集
ແມ່ແບບ:ຂະຫຍາຍ	Template:加筆
ແມ່ແບບ:ກ່ອງຂໍ້ມູນ ອຳເພີ	Template:Infobox Amphoe
ວິກິພີເດຍ:ຄຳຖາມມີເລື້ອຍ ຂອງ ຜູ້ອ່ານ	Wikipedia:FAQ 読者向け
ແມ່ແບບ:Infobox Language/genetic2	Template:Infobox Language/genetic
ແມ່ແບບ:ເສດຖະສາດມະຫາພາກ	Template:マクロ経済学
ເຫດຍົນຕົກທີ່ປາກເຊ	ラオス国営航空301便墜落事故
ຮຳຊະ	ハムサ
ພິເສດ:ການດັດແກ້ຫຼ້າສຸດ	特別:最近の更新
Module:Coordinates	モジュール:Coordinates
ສາຍການບິນມາເລເຊຍທຽ່ວບິນMH370	マレーシア航空370便墜落事故
ອຸປະຕິເຫດເຮືອເຊໂວລຫລົ່ມ	2014年韓国フェリー転覆事故
