Afrika	アフリカ
Ġappun	日本
Norveġja	ノルウェー
Ingilterra	イングランド
Skozja	スコットランド
Irlanda ta' Fuq	北アイルランド
Repubblika tal-Irlanda	アイルランド
Ungerija	ハンガリー
Spanja	スペイン
Stati Uniti	アメリカ合衆国
Belġju	ベルギー
Lussemburgu	ルクセンブルク
Art	地球
Mewt	死
Bniedem	ヒト
Tim Berners-Lee	ティム・バーナーズ＝リー
Finlandja	フィンランド
Żvezja	スウェーデン
Danimarka	デンマーク
Polonja	ポーランド
Litwanja	リトアニア
Italja	イタリア
Żvizzera	スイス
Awstrija	オーストリア
Greċja	ギリシャ
Turkija	トルコ
Portugall	ポルトガル
Ewropa	ヨーロッパ
Asja	アジア
Wikipedija	ウィキペディア
Pajjiżi l-Baxxi	オランダ
Berlin	ベルリン
Kompjuter	コンピュータ
Barack Obama	バラク・オバマ
Urugwaj	ウルグアイ
Londra	ロンドン
Messiku	メキシコ
Oċean Atlantiku	大西洋
Oċean Paċifiku	太平洋
Jannar	1月
Frar	2月
Marzu	3月
Marte (pjaneta)	火星
Kenja	ケニア
Etjopja	エチオピア
Gana	ガーナ
April	4月
Mejju	5月
Ġunju	6月
Lulju	7月
Awwissu	8月
Settembru	9月
Ottubru	10月
Novembru	11月
Diċembru	12月
Iljun	ライオン
Franza	フランス
Kelb	イヌ
Renju Unit	イギリス
Qattus	ネコ
Ċina	中華人民共和国
Wikizzjunarju	ウィクショナリー
Brażil	ブラジル
François Hollande	フランソワ・オランド
Russja	ロシア
Wiki	ウィキ
Fondazzjoni Wikimedia	ウィキメディア財団
Jimmy Wales	ジミー・ウェールズ
Ġermanja	ドイツ
Bjelorussja	ベラルーシ
Il Canto degli italiani	マメーリの賛歌
Iżlanda	アイスランド
Estonja	エストニア
Saturnu (pjaneta)	土星
Latvja	ラトビア
Ukraina	ウクライナ
Ċekja	チェコ
Slovakkja	スロバキア
Slovenja	スロベニア
Vilnius	ヴィリニュス
Moldova	モルドバ
Rumanija	ルーマニア
Bulgarija	ブルガリア
Ruma	ローマ
Repubblika tal-Maċedonja	マケドニア共和国
Albanija	アルバニア
Kroazja	クロアチア
Bożnija u Ħerżegovina	ボスニア・ヘルツェゴビナ
Ażerbajġan	アゼルバイジャン
Andorra	アンドラ
Ċipru	キプロス
Ġeorġja	グルジア
Każakistan	カザフスタン
Malta	マルタ
Monako	モナコ
Montenegro	モンテネグロ
Belt tal-Vatikan	バチカン
San Marino	サンマリノ
Brussell	ブリュッセル市
Kuba	キューバ
Beliże	ベリーズ
Torri Eiffel	エッフェル塔
Barbados	バルバドス
Volkswagen	フォルクスワーゲン
Indoneżja	インドネシア
Wolfgang Amadeus Mozart	ヴォルフガング・アマデウス・モーツァルト
Ludwig van Beethoven	ルートヴィヒ・ヴァン・ベートーヴェン
Afrika t'Isfel	南アフリカ共和国
Alġerija	アルジェリア
Wikisors	ウィキソース
Varsavja	ワルシャワ
Festival tal-Eurovision	ユーロビジョン・ソング・コンテスト
Injam	木材
Pornografija	ポルノグラフィ
Ċili	チリ
Ġesù	イエス・キリスト
Galileo Galilei	ガリレオ・ガリレイ
Merkurju (pjaneta)	水星
Storja	歴史
Venere (pjaneta)	金星
Imħabba	愛
Ġove (pjaneta)	木星
Triq ta' Sant'Anna	銀河系
Uranu (pjaneta)	天王星
Nettunu (pjaneta)	海王星
Astronomija	天文学
Singapor	シンガポール
Xjenza	科学
Liechtenstein	リヒテンシュタイン
Sport	スポーツ
Adolf Hitler	アドルフ・ヒトラー
Facebook	Facebook
L-Ewwel Gwerra Dinjija	第一次世界大戦
It-Tieni Gwerra Dinjija	第二次世界大戦
Wikotba	ウィキブックス
Wikikwota	ウィキクォート
Wikiversità	ウィキバーシティ
Skopje	スコピエ
Szczecin	シュチェチン
Matematika	数学
Lingwa Latina	ラテン語
Baħrejn	バーレーン
Armenja	アルメニア
Serbja	セルビア
Qamar	月
Awstralja	オーストラリア
Arġentina	アルゼンチン
Perù	ペルー
Bijoloġija	生物学
Kambodja	カンボジア
Faxxa ta' Kuiper	エッジワース・カイパーベルト
Koran	クルアーン
Dinosawru	恐竜
Iżlam	イスラム教
Ljubljana	リュブリャナ
Unjoni Ewropea	欧州連合
Plovdiv	プロヴディフ
Mara	女性
Poeżija	詩
Lumija	レモン
Émile Zola	エミール・ゾラ
Napuljun I ta' Franza	ナポレオン・ボナパルト
Vesuvju	ヴェスヴィオ
Xemx	太陽
Sena dawl	光年
Oċeanja	オセアニア
Sistema Solari	太陽系
Idroġenu	水素
Wikimedia Commons	ウィキメディア・コモンズ
Lejl	夜
Oslo	オスロ
Katowice	カトヴィツェ
Toqba sewda	ブラックホール
Lionel Messi	リオネル・メッシ
Karbonju	炭素
Ażotu	窒素
Ossiġenu	酸素
Inter Milan	インテルナツィオナーレ・ミラノ
Pjaneta	惑星
Kleopatra VII	クレオパトラ7世
Mużika	音楽
Moska	モスクワ
Lingwa Taljana	イタリア語
Ċad	チャド
New Zealand	ニュージーランド
Indja	インド
Tuvalu	ツバル
Ħadid	鉄
Tonga	トンガ
Samoa	サモア
Gżejjer Solomon	ソロモン諸島
Vanwatu	バヌアツ
Molière	モリエール
Papwa Gwinea l-Ġdida	パプアニューギニア
William Shakespeare	ウィリアム・シェイクスピア
Nawru	ナウル
Kiribati	キリバス
Fiġi	フィジー
Veneżwela	ベネズエラ
Genghis Khan	チンギス・カン
Żiemel	ウマ
Annimal	動物
Surinam	スリナム
Paragwaj	パラグアイ
Gujana	ガイアナ
Arti	芸術
Ekwador	エクアドル
Kolombja	コロンビア
Buddiżmu	仏教
Bolivja	ボリビア
Trinidad u Tobago	トリニダード・トバゴ
Saint Vincent u l-Grenadini	セントビンセント・グレナディーン
Santa Luċija	セントルシア
Leonardo da Vinci	レオナルド・ダ・ヴィンチ
Saint Kitts u Nevis	セントクリストファー・ネイビス
Ġamajka	ジャマイカ
Grenada	グレナダ
Gwatemala	グアテマラ
Baħamas	バハマ
Antigwa u Barbuda	アンティグア・バーブーダ
Ħonduras	ホンジュラス
Dominika	ドミニカ国
Repubblika Dominikana	ドミニカ共和国
Ħaiti	ハイチ
El Salvador	エルサルバドル
Iran	イラン
Iraq	イラク
Kosta Rika	コスタリカ
Iżrael	イスラエル
Panama	パナマ
Jemen	イエメン
Lingwa pollakka	ポーランド語
Ġordan	ヨルダン
Nikaragwa	ニカラグア
Libanu	レバノン
Maldive	モルディブ
Malażja	マレーシア
Burma	ミャンマー
Pakistan	パキスタン
Qatar	カタール
Arabja Sawdija	サウジアラビア
Sri Lanka	スリランカ
Josif Stalin	ヨシフ・スターリン
YouTube	YouTube
Aristotli	アリストテレス
Emirati Għarab Magħquda	アラブ首長国連邦
Vjetnam	ベトナム
Korea t'Isfel	大韓民国
Afganistan	アフガニスタン
Bangladexx	バングラデシュ
Mali	マリ共和国
Angola	アンゴラ
Butan	ブータン
Brunej	ブルネイ
Tanżanija	タンザニア
Repubblika Ċentru-Afrikana	中央アフリカ共和国
Isaac Newton	アイザック・ニュートン
Isfar	黄色
Mekkanika kwantistika	量子力学
Togo	トーゴ
Tuneżija	チュニジア
Żambja	ザンビア
Żimbabwe	ジンバブエ
Sudan t'Isfel	南スーダン
Benin	ベナン
Botswana	ボツワナ
Wikiħbarijiet	ウィキニュース
Burkina Faso	ブルキナファソ
Burundi	ブルンジ
Komoros	コモロ
Repubblika tal-Kongo	コンゴ共和国
Repubblika Demokratika tal-Kongo	コンゴ民主共和国
Ġibuti	ジブチ
Bavarja	バイエルン州
Ginea Ekwatorjali	赤道ギニア
Eritrea	エリトリア
Papa Ġwanni Pawlu II	ヨハネ・パウロ2世 (ローマ教皇)
Gabon	ガボン
Mahatma Gandhi	マハトマ・ガンディー
Gambja	ガンビア
Ginea	ギニア
Ginea Bissaw	ギニアビサウ
Kosta tal-Avorju	コートジボワール
Kamerun	カメルーン
Kap Verde	カーボベルデ
Lesoto	レソト
Liberja	リベリア
Libja	リビア
Madagaskar	マダガスカル
Malawi	マラウイ
Mawritanja	モーリタニア
Mawrizju	モーリシャス
Marokk	モロッコ
Możambik	モザンビーク
Namibja	ナミビア
Niġer	ニジェール
Niġerja	ナイジェリア
Charles Darwin	チャールズ・ダーウィン
Uganda	ウガンダ
Rwanda	ルワンダ
São Tomé u Príncipe	サントメ・プリンシペ
Senegal	セネガル
Seychelles	セーシェル
Sierra Leone	シエラレオネ
Somalja	ソマリア
Sudan	スーダン
Sważiland	スワジランド
Amburgu	ハンブルク
Evoluzzjoni	進化
Ġnus Magħquda	国際連合
Dante Alighieri	ダンテ・アリギエーリ
Ġeografija	地理学
Qalb	心臓
Praga	プラハ
Ikħal	青
Limburgu (Belġju)	リンブルフ州 (ベルギー)
Fjandri tal-Punent	ウェスト＝フランデレン州
Fjandri tal-Lvant	オースト＝フランデレン州
Antwerp (provinċja)	アントウェルペン州
Brabant Fjamming	フラームス＝ブラバント州
Merkurju (mitoloġija)	メルクリウス
Hector Berlioz	エクトル・ベルリオーズ
Giorgio Napolitano	ジョルジョ・ナポリターノ
Francesco Cossiga	フランチェスコ・コッシガ
Oċean Indjan	インド洋
Kosovo	コソボ
Frédéric Chopin	フレデリック・ショパン
Kategorija:Prinċipali	Category:主要カテゴリ
Dortmund	ドルトムント
The Beatles	ビートルズ
Osama Bin Laden	ウサーマ・ビン・ラーディン
Lingwa Spanjola	スペイン語
Montevideo	モンテビデオ
Johann Sebastian Bach	ヨハン・ゼバスティアン・バッハ
Brimba	クモ
Virġilju	ウェルギリウス
Uetersen	ユーテルゼン
Karozza	自動車
Żagreb	ザグレブ
Sqallija	シチリア
Maurits Cornelis Escher	マウリッツ・エッシャー
Buenos Aires	ブエノスアイレス
Belt tal-Messiku	メキシコシティ
Tokjo	東京都
Barċellona	バルセロナ
Ateni	アテネ
AC Milan	ACミラン
Ħavana	ハバナ
Édith Piaf	エディット・ピアフ
Kopenħagen	コペンハーゲン
Stokkolma	ストックホルム
Ħelsinki	ヘルシンキ
Dublin	ダブリン
Rejkjavik	レイキャヴィーク
Tallinn	タリン
Riga	リガ
Bratislava	ブラチスラヴァ
Gdańsk	グダニスク
Lussemburgu (belt)	ルクセンブルク (都市)
Bibbja	聖書
Ho Chi Minh (belt)	ホーチミン市
Knisja Vera ta' Ġesù	真イエス教会
Dong Hoi	ドンホイ
Concepción (Ċili)	コンセプシオン (チリ)
Atalanta BC	アタランタBC
Bolonja	ボローニャ
Bologna FC 1909	ボローニャFC
Cagliari	カリャリ
Kiev	キエフ
Cagliari Calcio	カリアリ・カルチョ
Karim Benzema	カリム・ベンゼマ
Patrice Evra	パトリス・エヴラ
Końskowola	コィンスコヴォラ
2014	2014年
2015	2015年
2007	2007年
ACF Fiorentina	ACFフィオレンティーナ
Serp	ヘビ
1 ta' Jannar	1月1日
2 ta' Jannar	1月2日
Rivoluzzjoni Industrijali	産業革命
Imperu Ruman	ローマ帝国
Minsk	ミンスク
Microsoft	マイクロソフト
8 ta' Diċembru	12月8日
Kurów	クルフ
Kimika	化学
19 ta' Marzu	3月19日
Papa Benedittu XVI	ベネディクト16世 (ローマ教皇)
Papa Piju XII	ピウス12世 (ローマ教皇)
Watford FC	ワトフォードFC
Futbol	サッカー
L-Olokawst	ホロコースト
Madrid	マドリード
Michael Jackson	マイケル・ジャクソン
5 ta' Settembru	9月5日
4 ta' Settembru	9月4日
Santiago (Ċili)	サンティアゴ (チリ)
25 ta' Ottubru	10月15日
5 ta' Novembru	11月5日
22 ta' Novembru	11月22日
Aħdar	緑
Aħmar	赤
Lourdes	ルルド
Rabat (Marokk)	ラバト
Kometa	彗星
Belgrad	ベオグラード
Kategorija:Mudelli	Category:ウィキペディアのテンプレート
George Sand	ジョルジュ・サンド
Nikosija	ニコシア
Asterojde	小惑星
Manama	マナーマ
Eklissi solari	日食
Wikipedija:Paġna tal-provi	Wikipedia:サンドボックス
Nettunu (mitoloġija)	ネプトゥーヌス
Alġebra	代数学
Ajruport Dong Hoi	ドンホイ空港
Miley Cyrus	マイリー・サイラス
Curitiba	クリチバ
Pangea	パンゲア大陸
Kategorija:1888	Category:1888年
Konfuċju	孔子
Corbin Bleu	コービン・ブルー
Kategorija:Matematika	Category:数学
Gżejjer Faroe	フェロー諸島
Mudell:Dati pajjiż Iran	Template:Country data Iran
Ġove (mitoloġija)	ユーピテル
Sherlock Holmes	シャーロック・ホームズ
Rinaxximent	ルネサンス
Kategorija:Twieldu fl-1888	Category:1888年生
Ewro	ユーロ
Baħar Mediterran	地中海
Kristjaneżmu	キリスト教
Mudell:Favur	Template:賛成
Għasfur	鳥類
Belt kapitali	首都
Monzón	モンソン
Mustafa Kemal Atatürk	ムスタファ・ケマル・アタテュルク
Mudell:Portal	Template:ウィキポータルリンク
Huang Xianfan	黄現ハン
Bill Gates	ビル・ゲイツ
Struttura .NET	.NET Framework
Enċiklopedija	百科事典
Il-Paġna prinċipali	メインページ
Baskitbol	バスケットボール
Francisco Goya	フランシスコ・デ・ゴヤ
Albrecht Dürer	アルブレヒト・デューラー
Frida Kahlo	フリーダ・カーロ
Mikelanġlu	ミケランジェロ・ブオナローティ
Miguel de Cervantes	ミゲル・デ・セルバンテス
Charles Dickens	チャールズ・ディケンズ
Mekka	メッカ
Che Guevara	チェ・ゲバラ
Mao Zedong	毛沢東
Johann Wolfgang von Goethe	ヨハン・ヴォルフガング・フォン・ゲーテ
Filosofija	哲学
Jimi Hendrix	ジミ・ヘンドリックス
Kategorija:Proposti għat-tħassir minnufih	Category:即時削除対象のページ
Hebe Camargo	ヘーペ・カマルゴ
Komuniżmu	共産主義
Saħara tal-Punent	西サハラ
Pajjiż	国
Kartaġni	カルタゴ
Kategorija:Astronomija	Category:天文学
UTC−3:30	UTC-3:30
Søren Kierkegaard	セーレン・キェルケゴール
Bolzano	ボルツァーノ
Rivoluzzjoni Franċiża	フランス革命
Saħara	サハラ砂漠
Strażburgu	ストラスブール
Lingwa Kroata	クロアチア語
UTC+1	UTC+1
Omeru	ホメーロス
UTC+2	UTC+2
UTC+3	UTC+3
Lena Meyer-Landrut	レナ・マイヤー＝ランドルート
Seklu XVII	17世紀
Ateiżmu	無神論
Ekoloġija	生態学
FC Barcelona	FCバルセロナ
Marie Curie	マリ・キュリー
Premju Nobel	ノーベル賞
Alan Turing	アラン・チューリング
Ideoloġija	イデオロギー
Ada Lovelace	エイダ・ラブレス
Franz Schubert	フランツ・シューベルト
Igor' Stravinskij	イーゴリ・ストラヴィンスキー
Pëtr Il'ič Čajkovskij	ピョートル・チャイコフスキー
Giuseppe Verdi	ジュゼッペ・ヴェルディ
Kristofru Kolombu	クリストファー・コロンブス
Nagħġa	ヒツジ
Mammiferu	哺乳類
Naħla	ハナバチ
Speċi	種 (分類学)
Tifel	子供
Napuljun III	ナポレオン3世
Vladimir Putin	ウラジーミル・プーチン
Analisi matematika	解析学
Commonwealth tan-Nazzjonijiet	イギリス連邦
Organizzazzjoni Dinjija tas-Saħħa	世界保健機関
Demm	血液
Pulmun	肺
Casablanca	カサブランカ
Xjenza Naturali	自然科学
Santu Wistin	アウグスティヌス
Nelson Mandela	ネルソン・マンデラ
Martin Luther King Jr.	マーティン・ルーサー・キング・ジュニア
Ġeometrija	幾何学
Atmosfera	大気圏
Kategorija:Bulgarija	Category:ブルガリア
Kategorija:Franza	Category:フランス
Kategorija:Mużika	Category:音楽
Elf Lejla u Lejla	千夜一夜物語
Kategorija:Letteratura	Category:文学
Ilijade	イーリアス
Alessandru Manju	アレクサンドロス3世
Edukazzjoni	教育
Hugo Chávez	ウゴ・チャベス
Raġel	男性
Otto von Bismarck	オットー・フォン・ビスマルク
Abort	妊娠中絶
Skjavitù	奴隷
Logħob Olimpiku tas-sajf 2008	北京オリンピック
US Sassuolo Calcio	USサッスオーロ・カルチョ
Logħob Olimpiku tas-sajf 2016	リオデジャネイロオリンピック
Gwerra Ċivili Amerikana	南北戦争
Imperu Brittaniku	イギリス帝国
Real Madrid CF	レアル・マドリード
Sivilja	セビリア
Rivoluzzjoni Russa	ロシア革命
Arkimede	アルキメデス
Thomas Edison	トーマス・エジソン
Ewklide	エウクレイデス
Bit	ビット
Parlament Ewropew	欧州議会
Kostellazzjoni	星座
Karl Marx	カール・マルクス
Voltaire	ヴォルテール
Ħinduiżmu	ヒンドゥー教
Erwin Schrödinger	エルヴィン・シュレーディンガー
Lingwa Maltija	マルタ語
Reliġjon	宗教
René Descartes	ルネ・デカルト
Pawlu minn Tarsu	パウロ
Immanuel Kant	イマヌエル・カント
Guy de Maupassant	ギ・ド・モーパッサン
Friedrich Nietzsche	フリードリヒ・ニーチェ
Fwied	肝臓
Kilwa	腎臓
Fenek	ウサギ
Psikoloġija	心理学
Gautama Buddha	釈迦
Premier League	プレミアリーグ
Muħammed	ムハンマド・イブン＝アブドゥッラーフ
Probabbiltà	確率
Martin Luteru	マルティン・ルター
Xigħa	シーア派
Knisja Kattolika	カトリック教会
Chelsea FC	チェルシーFC
Arsenal FC	アーセナルFC
Sistema diġestiva	消化器
Logħob Olimpiku tax-xitwa 2010	バンクーバーオリンピック
Reġina Eliżabetta II	エリザベス2世
Alfabett	アルファベット
Ronald Reagan	ロナルド・レーガン
Francisco Varallo	フランシスコ・バラージョ
Festival tal-Eurovision 2005	ユーロビジョン・ソング・コンテスト2005
Festival tal-Eurovision 2006	ユーロビジョン・ソング・コンテスト2006
Festival tal-Eurovision 2007	ユーロビジョン・ソング・コンテスト2007
Festival tal-Eurovision 2008	ユーロビジョン・ソング・コンテスト2008
Festival tal-Eurovision 2009	ユーロビジョン・ソング・コンテスト2009
Festival tal-Eurovision 2010	ユーロビジョン・ソング・コンテスト2010
Festival tal-Eurovision 2011	ユーロビジョン・ソング・コンテスト2011
Festival tal-Eurovision 2012	ユーロビジョン・ソング・コンテスト2012
Festival tal-Eurovision 2013	ユーロビジョン・ソング・コンテスト2013
Catherine Middleton	キャサリン (ケンブリッジ公爵夫人)
David Beckham	デビッド・ベッカム
Ryan Giggs	ライアン・ギグス
Frankonja t'Isfel	ウンターフランケン
Tom Cleverley	トム・クレヴァリー
Ben Foster	ベン・フォスター (サッカー選手)
Ashley Young	アシュリー・ヤング
Kim Jong-il	金正日
Kategorija:Veneżwela	Category:ベネズエラ
Belfast	ベルファスト
Tavla perjodika	周期表
Tórshavn	トースハウン
Manuel Almunia	マヌエル・アルムニア
Attakki tal-11 ta' Settembru	アメリカ同時多発テロ事件
Chordata	脊索動物
Kultura	文化
Trattat ta' Maastricht	マーストリヒト条約
Mediċina	医学
Sarajevo	サラエヴォ
Ekwazzjoni differenzjali	微分方程式
Kategorija:Brażil	Category:ブラジル
Kategorija:Rumanija	Category:ルーマニア
Element kimiku	元素
Funzjonijiet (matematika)	関数 (数学)
Kimika organika	有機化学
Mekkanika klassika	古典力学
Klassifikazzjoni bijoloġika	生物の分類
Arti marzjali	格闘技
Rota	自転車
Relatività ristretta	特殊相対性理論
Ħġieġ	ガラス
Karta	紙
Kilogramm	キログラム
Cristiano Ronaldo	クリスティアーノ・ロナウド
Metru	メートル
Pittura	絵画
Skultura	彫刻
Żfin	ダンス
Pajjiżi tad-dinja	国の一覧
Preistorja	先史時代
Silvio Berlusconi	シルヴィオ・ベルルスコーニ
Eric Saade	エリック・サーデ
4′33″	4分33秒
Kolera	コレラ
Skerma	フェンシング
Sfera ċelesti	天球
Malarja	マラリア
AIDS	後天性免疫不全症候群
Tuberkulożi	結核
Inna	インナ
Mona Lisa	モナ・リザ
Teorija tan-numri	数論
Kileb	持ち送り
Biżantini	東ローマ帝国
Kruċjata	十字軍
Imperu Ottoman	オスマン帝国
Stephan El Shaarawy	ステファン・エル・シャーラウィ
Mirtilla	ブルーベリー
Lampuna	ラズベリー
Tuta tal-għollieq	ブラックベリー
Kurgan (belt)	クルガン (都市)
Trapani	トラーパニ
Wikispeċi	ウィキスピーシーズ
Lingwa Għarbija	アラビア語
Jum ir-Ringrazzjament	感謝祭
Lingwa Oċċitanija	オック語
Lingwa tas-Sinjali Amerikana	アメリカ手話
Kategorija:Provinċji tal-Italja	イタリアの県の一覧
Alkoħoliżmu	アルコール依存症
FC Bayern Munich	バイエルン・ミュンヘン
Serie A	セリエA (サッカー)
Queen	クイーン (バンド)
Provinċja ta' Agrigento	アグリジェント県
Provinċja ta' Bergamo	ベルガモ県
Provinċja ta' Kaltanissetta	カルタニッセッタ県
Provinċja ta' Lodi	ローディ県
Wikipedija:Vetrina	Wikipedia:秀逸な記事
Mudell:Link FA	Template:Link FA
Dinja	世界
Wikipedija:Pjazza	Wikipedia:井戸端
Takson	タクソン
Papa Pawlu VI	パウロ6世 (ローマ教皇)
Etna	エトナ火山
Clube de Regatas do Flamengo	CRフラメンゴ
Gerard Piqué	ジェラール・ピケ
San Lawrenz	ローマのラウレンティウス
Martin Schulz	マルティン・シュルツ
KAA Gent	KAAヘント
Mudell Standard	標準模型
Teorija ta' kollox	万物の理論
Tamworth FC	タムワースFC
Mafja	マフィア
Manchester United FC	マンチェスター・ユナイテッドFC
Aston Villa FC	アストン・ヴィラFC
West Ham United FC	ウェストハム・ユナイテッドFC
UEFA Champions League	UEFAチャンピオンズリーグ
UEFA Europa League	UEFAヨーロッパリーグ
Fenek tal-istrixxi ta' Sumatra	スマトラウサギ
Tazza tad-Dinja tal-Futbol	FIFAワールドカップ
Daniel Parejo Muñoz	ダニエル・パレホ
Blackburn Rovers FC	ブラックバーン・ローヴァーズFC
Wolverhampton Wanderers FC	ウルヴァーハンプトン・ワンダラーズFC
Rafael Correa	ラファエル・コレア
R. Charleroi SC	シャルルロワSC
FC Twente	FCトゥウェンテ
Motorhead	モーターヘッド
Milied	クリスマス
Lingwi Romaniċi	ロマンス諸語
Steve Jobs	スティーブ・ジョブズ
Lady Gaga	レディー・ガガ
Indoewropew	インド・ヨーロッパ語族
Muammar al-Gaddafi	ムアンマル・アル＝カッザーフィー
Francesco Totti	フランチェスコ・トッティ
Chișinău	キシナウ
Soċjoloġija	社会学
Şalom	シャーローム (週刊紙)
Didelphidae	オポッサム
Caenolestidae	ケノレステス目
Trojja	イリオス
The Pirate Bay	パイレート・ベイ
Kampjonati Ewropej tal-Futbol 2012	UEFA EURO 2012
Audi	アウディ
Abkażja	アブハジア
Antropoloġija	人類学
Baħar l-Aħmar	紅海
Octave Mirbeau	オクターヴ・ミルボー
Abjad	白
Iswed	黒
Lordi	ローディ (バンド)
Lingwa uffiċjali	公用語
Provinċja ta' Quảng Bình	クアンビン省
Entrena	エントレナ
Mérida (Veneżwela)	メリダ (ベネズエラ)
Benito Mussolini	ベニート・ムッソリーニ
LOST (Serje televiżiva)	LOST
Ġebla tal-ġir	石灰岩
Valletta	バレッタ
Papa Ġwanni XXIII	ヨハネ23世 (ローマ教皇)
Benetice (Světlá nad Sázavou)	ベネティツェ (スヴィエトラー・ナト・サーザヴォウ)
Prixtina	プリシュティナ
Curaçao	キュラソー島
Coccinellidae	テントウムシ
Metatheria	有袋類
Pangolin	センザンコウ
Lagomorpha	ウサギ目
Baqra tal-baħar	ジュゴン目
Eutheria	真獣下綱
Fenek Ewropew	アナウサギ
Leporidae	ウサギ科
Imperu Kushan	クシャーナ朝
Qlugħ	帆
Klaas-Jan Huntelaar	クラース・ヤン・フンテラール
Proboscidea	ゾウ目
Università Niccolò Cusano	ニコラウス・クザーヌス大学
Fażijiet lunari	月相
Fariżej	ファリサイ派
M'Baye Niang	エムベイェ・ニアン
Lepisma saccharina	セイヨウシミ
Membru tal-Parlament Ewropew	欧州議会議員
Laurasiatheria	ローラシア獣上目
Afrotheria	アフリカ獣上目
Ewropa t'Isfel	南ヨーロッパ
Ewropa Ċentrali	中央ヨーロッパ
Lingwa tas-Sinjali Adamorobe	アダモロベ手話
Kristadelfjani	キリスト・アデルフィアン派
Tim nazzjonali tal-futbol tal-Eġittu	サッカーエジプト代表
Maja	マヤ文明
Chow Chow	チャウチャウ
FC Kuban Krasnodar	FCクバン・クラスノダール
Derivata	微分法
Kwalifikazzjoni għall-Kampjonati Ewropej tal-Futbol 2008	UEFA EURO 2008予選
Chris Smalling	クリス・スモーリング
Jonny Evans	ジョニー・エヴァンズ
Michael Carrick	マイケル・キャリック
Multilingwiżmu	多言語
Lingwa Sileżjana	シレジア語
Avril Lavigne	アヴリル・ラヴィーン
Mikhail Gorbachev	ミハイル・ゴルバチョフ
Slogan	スローガン
Madre Tereża ta' Kalkutta	マザー・テレサ
UEFA Champions League 2013–14	UEFAチャンピオンズリーグ 2013-14
Rudolf Clausius	ルドルフ・クラウジウス
Auguste Rodin	オーギュスト・ロダン
Blogg	ブログ
Oscar Wilde	オスカー・ワイルド
Krakovja	クラクフ
Thylacinidae	フクロオオカミ科
Malala Yousafzai	マララ・ユスフザイ
Carlos Alonso González	サンティリャーナ
Valery Leontiev	ヴァレリー・レオンティエフ
Lingwa tas-Sinjali Franċiża	フランス手話
Mużew	博物館
Du Fu	杜甫
Popolazzjoni	人口
Arċipelagu	多島海
Lingwa Sqallija	シチリア語
Valparaíso	バルパライソ
Nju	ニウエ
Tim nazzjonali tal-futbol tal-Iskozja	サッカースコットランド代表
Lingwa Leoniża	レオン語
Żews	ゼウス
Lingwa tas-Sinjali	手話
Astroloġija	占星術
Mošovce	モショヴツェ
Saint-Dié-des-Vosges	サン＝ディエ＝デ＝ヴォージュ
Boris Yeltsin	ボリス・エリツィン
Hirohito	昭和天皇
Baħar Eġew	エーゲ海
J.K. Rowling	J・K・ローリング
Hiroshima	広島市
Mitoloġija Griega	ギリシア神話
Ġeneru (tassonomija)	属 (分類学)
Xjenzi soċjali	社会科学
Lista ta' kodiċi telefoniċi	国際電話番号の一覧
Lista ta' bliet kapitali	首都の一覧
Noemi (kantanta)	ノエミ (歌手)
Sit elettroniku	ウェブサイト
Odissea	オデュッセイア
Lingwa Ido	イド語
Etimoloġija	語源
Nikita Krushchev	ニキータ・フルシチョフ
Kia Motors	起亜自動車
Familja (bijoloġija)	科 (分類学)
UEFA	欧州サッカー連盟
Arthur Conan Doyle	アーサー・コナン・ドイル
Sport Club Corinthians Paulista	コリンチャンス
Lingwa Kopta	コプト語
Folklor	伝承
Siligo	シーリゴ
Mark Zuckerberg	マーク・ザッカーバーグ
Neolitiku	新石器時代
Katerina II tar-Russja	エカチェリーナ2世
Guglielmo Marconi	グリエルモ・マルコーニ
Ordni (bijoloġija)	目 (分類学)
Cork	コーク (アイルランド)
Renju (bijoloġija)	界 (分類学)
Novial	ノヴィアル
Aung San Suu Kyi	アウンサンスーチー
Kompożitur	作曲家
Influwenza tal-majjali	豚インフルエンザ
Serbja u Montenegro	セルビア・モンテネグロ
Romantiċiżmu	ロマン主義
It-Trinita' Mqaddsa	三位一体
Faragħun	ファラオ
Mariupol	マリウポリ
Tazza tad-Dinja tal-Futbol 2006	2006 FIFAワールドカップ
Klaus Ebner	クラウス・エブナー
Klassi (bijoloġija)	綱 (分類学)
Campora San Giovanni	カンポラ・サン・ジョヴァンニ
Bălţi	バルツィ
Auckland Grammar School	オークランド・グラマー・スクール
Bolla postali	切手
Era (mitoloġija)	ヘーラー
Premju Nobel għall-Fiżika	ノーベル物理学賞
Enya	エンヤ
Phylum	門 (分類学)
Enriku VIII tal-Ingilterra	ヘンリー8世 (イングランド王)
São Paulo FC	サンパウロFC
Kelb tal-Fenek	ファラオ・ハウンド
Baħar Tirren	ティレニア海
Leeds	リーズ
NK Čelik Zenica	NKチェリク・ゼニツァ
Surrealiżmu	シュルレアリスム
Birkirkara	ビルキルカラ
Radio Studio 54 Network	Radio Studio 54 Network
Lamantin tal-Karibew	アメリカマナティー
Atti ta' l-Appostli	使徒言行録
Żodjaku	黄道十二星座
Paulínia	パウリニア
Il-100 ktieb tas-seklu skont Le Monde	ルモンド世紀の100冊
Fonoloġija	音韻論
Kim Il-sung	金日成
Jan Vermeer	ヨハネス・フェルメール
Borussia Dortmund	ボルシア・ドルトムント
Għenba tax-xewk	セイヨウスグリ
Michel de Montaigne	ミシェル・ド・モンテーニュ
Golf ta' Biskaja	ビスケー湾
Sorċid	トガリネズミ
Feniċi	フェニキア
Akille	アキレウス
Gramma	グラム
.mt	.mt
Michelangelo Merisi da Caravaggio	ミケランジェロ・メリージ・ダ・カラヴァッジオ
Tim nazzjonali tal-futbol ta' Spanja	サッカースペイン代表
Martin Weinek	マルティン・バイネク
Björk	ビョーク
H. G. Wells	ハーバート・ジョージ・ウェルズ
Tumas More	トマス・モア
Fernando Torres	フェルナンド・トーレス
Lamantin	マナティー
Baħar Liguri	リグリア海
Dima Bilan	ジーマ・ビラーン
Lega Anżejatika	ハンザ同盟
Kubiżmu	キュビスム
Qawwiet tal-Assi tat-Tieni Gwerra Dinjija	枢軸国
Wikipedija:Mistoqsijiet rikorrenti	Wikipedia:FAQ
Għar ta' Thien Duong	天国の洞
Arg-é Bam	アルゲ・バム
Tim nazzjonali tal-futbol tal-Ġermanja	サッカードイツ代表
Gustave Flaubert	ギュスターヴ・フローベール
San Mattew	マタイ
Sant'Ambroġju	アンブロジウス
Ġwanni Kriżostmu	金口イオアン
Papa Piju X	ピウス10世 (ローマ教皇)
Papa Ljun XIII	レオ13世 (ローマ教皇)
Rasputin	グリゴリー・ラスプーチン
San Girgor Nażjanżenu	ナジアンゾスのグレゴリオス
Egon Schiele	エゴン・シーレ
Duminku ta' Guzmán	ドミニコ
Hamit Altıntop	ハミト・アルトゥントップ
Maximilien Robespierre	マクシミリアン・ロベスピエール
Ġlormu	ヒエロニムス
San Bażilju	カイサリアのバシレイオス
Michel Foucault	ミシェル・フーコー
Daniel Van Buyten	ダニエル・ファン・ブイテン
Ilarju ta' Poitiers	ポワティエのヒラリウス
John Henry Newman	ジョン・ヘンリー・ニューマン
Morus (botanika)	クワ
Son Doong	ソンドン洞
Alex Ferguson	アレックス・ファーガソン
Erwin Hoffer	エルヴィン・ホッファー
Arkanġlu Mikiel	ミカエル
Titan	ティーターン
Kardinal	枢機卿
Iżabella ta' Kastilja	イサベル1世 (カスティーリャ女王)
Liebru	ノウサギ属
Felix Mendelssohn	フェリックス・メンデルスゾーン
Orikteropu	ツチブタ
Leonardo Araújo	レオナルド・ナシメント・ジ・アラウージョ
Metodu xjentifiku	科学的方法
Espoo	エスポー (フィンランド)
Bijodiversità	生物多様性
Kannella (kulur)	茶色
Tizjanu	ティツィアーノ・ヴェチェッリオ
Matteo Renzi	マッテオ・レンツィ
Venere (mitoloġija)	ウェヌス
Tazza tad-Dinja tal-Futbol 2002	2002 FIFAワールドカップ
Tim nazzjonali tal-futbol tal-Ingilterra	サッカーイングランド代表
Tim nazzjonali tal-futbol ta' Franza	サッカーフランス代表
Sid Vicious	シド・ヴィシャス
Mario Monti	マリオ・モンティ
Stojċiżmu	ストア派
Martin Heidegger	マルティン・ハイデッガー
Tazza tad-Dinja tal-Futbol 1930	1930 FIFAワールドカップ
Università ta' New York	ニューヨーク大学
Giulio Andreotti	ジュリオ・アンドレオッティ
Park Ji-Sung	朴智星
Slaten Maġi	東方の三博士
Charles de Foucauld	シャルル・ド・フーコー
Pajjiżi Nordiċi	北欧
Kategorija:Mudelli tal-kimika	Category:化学関連のテンプレート
Trattat ta' Liżbona	リスボン条約
Claudio Monteverdi	クラウディオ・モンテヴェルディ
Iraċ	ハイラックス
Sami Khedira	サミ・ケディラ
FC Baku	FKバクー
Provinċja ta' Soria	ソリア県
Arkanġlu Rafel	ラファエル
George Abela	ジョージ・アベーラ
Moħammed VI	ムハンマド6世 (モロッコ王)
Jum l-Indipendenza	国家の日
Assedju ta' Malta (1565)	マルタ包囲戦 (1565年)
CONMEBOL	南米サッカー連盟
Erbivoru	草食動物
Herbert von Bismarck	ヘルベルト・フォン・ビスマルク
Oskar Schindler	オスカー・シンドラー
Enejide	アエネーイス
Flamurtari Vlorë	KSフラムルタリ・ヴロラ
KF Laçi	KFラチ
Affiss	接辞
Norberto Murara Neto	ノルベルト・ムラーラ・ネト
L-Għanja tal-Milied	クリスマス・キャロル (小説)
Semitiku	セム族 (民族集団)
Marrara	胆嚢
Sottospeċi	亜種
Ħassan II	ハサン2世 (モロッコ王)
It-Tielet Repubblika Franċiża	フランス第三共和政
Joyeux Noël	戦場のアリア
FK Kukësi	FKクケシ
KF Skënderbeu Korçë	KFスカンデルベウ・コルチャ
Carlos Bacca	カルロス・バッカ
Bank Ċentrali ta' Malta	マルタ中央銀行
Yıldıray Baştürk	ユルドゥライ・バシュテュルク
Alfred Wegener	アルフレート・ヴェーゲナー
Edith Stein	エーディト・シュタイン
Friedrich Carl von Savigny	フリードリヒ・カール・フォン・サヴィニー
Wilhelm von Humboldt	ヴィルヘルム・フォン・フンボルト
Wikipedija:Vetrina/Senjalazzjonijiet	Wikipedia:秀逸な記事の選考
Tazza tad-Dinja tal-Futbol 2014	2014 FIFAワールドカップ
Coronel Fabriciano	コロネル・ファブリシアーノ
L-Integral	積分法
Miroslav Klose	ミロスラフ・クローゼ
Alla Pugacheva	アーラ・プガチョワ
Dante Bonfim Costa Santos	ダンテ・ボンフィム・コスタ・サントス
Isco	フランシスコ・ロマン・アラルコン
Fes	フェズ
Greenpeace	グリーンピース (NGO)
Teuta Durrës	KSテウタ・ドゥラス
Ragħaj	羊飼い
Arkanġlu Gabrijel	ガブリエル
Mata Hari	マタ・ハリ
Fußball-Bundesliga	サッカー・ブンデスリーガ (ドイツ)
Pressjoni tad-demm	血圧
Enea	アイネイアース
Politiku	政治家
David Villa	ダビド・ビジャ
Demenzja	認知症
Jürgen Klopp	ユルゲン・クロップ
Tazza tan-Nazzjonijiet Afrikani	アフリカネイションズカップ
Romeo u Ġuljetta	ロミオとジュリエット
Konfederazzjoni Ażjatika tal-Futbol	アジアサッカー連盟
Robin Williams	ロビン・ウィリアムズ
Normanni	ノルマン人
Tim nazzjonali tal-futbol tal-Brażil	サッカーブラジル代表
Grupp (matematika)	群 (数学)
Mesut Özil	メスト・エジル
Isabel Allende	イサベル・アジェンデ
Wes Brown	ウェズ・ブラウン
It-Tempesta	テンペスト (シェイクスピア)
Jum l-Indipendenza (Stati Uniti)	独立記念日 (アメリカ合衆国)
Mudell:Ċita ktieb	Template:Cite book
Robert Tappan Morris	ロバート・T・モリス
Divorzju	離婚
Chrzanów	フシャヌフ
Medjugori	メジュゴリェ
Suffiss	接尾辞
Artiklu (grammatika)	冠詞
Australopithecus	アウストラロピテクス
Festival tal-Eurovision tat-Tfal	ジュニア・ユーロビジョン・ソング・コンテスト
Kaspar Capparoni	カスパー・カパローニ
Ħolma ta’ Lejla Sajfija	夏の夜の夢
Berthe Morisot	ベルト・モリゾ
Manuel Neuer	マヌエル・ノイアー
Penny Black	ペニー・ブラック
Armistizju	休戦協定
KV Mechelen	KVメヘレン
Heiko Westermann	ハイコ・ヴェスターマン
Montenegro fil-Festival tal-Eurovision	モンテネグロのユーロビジョン・ソング・コンテスト
Papa Ċelestinu V	ケレスティヌス5世 (ローマ教皇)
Nektarivoru	蜜食動物
Amedeo Modigliani	アメデオ・モディリアーニ
Appendiċite	虫垂炎
Marco Streller	マルコ・シュトレラー
Hakan Yakın	ハカン・ヤキン
Ludovic Magnin	リュドヴィク・マニャン
Diego Benaglio	ディエゴ・ベナリオ
Daniel Bernoulli	ダニエル・ベルヌーイ
Jacob Bernoulli	ヤコブ・ベルヌーイ
Stella Mwangi	ステラ・ムワンギ
Dziecinów	ヂェチヌフ (オトフォツク郡)
Pajjiż interkjuż	内陸国
Gwerer Puniċi	ポエニ戦争
Ġunone	ユーノー
Massimo Oddo	マッシモ・オッド
Fraizer Campbell	フレイザー・キャンベル
Allianz Arena	アリアンツ・アレーナ
San Ġużepp	ナザレのヨセフ
Hidetoshi Nakata	中田英寿
FK Borac Banja Luka	FKボラツ・バニャ・ルカ
L-Aħħar Ċena (Leonardo)	最後の晩餐 (レオナルド)
Macroscelididae	ハネジネズミ
Dugongu	ジュゴン
Galway	ゴールウェイ
Mario Balotelli	マリオ・バロテッリ
Marvin Compper	マーヴィン・コンパー
Macbeth	マクベス (シェイクスピア)
Theria	獣亜綱
Akropoli ta' Ateni	アテナイのアクロポリス
Filatelija	郵便趣味
Stromboli	ストロンボリ島
The Fame	ザ・フェイム
FK Austria Wien	FKアウストリア・ウィーン
SK Rapid Wien	SKラピード・ウィーン
IMMAGINE&POESIA	IMMAGINE&POESIA
Venere ta' Willendorf	ヴィレンドルフのヴィーナス
Bandiera ta' Malta	マルタの国旗
Teorija tal-grafi	グラフ理論
Lola Pagnani	ローラ・パニーニ
Bitcoin	ビットコイン
Tim nazzjonali tal-futbol tad-Danimarka	サッカーデンマーク代表
Black metal	ブラックメタル
Ġeroglifiċi Eġizzjani	ヒエログリフ
Sataniżmu	サタニズム
Grawnd Nazzjonali ta' Bejġing	北京国家体育場
Stadio Giuseppe Meazza	スタディオ・ジュゼッペ・メアッツァ
Plotinu	プロティノス
Tim nazzjonali tal-futbol tal-Kroazja	サッカークロアチア代表
Eomanis	エオマニス
Tim nazzjonali tal-futbol tal-Greċja	サッカーギリシャ代表
Tazza tad-Dinja tal-Futbol tal-Klabbs 2006	FIFAクラブワールドカップ2006
Tazza tad-Dinja tal-Futbol tal-Klabbs 2007	FIFAクラブワールドカップ2007
Tazza tad-Dinja tal-Futbol tal-Klabbs 2009	FIFAクラブワールドカップ2009
Tazza tad-Dinja tal-Futbol tal-Klabbs 2008	FIFAクラブワールドカップ2008
Eklissi	食 (天文)
Neymar	ネイマール・ダ・シウバ・サントス・ジュニオール
Brendi	ブランデー
Dominju (bijoloġija)	ドメイン (分類学)
Kassisa	クロスグリ
Dragan Đokanović	ドラガン・ジョカノヴィッチ
David de Gea	ダビド・デ・ヘア
Westfalenstadion	ヴェストファーレンシュタディオン
Robert Lewandowski	ロベルト・レヴァンドフスキ
Kunflitt Iżraeli-Palestinjan	パレスチナ問題
Għajnuna:Kif timmodifika artiklu	Help:ページの編集
Lidl	リドル
Jupp Heynckes	ユップ・ハインケス
Plutone (mitoloġija)	プルートー
Eddie Fenech Adami	エドワルド・フェネク・アダミ
Prim Ministru ta' Malta	マルタの首相
Riccardo Montolivo	リッカルド・モントリーヴォ
Tazza tad-Dinja tal-Futbol tal-Klabbs 2010	FIFAクラブワールドカップ2010
Cristian Zaccardo	クリスティアン・ザッカルド
Gwerra totali	国家総力戦
Nickelodeon	ニコロデオン (TVチャンネル)
Ugo Grozju	フーゴー・グローティウス
René Adler	レネー・アードラー
Eruka	ルッコラ
Ablativ	奪格
Tazza Ażjatika tal-Futbol	AFCアジアカップ
Boomerang TV	BOOMERANG
Internazzjonali Soċjalista	社会主義インターナショナル
Nannakola tas-seba' tikek	ナナホシテントウ
Santa Sede	聖座
Ettore	ヘクトール
WK	西暦
Reġina ta' Saba	シバの女王
Alġebra astratta	抽象代数学
CONCACAF	北中米カリブ海サッカー連盟
Skanderbeg	スカンデルベグ
Tim nazzjonali tal-futbol tal-Iżvezja	サッカースウェーデン代表
Paul Allen	ポール・アレン
Eroj	ヒーロー
Kuopio	クオピオ
Sirt	スルト (リビア)
Soccer City	FNBスタジアム
Tim nazzjonali tal-futbol tal-Awstrija	サッカーオーストリア代表
Tim nazzjonali tal-futbol tal-Irlanda	サッカーアイルランド共和国代表
Nemanja Vidić	ネマニャ・ヴィディッチ
Derry	ロンドンデリー
Ġuvni	学士
Drużiżmu	ドゥルーズ派
Omnivoru	雑食
George Best	ジョージ・ベスト
Oliver Twist	オリバー・ツイスト
Juan Carreño	フアン・カレーニョ
Javier Hernández Balcázar	ハビエル・エルナンデス・バルカサール
Tim nazzjonali tal-futbol tal-Iżvizzera	サッカースイス代表
Ekwazzjoni ta' Schrödinger	シュレーディンガー方程式
Priżma	プリズム
Ballun tad-Deheb	バロンドール
Tim nazzjonali tal-futbol tal-Polonja	サッカーポーランド代表
Foviżmu	フォーヴィスム
Tim nazzjonali tal-futbol tal-Belġju	サッカーベルギー代表
Sant'Antnin ta' Padova	パドヴァのアントニオ
Eredivisie	エールディヴィジ
Konfederazzjoni Afrikana tal-Futbol	アフリカサッカー連盟
Tim nazzjonali tal-futbol tar-Rumanija	サッカールーマニア代表
Dimitar Berbatov	ディミタール・ベルバトフ
Tim nazzjonali tal-futbol tal-Ukrajna	サッカーウクライナ代表
Għawdex	ゴゾ島
Tim nazzjonali tal-futbol tal-Ungerija	サッカーハンガリー代表
Natura mejta	静物画
Laura Pausini	ラウラ・パウジーニ
Gwerra Anglo-Żanżibarjana	イギリス・ザンジバル戦争
Children of Bodom	チルドレン・オブ・ボドム
Festival tal-Eurovision 1956	ユーロビジョン・ソング・コンテスト1956
Tazza tal-Konfederazzjonijiet	FIFAコンフェデレーションズカップ
Tim nazzjonali tal-futbol tas-Slovenja	サッカースロベニア代表
Darren Fletcher	ダレン・フレッチャー
Gowler	ゴールキーパー
Mary Cassatt	メアリー・カサット
Frankinċens	乳香
Cape Town Stadium	ケープタウン・スタジアム
Xenarthra	異節上目
Lista ta' kimiċi organiċi	有機化合物
Lira Maltija	マルタ・リラ
Antonio Valencia	アントニオ・バレンシア
Tim nazzjonali tal-futbol tas-Slovakkja	サッカースロバキア代表
Tereża ta' Ávila	アビラのテレサ
Guernica (pittura)	ゲルニカ (絵画)
Tim nazzjonali tal-futbol ta' New Zealand	サッカーニュージーランド代表
Kompjuter kwantistiku	量子コンピュータ
Tazza tad-Dinja tal-Futbol 2010	2010 FIFAワールドカップ
Kantant	歌手
Andrea Palladio	アンドレーア・パッラーディオ
Heurelho Gomes	エウレリョ・ダ・シウヴァ・ゴメス
Moviment Brownjan	ブラウン運動
Filosofija Presokratika	ソクラテス以前の哲学者
Marvin Ogunjimi	マーヴィン・オグンジミ
Apparat Periferali	周辺機器
Meknès	メクネス
Copa América	コパ・アメリカ
Serje ta' Fourier	フーリエ級数
Santa Katarina ta' Lixandra	アレクサンドリアのカタリナ
Lipari	エオリア諸島
Liebru tal-muntanji	ユキウサギ
Konfederazzjoni Oċeanika tal-Futbol	オセアニアサッカー連盟
Kwalifikazzjoni għall-Kampjonati Ewropej tal-Futbol 2012	UEFA EURO 2012予選
Tim nazzjonali tal-futbol tal-Andorra	サッカーアンドラ代表
Tim nazzjonali tal-futbol tal-Ażerbajġan	サッカーアゼルバイジャン代表
Klassifika dinjija tal-FIFA	FIFAランキング
Charlotte Perrelli	シャロッテ・ペレッリ
Tim nazzjonali tal-futbol tal-Bulgarija	サッカーブルガリア代表
Tim nazzjonali tal-futbol ta' Wales	サッカーウェールズ代表
Atomium	アトミウム
Tim nazzjonali tal-futbol tal-Bożnija u Ħerżegovina	サッカーボスニア・ヘルツェゴビナ代表
Tereża ta' Lisieux	リジューのテレーズ
Tabella tal-midalji tal-Logħob Olimpiku tas-sajf 2008	北京オリンピックでの国・地域別メダル受賞数一覧
Ellis Park Stadium	エリス・パーク・スタジアム
Tazza Interkontinentali (futbol)	インターコンチネンタルカップ (サッカー)
Bing	Bing
Plejer tas-Sena tal-FIFA	FIFA最優秀選手賞
Santa Luċija (qaddisa)	シラクサのルチア
Tim nazzjonali tal-futbol tal-Armenja	サッカーアルメニア代表
San Bastjan	セバスティアヌス
Kolugo	ヒヨケザル目
Tim nazzjonali tal-futbol tal-Każakistan	サッカーカザフスタン代表
Tazza tal-Konfederazzjonijiet 2009	FIFAコンフェデレーションズカップ2009
Pika	ナキウサギ
Thomas Vermaelen	トーマス・フェルメーレン
UEFA Champions League 2009–10	UEFAチャンピオンズリーグ 2009-10
Tim nazzjonali tal-futbol tal-Lussemburgu	サッカールクセンブルク代表
Diġitigrad	趾行
Gareth Bale	ガレス・ベイル
Inkwiżizzjoni Spanjola	スペイン異端審問
Glen Johnson	グレン・ジョンソン
Manuel Rivera-Ortiz	マヌエル・リベラ＝オルティス
Tim nazzjonali tal-futbol ta' San Marino	サッカーサンマリノ代表
Immakulata Kunċizzjoni	無原罪の御宿り
Nigel de Jong	ナイジェル・デ・ヨング
Tim nazzjonali tal-futbol tal-Bjelorussja	サッカーベラルーシ代表
Tim nazzjonali tal-futbol tal-Albanija	サッカーアルバニア代表
Tim nazzjonali tal-futbol tal-Ġeorġja	サッカーグルジア代表
Tim nazzjonali tal-futbol tal-Litwanja	サッカーリトアニア代表
Karmelitani	カルメル会
UEFA Champions League 2007–08	UEFAチャンピオンズリーグ 2007-08
Tim nazzjonali tal-futbol tal-Finlandja	サッカーフィンランド代表
Tim nazzjonali tal-futbol tal-Liechtenstein	サッカーリヒテンシュタイン代表
Premier League 2008–09	プレミアリーグ2008-2009
Tim nazzjonali tal-futbol tal-Estonja	サッカーエストニア代表
Premier League 2010–11	プレミアリーグ2010-2011
Ħin supplementari	延長戦
Peter Mokaba Stadium	ピーター・モカバ・スタジアム
Joe Hart	ジョー・ハート
Malena Ernman	マレーナ・エルンマン
Premier League 2007–08	プレミアリーグ2007-2008
RSC Anderlecht	RSCアンデルレヒト
Barriera	採石場
Oroskopju	ホロスコープ
Eġizzjan demotiku	デモティック
Fatt	事実
FK Partizan	パルチザン・ベオグラード
Tim nazzjonali tal-futbol ta' Malta	サッカーマルタ代表
Supereroj	スーパーヒーロー
UEFA Champions League 2008–09	UEFAチャンピオンズリーグ 2008-09
Tim nazzjonali tal-futbol ta' Ċipru	サッカーキプロス代表
Premier League 2009–10	プレミアリーグ2009-2010
Tim nazzjonali tal-futbol tal-Montenegro	サッカーモンテネグロ代表
UEFA Champions League 2010–11	UEFAチャンピオンズリーグ 2010-11
Rafael Pereira da Silva (twieled fl-1990)	ラファエウ・ペレイラ・ダ・シウヴァ
FA Community Shield	FAコミュニティ・シールド
Tim nazzjonali tal-futbol tal-Iżlanda	サッカーアイスランド代表
Tim nazzjonali tal-futbol tal-Unjoni Sovjetika	サッカーソビエト連邦代表
Soċjaliżmu Demokratiku	民主社会主義
Tim nazzjonali tal-futbol tal-Latvja	サッカーラトビア代表
CONCACAF Gold Cup	CONCACAFゴールドカップ
Pont du Gard	ポン・デュ・ガール
Sligo	スライゴ
Emblema ta' Malta	マルタの国章
Benvenuto Cellini	ベンヴェヌート・チェッリーニ
Ordni Militari Sovran ta' Malta	マルタ騎士団
Standard Liège	スタンダール・リエージュ
Club Brugge KV	クラブ・ブルッヘ
Jóhanna Guðrún Jónsdóttir	ヨハンナ・グズルン・ヨンスドッティル
Tim nazzjonali tal-futbol tal-Irlanda ta' Fuq	サッカー北アイルランド代表
Edward Sapir	エドワード・サピア
Kemmuna	コミノ島
FC BATE Borisov	FC BATEボリソフ
Lucrezia Borgia	ルクレツィア・ボルジア
Klara ta' Assisi	アッシジのキアラ
Tim nazzjonali tal-futbol tal-Iżrael	サッカーイスラエル代表
Gareth Barry	ギャレス・バリー
San Valentinu	ウァレンティヌス
FK Ekranas	FKエクラナス・パネヴェジース
Mini ta' Cu Chi	クチの地下道
L-Innu Malti	マルタ賛歌
Midfilder	ミッドフィールダー
Kwalifikazzjoni għat-Tazza tad-Dinja tal-Futbol 2010	2010 FIFAワールドカップ・予選
Kate Ryan	ケイト・ライアン
Lys Assia	リス・アシア
Patri Piju	ピオ神父
Analisi komplessa	複素解析
Martín Cáceres	マルティン・カセレス
Thylacinus	フクロオオカミ属
Royale Union Saint-Gilloise	ロイヤル・ユニオン・サン＝ジロワーズ
Fertilizzazzjoni ''in vitro''	体外受精
Tim nazzjonali tal-futbol tal-Gżejjer Faroe	サッカーフェロー諸島代表
Magnificat	マニフィカト
Gowler (futbol)	ゴールキーパー (サッカー)
Theofanis Gekas	テオファニス・ゲカス
Ażerbajġan fil-Festival tal-Eurovision	アゼルバイジャンのユーロビジョン・ソング・コンテスト
Papat ta' Avignon	アヴィニョン捕囚
G-14	G-14
Armenja fil-Festival tal-Eurovision	アルメニアのユーロビジョン・ソング・コンテスト
Albanija fil-Festival tal-Eurovision	アルバニアのユーロビジョン・ソング・コンテスト
Rush	ラッシュ (バンド)
Dundalk	ダンドーク
Kumitat tar-Reġjuni	地域委員会 (EU)
Id-Dsatax-il Emenda għall-Kostituzzjoni tal-Istati Uniti	アメリカ合衆国憲法修正第19条
Mandejżmu	マンダ教
'O sole mio	オー・ソレ・ミオ
SK Sturm Graz	SKシュトゥルム・グラーツ
Il-Merkant ta’ Venezja	ヴェニスの商人
Hugo (film)	ヒューゴの不思議な発明
Hapoel Tel Aviv FC	ハポエル・テルアビブFC
UEFA Europa League 2009–10	UEFAヨーロッパリーグ 2009-10
Phil Jones	フィル・ジョーンズ (サッカー選手)
UEFA Europa League 2010–11	UEFAヨーロッパリーグ 2010-11
Olympe de Gouges	オランプ・ド・グージュ
Giovanni Falcone	ジョヴァンニ・ファルコーネ
Mdina	イムディーナ
Vulcano	ヴルカーノ島
Tranquillo Barnetta	トランクイロ・バルネッタ
Liġi tan-numri kbar	大数の法則
Andorra fil-Festival tal-Eurovision	アンドラのユーロビジョン・ソング・コンテスト
Kitba jeratika	ヒエラティック
Rapidshare	RapidShare
Batterija	バッテリー
Kung fu	功夫
San Marino fil-Festival tal-Eurovision	サンマリノのユーロビジョン・ソング・コンテスト
Federico Macheda	フェデリコ・マケダ
Regola tal-gowls barra mid-dar	アウェーゴール
Las Meninas	ラス・メニーナス
Ingólfr Arnarson	インゴールヴル・アルナルソン
Talpa marsupjal ta' Nofs in-nhar	フクロモグラ
Elezzjonijiet Ewropej 2009	2009年欧州議会議員選挙
KF Tirana	KFティラナ
Superliga Albaniża	カテゴリア・スペリオレ
Kewkba ta' Betlehem	ベツレヘムの星
FC Dinamo Minsk	FCディナモ・ミンスク
Nick Drake	ニック・ドレイク
Marokk fil-Festival tal-Eurovision	モロッコのユーロビジョン・ソング・コンテスト
Zoran Tošić	ゾラン・トシッチ
Golf	ゴルフ (曖昧さ回避)
Kwalifikazzjoni għat-Tazza tad-Dinja tal-Futbol 2010 (UEFA)	2010 FIFAワールドカップ・ヨーロッパ予選
Palazz Belvedere	ベルヴェデーレ宮殿
Andrea Poli	アンドレア・ポーリ
Bjelorussja fil-Festival tal-Eurovision	ベラルーシのユーロビジョン・ソング・コンテスト
Artemisia Gentileschi	アルテミジア・ジェンティレスキ
Gżejjer Aran	アラン諸島
André Villas-Boas	アンドレ・ビラス・ボアス
Samir Handanovič	サミール・ハンダノヴィッチ
Ignazio Abate	イニャツィオ・アバーテ
Gelson Fernandes	ジェルソン・フェルナンデス
Idriss Carlos Kameni	イドリス・カルロス・カメニ
Marlee Matlin	マーリー・マトリン
Dasyuromorphia	フクロネコ目
Football League	フットボールリーグ
Fábio Pereira da Silva	ファビオ・ペレイラ・ダ・シウヴァ
Antonio Nocerino	アントニオ・ノチェリーノ
Mohamed Bouazizi	モハメド・ブアジジ
Anna Bergendahl	アンナ・ベリエンダール
Denílson Pereira Neves	デニウソン・ペレイラ・ネヴェス
Emerson Ferreira da Rosa	エメルソン・フェレイラ
L-Ewwel Diviżjoni Belġjana	ジュピラー・プロ・リーグ
KRC Genk	KRCヘンク
Lied	歌曲
Kalkulu tal-varjazzjonijiet	変分法
Ġgantija	ジュガンティーヤ
UNCLOS Konvenzjoni tal-Ġnus Magħquda dwar id-Dritt tal-Baħar	海洋法に関する国際連合条約
Trama (narrattiva)	プロット (物語)
Filippu Neri	フィリッポ・ネリ
Neftchi Baku PFC	ネフチ・バクー
Bundesliga (Awstrija)	サッカー・ブンデスリーガ (オーストリア)
Al-Fatiħa	開端 (クルアーン)
Tazza tal-Konfederazzjonijiet 2013	FIFAコンフェデレーションズカップ2013
Giuseppe Rossi	ジュゼッペ・ロッシ
Darron Gibson	ダロン・ギブソン
Russja fil-Festival tal-Eurovision	ロシアのユーロビジョン・ソング・コンテスト
Enzo Scifo	エンツォ・シーフォ
Air Malta	マルタ航空
Kwalifikazzjoni għat-Tazza tad-Dinja tal-Futbol 2010 (CONCACAF)	2010 FIFAワールドカップ・北中米カリブ海予選
F91 Dudelange	F91デュドランジュ
FC Santa Coloma	FCサンタ・コロマ
KSC Lokeren Oost-Vlaanderen	スポルティング・ロケレン
Tito Vilanova	フランセスク・ビラノバ
Kwalifikazzjoni għat-Tazza tad-Dinja tal-Futbol 2010 (OFC)	2010 FIFAワールドカップ・オセアニア予選
Tazza tad-Dinja tal-Futbol tal-Klabbs	FIFAクラブワールドカップ
No (teatru)	能
AFC	AFC
CAF	CAF
Premier League (diżambigwazzjoni)	プレミアリーグ (曖昧さ回避)
Alessandro Nesta	アレッサンドロ・ネスタ
Johann Bernoulli	ヨハン・ベルヌーイ
Tribù (bijoloġija)	族 (分類学)
Santa Katerina ta' Siena	シエナのカタリナ
Alexa Internet	アレクサ・インターネット
Tupaja	ツパイ目
Liebru tal-Artiku	ホッキョクウサギ
Żarbuna tad-Deheb	ヨーロッパ・ゴールデンシュー
Denis Law	デニス・ロー
Taljan	イタリアン
Al-Iħlas	純正 (クルアーン)
Daniele Bonera	ダニエレ・ボネーラ
Incertae sedis	Incertae sedis
Ġużeppina Bakhita	ジュゼッピーナ・バキタ
Sofonisba Anguissola	ソフォニスバ・アングイッソラ
Elena Gheorghe	エレナ・ゲオルゲ
Hadise	ハディセ
Lavinia Fontana	ラヴィニア・フォンターナ
Amanda Michalka	アマンダ・ミシェルカ
Alyson Michalka	アリソン・ミシェルカ
Aysel Teymurzadeh	アイセル・テイムルザデ
Olta Boka	オルタ・ボカ
Magdalena Tul	マグダレナ・トゥル
Premier League Armen	アルメニア・プレミアリーグ
Andrea Demirović	アンドレア・デミロヴィッチ
Al-naxid al-xarif	モロッコの国歌
Ġeorġja fil-Festival tal-Eurovision	グルジアのユーロビジョン・ソング・コンテスト
FK Sarajevo	FKサラエヴォ
Konvenzjoni ta' Vjenna dwar id-Dritt tat-Trattati	条約法に関するウィーン条約
Muniti tal-ewro ta' Malta	マルタのユーロ硬貨
Kampjonati Ewropej tal-Futbol 2008	UEFA EURO 2008
Myrmecobiidae	フクロアリクイ
Papessa Ġovanna	女教皇ヨハンナ
Ġwann Marija Vianney	ジャン＝マリー・ヴィアンネ
Ottorino Respighi	オットリーノ・レスピーギ
FC Pyunik	FCピュニク・エレバン
Mikrostat	ミニ国家
Vinċenz de Paul	ヴァンサン・ド・ポール
Premier League Bjelorussu	ベラルーシ・プレミアリーグ
Linfield FC	リンフィールドFC
Peramelemorphia	バンディクート目
Anders Lindegaard	アンデルス・リンデゴーア
Florentino Pérez	フロレンティーノ・ペレス
Ċipru fil-Festival tal-Eurovision	キプロスのユーロビジョン・ソング・コンテスト
Marca	マーク (曖昧さ回避)
Diżugwaljanza ta' Čebyšëv	チェビシェフの不等式
Halloween	ハロウィン
FIFA	国際サッカー連盟
Dipendenza (Informatika)	結合度
Primera Divisió	アンドラン・プリメーラ・ディビシオ
Lista ta' pajjiżi skont l-erja	国の面積順リスト
Sumgayit PFC	スムガイトFK
Kampjonati Ewropej tal-Futbol	UEFA欧州選手権
FC Wacker Innsbruck (2002)	FCヴァッカー・インスブルック
Constant Vanden Stock Stadium	コンスタン・ヴァンデン・ストックスタディオン
NK Široki Brijeg	NKシロキ・ブリイェグ
SV Mattersburg	SVマッテルスブルク
Jean Parisot de la Valette	ジャン・ド・ヴァレット
Fażi eliminatorja tal-UEFA Champions League 2012–13	UEFAチャンピオンズリーグ 2012-13 決勝トーナメント
Wayne Rooney	ウェイン・ルーニー
Tim nazzjonali tal-futbol tal-Awstralja	サッカーオーストラリア代表
Finali tat-Tazza tad-Dinja tal-Futbol 2006	2006 FIFAワールドカップ・決勝
Nouvelle Fédération-Board	NF-Board
Alfonsu Marija de Liguori	アルフォンソ・デ・リゴリ
Bulgarija fil-Festival tal-Eurovision	ブルガリアのユーロビジョン・ソング・コンテスト
Ukraina fil-Festival tal-Eurovision	ウクライナのユーロビジョン・ソング・コンテスト
Bożnija u Ħerżegovina fil-Festival tal-Eurovision	ボスニア・ヘルツェゴビナのユーロビジョン・ソング・コンテスト
Fenetika	表形分類学
Attakkant	フォワード (サッカー)
Nihat Kahveci	ニハト・カフヴェジ
Christina Metaxa	フリスティーナ・メタクサー
CE Principat	CEプリンシパト
Piero Soderini	ピエロ・ソデリーニ
Istitut tal-Unjoni Ewropea għall-Istudji dwar is-Sigurtà	欧州安全保障研究所
Oscar Romero	オスカル・ロメロ
Marte	マルテ
Nickelodeon (Amerika)	ニコロデオン
Lisandro López	リサンドロ・ロペス
Chris Eagles	クリス・イーグルス
ASEAN Football Federation	ASEANサッカー連盟
Robertu Bellarmino	ロベルト・ベラルミーノ
Fenek tax-xmara	ブッシュマンウサギ
Fenek ta' Assam	アラゲウサギ
Salve Reġina	サルヴェ・レジーナ
John O'Shea	ジョン・オシェイ
Guillermo Stábile	ギジェルモ・スタービレ
Massimo Busacca	マッシモ・ブサッカ
Ritchie De Laet	リッチー・デ・ラエト
Manucho Gonçalves	マテウス・アルベルト・コントレイラス・ゴンサルヴェス
Diego Cavalieri	ジエゴ・カバリエリ
Bernd Leno	ベルント・レノ
Urby Emanuelson	ウルビー・エマヌエルソン
Paolo Borsellino	パオロ・ボルセリーノ
Jô	ジョアン・アウヴェス・デ・アシス・シウヴァ
Adem Ljajić	アデム・リャイッチ
Lucien Laurent	リュシアン・ローラン
Sebastian Prödl	セバスティアン・プリョードル
Julien Faubert	ジュリアン・フォベール
Danny Simpson	ダニー・シンプソン
Ruġġieru I ta' Sqallija	ルッジェーロ1世
Michael Mancienne	マイケル・マンシェン
Dong Fangzhuo	董方卓
San Ġennaru	ヤヌアリウス
Carlos Eugênio Simon	カルロス・エウジェニオ・シモン
Pascal Zuberbühler	パスカル・ツベルビューラー
Stanislav Šesták	スタニスラフ・シェスターク
Franco Di Santo	フランコ・ディ・サント
Luis Monti	ルイス・モンティ
Patrick Müller	パトリック・ミュラー
Digão	ロドリゴ・イゼクソン・ドス・サントス・レイチ
Leonardo Sciascia	レオナルド・シャーシャ
Edward Maya	エドワード・マヤ
Gonzalo Javier Rodríguez	ゴンサロ・ロドリゲス
Tazza tad-Dinja VIVA	VIVAワールドカップ
Premier League Malti	マルタ・プレミアリーグ
Serebro	セレブロ
Nicolas Douchez	ニコラ・ドゥシェ
Kroazja fil-Festival tal-Eurovision	クロアチアのユーロビジョン・ソング・コンテスト
La Liga	リーガ・エスパニョーラ
Joel Obi	ジョエル・オビ
Premier League Ażerbajġan	アゼルバイジャン・プレミアリーグ
Alleati tat-Tieni Gwerra Dinjija	連合国 (第二次世界大戦)
Repubblika Ċeka fil-Festival tal-Eurovision	チェコのユーロビジョン・ソング・コンテスト
Valletta FC	バレッタFC
Serbja u Montenegro fil-Festival tal-Eurovision	セルビア・モンテネグロのユーロビジョン・ソング・コンテスト
Jerzy Grotowski	イェジー・グロトフスキ
FC Ararat Yerevan	FCアララト・エレバン
Gustavo Gutiérrez	グスタボ・グティエレス
Joe Sacco	ジョー・サッコ
Difensur	ディフェンダー (サッカー)
Eurovision (diżambigwazzjoni)	ユーロビジョン (曖昧さ回避)
Jores Okore	ヨレス・オコレ
Gary Neville	ガリー・ネヴィル
Roland Linz	ローランド・リンツ
Johnny Leoni	ジョニー・レオーニ
San Staniżlaw Martri	シュツェパノフのスタニスラウス
Emiliano Insúa	エミリアーノ・インスア
Ritratt ta' Adele Bloch-Bauer I	アデーレ・ブロッホ＝バウアーの肖像 I
Paul Van Himst	ポール・ヴァン・ヒムスト
György Garics	ギョルギ・ガリッチ
Cercle Brugge KSV	サークル・ブルッヘ
Unuri tat-Tazza tad-Dinja tal-Futbol	FIFAワールドカップにおける賞
Memorial Day	戦没将兵追悼記念日
Unuri għall-klabbs tal-UEFA	UEFAクラブ・フットボール・アワード
Bloggosfera	ブロゴスフィア
Life of Pi	パイの物語
SV Zulte Waregem	ズルテ・ワレヘム
Semih Şentürk	セミフ・シェンテュルク
Helder Camara	エルデル・カマラ
Dasyurus	フクロネコ
Mattia De Sciglio	マッティア・デ・シリオ
Krassimir Avramov	クラシミル・アヴラモフ
Deividas Šemberas	デイヴィダス・シェンベラス
Pawlu Miki	パウロ三木
UEFA Europa League 2012–13	UEFAヨーロッパリーグ 2012-13
Ivan Leko	イヴァン・レコ
Marsaxlokk FC	マルサシュロックFC
Servizz Awstrijak barra l-pajjiż	オーストリア海外奉仕
Jamāhīriyya	ジャマーヒリーヤ
Mario Corso	マリオ・コルソ
Deloitte Football Money League	デロイト・フットボール・マネー・リーグ
Congratulations (Eurovision)	Congratulations
Serbja fil-Festival tal-Eurovision	セルビアのユーロビジョン・ソング・コンテスト
OFC	OFC
Innu tal-Emirati Għarab Magħquda	アラブ首長国連邦の国歌
Plesiadapiformes	プレシアダピス目
Ungerija fil-Festival tal-Eurovision	ハンガリーのユーロビジョン・ソング・コンテスト
Facundo Roncaglia	ファクンド・ロンカリア
Hilma af Klint	ヒルマ・アフ・クリント
Owen Hargreaves	オーウェン・ハーグリーヴス
Papa Franġisku	フランシスコ (ローマ教皇)
Roman Kienast	ローマン・キーナスト
Lamantin Amazoniku	アマゾンマナティー
Preguinho	ジョアン・コエーリョ・ネト
SV Ried	SVリート
Fabio Coltorti	ファビオ・コルトルティ
Guillermo Subiabre	ギジェルモ・スビアブレ
Il-Ktieb ta' Mormon	モルモン書
Eva Gonzalès	エヴァ・ゴンザレス
Slovakkja fil-Festival tal-Eurovision	スロバキアのユーロビジョン・ソング・コンテスト
Carlos Peucelle	カルロス・ペウセジェ
Yulia Savicheva	ユーリヤ・サーヴィチェヴァ
Víctor Fernández	ビクトル・フェルナンデス
It-Twerżiqa	叫び (エドヴァルド・ムンク)
Euarchontoglires	真主齧上目
Paramore	パラモア
Ħal Luqa	ルア
Unguligrad	蹄行
Festival tal-Eurovision taż-Żgħar 2008	ジュニア・ユーロビジョン・ソング・コンテスト2008
Coritiba Foot Ball Club	コリチーバFC
Ajruport Internazzjonali ta' Tan Son Nhat	タンソンニャット国際空港
L-Uffiċċju tal-Pubblikazzjonijiet tal-Unjoni Ewropea	欧州委員会出版局
Nani	ルイス・カルロス・アルメイダ・ダ・クーニャ
Edwin van der Sar	エトヴィン・ファン・デル・サール
Paolo Maldini	パオロ・マルディーニ
Loreen	ロリーン
Gonzalo Higuaín	ゴンサロ・イグアイン
Tim nazzjonali tal-futbol tat-Turkija	サッカートルコ代表
Tim nazzjonali tal-futbol tar-Repubblika Ċeka	サッカーチェコ代表
Tomasz Kuszczak	トマシュ・クシュチャク
Anderson Luís de Abreu Oliveira	アンデルソン・ルイス・デ・アブレウ・オリベイラ
UEFA Champions League 2011–12	UEFAチャンピオンズリーグ 2011-12
Charles Manson	チャールズ・マンソン
UEFA Champions League 2012–13	UEFAチャンピオンズリーグ 2012-13
Arda Turan	アルダ・トゥラン
Oġġett (filosofija)	対象
RAEC Mons	RAECモンス
Renault Samsung Motors	ルノーサムスン自動車
Galatasaray SK	ガラタサライSK (サッカー)
Linosa	リノーザ島
Tazza tad-Dinja tal-Futbol tal-Klabbs 2005	FIFAクラブ世界選手権2005
Tazza tad-Dinja tal-Futbol tal-Klabbs 2000	FIFAクラブ世界選手権2000
Moldova fil-Festival tal-Eurovision	モルドバのユーロビジョン・ソング・コンテスト
Latvja fil-Festival tal-Eurovision	ラトビアのユーロビジョン・ソング・コンテスト
Waasland-Beveren	ワースラント＝ベフェレン
Kwalifikazzjoni għat-Tazza tad-Dinja tal-Futbol 2010 (CONMEBOL)	2010 FIFAワールドカップ・南米予選
Matías Suárez	マティアス・スアレス
Mircea Rednic	ミルチェア・レドニク
Radja Nainggolan	ラジャ・ナインゴラン
Felipe Santana	フェリペ・サンタナ
André Schembri	アンドレ・シェンブリ
Stade Charles Tondreau	スタッド・シャルル・トンドロー
Ronaldo	ロナウド
Kwalifikazzjoni għall-Kampjonati Ewropej tal-Futbol 2012 - Grupp Ċ	UEFA EURO 2012予選・グループC
Kaká	カカ (サッカー選手)
FC Shakhtyor Salihorsk	FCシャフティオール・ソリゴルスク
Rivalità bejn Liverpool FC u Manchester United FC	ノースウェスト・ダービー
FK Leotar	FKレオタル・トレビニェ
FC Neman Grodno	FCネマン・フロドナ
Rumanija fil-Festival tal-Eurovision	ルーマニアのユーロビジョン・ソング・コンテスト
Trofew Bravo	ブラヴォー賞
Jelle Vossen	イェレ・ヴォセン
Finali tal-UEFA Champions League 2013	UEFAチャンピオンズリーグ 2012-13 決勝
Lista tal-kodiċi nazzjonali tal-FIFA	FIFAコードの一覧
Tupaja ta' Madras	マドラスツパイ
Senġi ħamrani	アカハネジネズミ
FC Mika	FCミカ
Pika tal-isteppa	ステップナキウサギ
Super Cup Maltija	マルタ・スーパーカップ
FC Minsk	FCミンスク
Francesco Azzopardi	フランチェスコ・アゾパルディ
Super Cup Ewropea 2013	2013 UEFAスーパーカップ
Librerija ta' Klassijiet Bażi	基本クラスライブラリ
FC Encamp	FCエンカンプ
Kon-Katidral ta' San Ġwann	聖ヨハネ准司教座聖堂
FIFA Puskás Award	FIFAプスカシュ賞
KV Kortrijk	KVコルトレイク
Wikipedija:Abbrevjazzjoni	Wikipedia:ショートカット
UE Sant Julià	UEサン・ジュリア
The Kite Runner	君のためなら千回でも
Qerda tal-innoċenti	幼児虐殺
Beerschot AC	KベールショットAC
UE Santa Coloma	UEサンタ・コロマ
Malta fil-Festival tal-Eurovision	マルタのユーロビジョン・ソング・コンテスト
Gianpaolo Bellini	ジャンパオロ・ベッリーニ
Mario Been	マリオ・ベーン
Glires	グリレス大目
Cinco de Mayo	シンコ・デ・マヨ
Litwanja fil-Festival tal-Eurovision	リトアニアのユーロビジョン・ソング・コンテスト
Shirak FC	FCシラク
Fenek tal-vulkan	メキシコウサギ
Ouija Board	ウィジャボード
Iqbal Masih	イクバル・マシー
San Franġisk t'Assisi	アッシジのフランチェスコ
Tim nazzjonali tal-futbol tal-Italja	サッカーイタリア代表
Trzebinia	トシェビニャ
Fenek ta' Amami	アマミノクロウサギ
Kolokolo	チロエオポッサム
FK Khazar Lankaran	FKハザル・レンコラン
SV Grödig	SVグレーディヒ
FC Admira Wacker Mödling	FCアドミラ・ヴァッカー・メードリング
Bolla fiskali	収入印紙
SP Tre Penne	SPトレ・ペンネ
FC Lusitanos	FCルシタノス
Logan Bailly	ローガン・バイリー
Cartoon Network	カートゥーン ネットワーク
De facto	デ・ファクト
Lista ta' pajjiżi skont il-popolazzjoni	国の人口順リスト
Klad	系統群
Kaptan (futbol)	キャプテン (サッカー)
Kunsilli lokali ta' Malta	マルタの地方行政区画
AS (gazzetta)	AS (新聞)
Kwalifikazzjoni għall-Kampjonati Ewropej tal-Futbol 2012 - Grupp B	UEFA EURO 2012予選・グループB
Tim nazzjonali tal-futbol tal-Komunità tal-Istati Indipendenti	サッカーCIS代表
Kwalifikazzjoni għall-Kampjonati Ewropej tal-Futbol 2012 - Grupp A	UEFA EURO 2012予選・グループA
Inter Baku PFC	インテル・バクーPFC
FK Qarabağ	カラバフFK
Lierse SK	リールセSK
Tim nazzjonali tal-futbol tar-Russja	サッカーロシア代表
Euarchonta	真主獣大目
Kwalifikazzjoni għall-Kampjonati Ewropej tal-Futbol 2012 - Grupp Ħ	UEFA EURO 2012予選・グループH
Ester	エステル (聖書)
Lorenzo Staelens	ロレンツォ・スターレンス
Cobh	コーヴ
John van den Brom	ジョン・ファン・デン・ブロム
Fażi tal-gruppi tal-UEFA Champions League 2012–13	UEFAチャンピオンズリーグ 2012-13 グループリーグ
Nicolò Isouard	ニコラ・イズアール
Kronoloġija tal-matematika	数学の年表
Ġużeppi Moscati	ジュゼッペ・モスカーティ
Kwalifikazzjoni għall-Kampjonati Ewropej tal-Futbol 2012 - Grupp Ġ	UEFA EURO 2012予選・グループG
JK Nõmme Kalju	JKノーメ・カリュ
Kwalifikazzjoni għall-Kampjonati Ewropej tal-Futbol 2012 - Grupp I	UEFA EURO 2012予選・グループI
Kwalifikazzjoni għall-Kampjonati Ewropej tal-Futbol 2012 - Grupp F	UEFA EURO 2012予選・グループF
Kwalifikazzjoni għall-Kampjonati Ewropej tal-Futbol 2012 - Grupp E	UEFA EURO 2012予選・グループE
Kwalifikazzjoni għall-Kampjonati Ewropej tal-Futbol 2012 - Grupp D	UEFA EURO 2012予選・グループD
Finali tal-Kampjonati Ewropej tal-Futbol 2008	UEFA EURO 2008決勝
Filosofija Ellenistika	ヘレニズム哲学
FC Banants	FCバナンツ
Varjetà (botanika)	変種
FK Olimpic	FKオリンピク・サラエヴォ
FC Brest	FCディナモ・ブレスト
President ta' Malta	マルタの大統領
Birkirkara FC	ビルキルカラFC
Lingwa Awżiljari Internazzjonali	国際補助語
Lista ta' lingwi uffiċjali	公用語の一覧
Regina (grupp)	レギナ (バンド)
It-Tripletta	トレブル (サッカー)
Partizani Tirana	FKパルティザニ・ティラナ
East Asian Football Federation	東アジアサッカー連盟
Borussia Dortmund II	ボルシア・ドルトムント II
Analisi armonika	調和解析
UEFA Jubilee Awards	UEFAジュビリーアウォーズ
Transnistrija	沿ドニエストル共和国
Gabala FC	ガバラFK
Għajnuna:Kontenut	Help:目次
Għajnuna:Gwida essenzjali	Wikipedia:ガイドブック
Logħob tal-Pajjiżi ż-Żgħar tal-Ewropa	欧州小国競技大会
Marca (gazzetta)	マルカ (新聞)
Cristal Arena	クリスタル・アレナ
Francis Dickoh	フランシス・ディッコー
Tupaja ż-żgħir	ピグミーツパイ
Hibernians FC	ヒバーニアンズFC
Gipsy.cz	ジプシー.cz
Hany Ramzy	ハニ・ラムズィ
Stade Maurice Dufrasne	スタッド・モーリス・デュフラン
Michael Essien	マイケル・エッシェン
FC Bayern Munich II	FCバイエルン・ミュンヘンII
FC Red Bull Salzburg	レッドブル・ザルツブルク
Markapaġna	栞
Statistika tat-Tazza tad-Dinja tal-Futbol 2010	2010 FIFAワールドカップの統計
Stejdjum Jan Breydel	ヤン・ブレイデルスタディオン
Cynocephalus volans	フィリピンヒヨケザル
Laurent Ciman	ローラン・シマン
Liverpool FC	リヴァプールFC
Flor-de-Lis	フロール＝デ＝リス
FIFPro	国際プロサッカー選手会
Pika tat-Tramuntana	キタナキウサギ
Plantigrad	蹠行
Stade du Pays de Charleroi	スタッド・デュ・ペイ・ド・シャルルロワ
West Asian Football Federation	西アジアサッカー連盟
Bolla telegrafika	電信切手
Merlin (serje televiżiva)	魔術師 MERLIN
Tim nazzjonali tal-futbol ta' Malta (nisa)	サッカーマルタ女子代表
Wikipedija:Ambaxxata	Wikipedia:大使館
Sliema Wanderers FC	スリマ・ワンダラーズFC
Aramajk ta' Ġesù	イエスが使った言語
Senġi ta' taħt dahru dehebi	コシキハネジネズミ
Tazza Maltija	マルタFAトロフィー
Cohesion	凝集度
Liebru Ġappuniż	ニホンノウサギ
Trofew Zarra	サラ賞
Candies (grupp)	キャンディーズ
FK Rudar Prijedor	FKルダル・プリイェドル
Wikipedija:Glossarju	Wikipedia:ウィキペディア用語集
Kategorija:Ġermanja	Category:ドイツ
Kategorija:Italja	Category:イタリア
Kategorija:Stati Uniti	Category:アメリカ合衆国
Kategorija:Russja	Category:ロシア
Kategorija:Renju Unit	Category:イギリス
Kategorija:Spanja	Category:スペイン
Kategorija:Indja	Category:インド
Kategorija:Turkija	Category:トルコ
Kategorija:New Zealand	Category:ニュージーランド
Pixxivoru	魚食動物
Kategorija:Afganistan	Category:アフガニスタン
Kategorija:Alġerija	Category:アルジェリア
Kategorija:Awstrija	Category:オーストリア
Kategorija:Pajjiżi l-Baxxi	Category:オランダ
Kategorija:Niġerja	Category:ナイジェリア
Kategorija:Polonja	Category:ポーランド
Kategorija:Portugall	Category:ポルトガル
Kategorija:Żvizzera	Category:スイス
Kategorija:Ukraina	Category:ウクライナ
Kategorija:Vjetnam	Category:ベトナム
Kategorija:Fiżika	Category:物理学
Kategorija:Bijoloġija	Category:生物学
Kategorija:Kimika	Category:化学
Kategorija:Storja	Category:歴史
Kategorija:Ġeografija	Category:地理
Kategorija:Reliġjon	Category:宗教
Kategorija:Sport	Category:スポーツ
Kategorija:Xjenza	Category:科学
Kategorija:Unjoni Ewropea	Category:欧州連合
Kategorija:Ċinema	Category:映画
Kategorija:Komunikazzjoni	Category:通信
Premier League 2011–12	プレミアリーグ2011-2012
Lista ta' ħwawar u ħxejjex aromatiċi	ハーブの一覧
Joseph Calleia	ジョセフ・カレイア
Stat kostrutt	エザーフェ
Kategorija:Mietu fl-2012	Category:2012年没
Partit Nazzjonalista	国民党
Jules Ottenstadion	ユレス・オッテンスタディオン
Mudell:Portal tmiem	Template:Box-footer
Ħin tal-Afrika tal-Lvant	東アフリカ時間
Wikijunior	ウィキジュニア
Kamra tad-Deputati ta' Malta	代議院 (マルタ)
Quartissimo	カルティッシモ
Aleksandar Tonev	アレクサンダル・トネフ
Juan Antonio Villacañas	フアン・アントニオ・ビジャカーニャス
Kategorija:Ekoloġija	Category:生態学
Kategorija:Diżambigwazzjoni	Category:曖昧さ回避
Kategorija:Olimpjadi	Category:オリンピック
Kategorija:Filosofija	Category:哲学
Kategorija:Psikoloġija	Category:心理学
Kategorija:Buddiżmu	Category:仏教
Kategorija:Kristjaneżmu	Category:キリスト教
Kategorija:Induiżmu	Category:ヒンドゥー教
Kategorija:Iżlam	Category:イスラム教
Kategorija:Ġudaiżmu	Category:ユダヤ教
Oġġett	オブジェクト
Freethiel Stadion	フレシエル・スタディオン
Ronaldo (diżambigwazzjoni)	ロナウド (曖昧さ回避)
Michy Batshuayi	ミヒー・バチュアイ
Prorastomus	プロラストムス
Bochotnica	ボホトニツァ
Juan Carlos Garrido	フアン・カルロス・ガリード
Stat Iżlamiku	ISIL
Guillermo Burdisso	ギジェルモ・ブルディッソ
Benedicta Boccoli	ベネディクタ・ボッコーリ
Għoti tal-penalties	PK戦
Kategorija:Abbozzi	Category:スタブ
Kategorija:Pjaneti	Category:惑星
Kategorija:Abbozzi tal-mużika	Category:音楽関連のスタブ
Kategorija:Abbozzi tal-kultura	Category:文化スタブ
Kategorija:Kultura	Category:文化
Kategorija:Snin	Category:年
Kategorija:Xjenzi soċjali	Category:人間科学
Kategorija:Kontinenti	Category:大陸
12 Years a Slave	それでも夜は明ける
Mario Azzopardi	マリオ・アゾパルディ
Mudell:SistemaSolari	Template:太陽系
Wikipedija:Konvenzjonijiet ta' nomenklatura	Wikipedia:記事名の付け方
Sottoġeneru	亜属
GNU/Linux	GNU/Linuxシステム
Għajnuna:Kif tirreġistra	Help:ログイン
Għajnuna:Wikiketta	Wikipedia:エチケット
Kategorija:Bots tal-Wikipedija	Category:Wikipedia bots
Rowen Muscat	ローウェン・マスカット
Palinivoru	花粉食動物
Parteċipazzjoni fil-Festival tal-Eurovision	ユーロビジョン・ソング・コンテストの参加国一覧
Miosiren	ミオシーレン
Noemi	ノエミ
Mudell:Kwota	Template:Quote
Kategorija:Nies Taljani	Category:イタリアの人物
Kategorija:Mużiċisti Amerikani	Category:アメリカ合衆国のミュージシャン
Kategorija:Futbolers Ġermaniżi	Category:ドイツのサッカー選手
Mudell:Tl	Template:Tl
Mudell:Kaxxa tal-utent	Template:Userbox
Sergio Mattarella	セルジョ・マッタレッラ
Kategorija:Pajjiżi	Category:国
Wikipedija:Amministraturi	Wikipedia:管理者
Kategorija:Każakistan	Category:カザフスタン
Wikipedija:Amministraturi/Kandidati	Wikipedia:管理者への立候補
Wikipedija:Bot	Wikipedia:Bot
Kategorija:Kategoriji moħbija	Category:隠しカテゴリ
Kategorija:Internet	Category:インターネット
Kategorija:Botanika	Category:植物学
Kategorija:Politika	Category:政治
Kategorija:Arti	Category:芸術
Eġittu	エジプト
Kategorija:2013	Category:2013年
Bryan Cristante	ブライアン・クリスタンテ
Mudell:Bot	Template:Bot
Kanada	カナダ
Kategorija:Ungerija	Category:ハンガリー
Kategorija:Stati membri tal-Unjoni Ewropea	Category:欧州連合加盟国
Kategorija:Belġju	Category:ベルギー
Kategorija:Ċekja	Category:チェコ
Kategorija:Danimarka	Category:デンマーク
Kategorija:Estonja	Category:エストニア
Kategorija:Finlandja	Category:フィンランド
Kategorija:Latvja	Category:ラトビア
Kategorija:Iżlanda	Category:アイスランド
Kategorija:Litwanja	Category:リトアニア
Kategorija:Malta	Category:マルタ
Kategorija:Żvezja	Category:スウェーデン
Kategorija:Slovakkja	Category:スロバキア
Kategorija:Slovenja	Category:スロベニア
Kategorija:Repubblika tal-Irlanda	Category:アイルランド
Kategorija:Artikli fil-vetrina	Category:秀逸な記事
Wikipedija:Rispons tal-esperjenza tal-utent	Wikipedia:使用性改善/フィードバック
Kategorija:Logħob elettroniku	Category:コンピュータゲーム
Wikipedija:Bot/Rikjesti	Wikipedia:Bot作業依頼
Mudell:Flagicon	Template:Flagicon
Kategorija:Pajjiżi tal-Ewropa	Category:ヨーロッパの国
Kategorija:Ewropa	Category:ヨーロッパ
Kategorija:Għajnuna	Category:ヘルプ
Mudell:Dokumentazzjoni	Template:Documentation
Wikipedija:Bot/Rikjesti għall-approvazzjoni	Wikipedia:Bot/使用申請
Kategorija:Paġni protetti	Category:編集保護中の記事
Wikipedija:Politika dwar il-protezzjoni	Wikipedia:保護の方針
Kategorija:Paġni semi-protetti	Category:編集半保護中の記事
Kategorija:Wikipedjani	Category:ウィキペディアン
Wikipedija:Kunsens	Wikipedia:合意形成
Wikipedija:L-ebda attakk personali	Wikipedia:個人攻撃はしない
Wikipedija:Kuntatt	Wikipedia:連絡先
Kategorija:Utenti skont il-lingwa	Category:言語別の利用者
Kategorija:Politiki tal-Wikipedija	Category:ウィキペディアの方針
Wikipedija:Sondaġġi	Wikipedia:調査投票の方法
Wikipedija:Firem	Wikipedia:署名
Wikipedija:Abbozz	Wikipedia:スタブ
Wikipedija:Artikli rikjesti	Wikipedia:執筆依頼
Mudell:Softredirect	Template:Softredirect
Mudell:Ħassar minnufih	Template:即時削除
Kategorija:Teknoloġija	Category:技術
Kategorija:Lingwa	Category:諸言語
Għajnuna:Kif tibda artiklu	Help:新規ページの作成
Kategorija:Wikipedija	Category:ウィキペディア
Kanċillier tal-Ġermanja	連邦首相 (ドイツ)
Wikipedija:Ċaħda ġenerali	Wikipedia:免責事項
Kategorija:Paġni mhux indiċizzati	Category:検索エンジンに収集されないページ
Wikipedija:Mudelli kollha	Wikipedia:Template メッセージの一覧
Kategorija:Avvenimenti kurrenti	Category:最新の出来事
Wikipedija:Manwal tal-istil	Wikipedia:スタイルマニュアル
Mudell:-	Template:-
Mudell:Navbox	Template:Navbox
Mudell:Abbrevjazzjoni	Template:ショートカット
Kategorija:Żoni tal-ħin	Category:標準時
Galeopterus variegatus	マレーヒヨケザル
Kategorija:Nies ħajjin	Category:存命人物
Festival tal-Eurovision 2014	ユーロビジョン・ソング・コンテスト2014
Mudell:!	Template:!
Kategorija:Mudelli ta' bnadar	Category:旗のテンプレート
Mudell:!-	Template:!-
Mudell:!!	Template:!!
Mudell:=	Template:=
Mudell:Tnavbar	Template:Tnavbar
Mudell:Ċiklu	Template:Loop
Mudell:0	Template:0
Kategorija:Mudelli ta' formattjar	Category:レイアウト用テンプレート
Mudell:Clear	Template:Clear
Mudell:Col-break	Template:Col-break
Mudell:Col-begin	Template:Col-begin
Mudell:Col-end	Template:Col-end
Mudell:Kulur	Template:Color
Mudell:Deskrizzjoni kmand	Template:Abbr
Wikipedija:Lista ta' artikli li kull Wikipedija għandu jkollha	Wikipedia:すべての言語版にあるべき項目の一覧
Kategorija:Afrika	Category:アフリカ
Kategorija:Xhur tas-sena	Category:月 (暦)
Mudell:Wikisors	Template:Wikisource
Mudell:Babel	Template:Babel
Mudell:Commons	Template:Commons
Mudell:Link GA	Template:Link GA
Mudell:Referenzi	Template:Reflist
Kategorija:Avvenimenti sportivi kurrenti	Category:最新のスポーツイベント
Jum il-Ħelsien	自由の日
Għajnuna:Esplora lill-Wikipedija	Help:検索
Mudell:Pajjiżi tal-Commonwealth	Template:イギリス連邦
Mudell:Stub	Template:Stub
Mudell:Utent ar-1	Template:User ar-1
Mudell:Utent az	Template:User az
Mudell:Utent be-2	Template:User be-2
Mudell:Utent da-1	Template:User da-1
Mudell:Utent bg-1	Template:User bg-1
Mudell:Utent eo-3	Template:User eo-3
Mudell:Utent de	Template:User de
Mudell:Utent de-1	Template:User de-1
Mudell:Utent el	Template:User el
Mudell:Utent es	Template:User es
Mudell:Utent de-3	Template:User de-3
Mudell:Utent en-3	Template:User en-3
Mudell:Utent en-1	Template:User en-1
Mudell:Utent en-2	Template:User en-2
Mudell:Utent en-4	Template:User en-4
Mudell:Utent en-0	Template:User en-0
Mudell:Utent en	Template:User en
Mudell:Utent de-2	Template:User de-2
Mudell:Utent es-1	Template:User es-1
Mudell:Utent fa	Template:User fa
Mudell:Utent fr-1	Template:User fr-1
Mudell:Utent ia-2	Template:User ia-2
Mudell:Utent hr	Template:User hr
Mudell:Utent it-3	Template:User it-3
Mudell:Utent ja-4	Template:User ja-4
Mudell:Utent sk	Template:User sk
Mudell:Utent tr-2	Template:User tr-2
Mudell:Utent fr-2	Template:User fr-2
Mudell:Utent ja	Template:User ja
Mudell:Utent it-1	Template:User it-1
Mudell:Utent fr	Template:User fr
Mudell:Ebda firma	Template:Unsigned
Mudell:Pl	Template:Pl icon
Kategorija:Turiżmu	Category:観光
Kategorija:1957	Category:1957年
Kategorija:1949	Category:1949年
Kategorija:1927	Category:1927年
Kategorija:1919	Category:1919年
Mudell:Dati pajjiż Taġikistan	Template:Country data Tajikistan
Kategorija:Moldova	Category:モルドバ
Kategorija:Ażerbajġan	Category:アゼルバイジャン
Kategorija:Asja	Category:アジア
Kategorija:Ċili	Category:チリ
Kategorija:Seklu 21	Category:21世紀
Kategorija:Mudelli ta' servizz	Category:ウィキペディアのメンテナンス用テンプレート
Kategorija:Utenti uk	Category:User uk
Kategorija:1930	Category:1930年
Kategorija:Utenti uk-N	Category:User uk-N
Kategorija:1936	Category:1936年
Kategorija:1947	Category:1947年
Mudell:Mudell ikkumplikat	Template:複雑なテンプレート
Kategorija:1937	Category:1937年
Kategorija:1940	Category:1940年
Kategorija:1934	Category:1934年
Kategorija:1960	Category:1960年
Kategorija:1943	Category:1943年
Kategorija:1951	Category:1951年
Kategorija:1942	Category:1942年
Kategorija:1959	Category:1959年
Kategorija:1938	Category:1938年
Kategorija:1928	Category:1928年
Kategorija:1913	Category:1913年
Kategorija:1918	Category:1918年
Kategorija:1954	Category:1954年
Kategorija:1941	Category:1941年
Kategorija:1955	Category:1955年
Kategorija:1950	Category:1950年
Kategorija:1921	Category:1921年
Kategorija:1977	Category:1977年
Kategorija:1946	Category:1946年
Kategorija:1948	Category:1948年
Kategorija:1932	Category:1932年
Mudell:Plejers fit-tim tal-futbol	Template:サッカークラブチーム選手一覧 開始
Kategorija:Futbol	Category:サッカー
Kategorija:1945	Category:1945年
Mudell:Dati pajjiż Kuwajt	Template:Country data Kuwait
Mudell:Mod	Template:Mod
Kategorija:1923	Category:1923年
Kategorija:1935	Category:1935年
Kategorija:1910	Category:1910年
Kategorija:1917	Category:1917年
Kategorija:1904	Category:1904年
Kategorija:1926	Category:1926年
Kategorija:1907	Category:1907年
Kategorija:1914	Category:1914年
Mudell:Utent sv	Template:User sv
Kategorija:1929	Category:1929年
Kategorija:1920	Category:1920年
Mudell:Utent it	Template:User it
Kategorija:1925	Category:1925年
Mudell:Utent uk	Template:User uk
Kategorija:1905	Category:1905年
Kategorija:1915	Category:1915年
Mudell:Utent es-2	Template:User es-2
Kategorija:1908	Category:1908年
Kategorija:Mudelli ta' avviż	Category:ユーザーへの警告テンプレート
Kategorija:1901	Category:1901年
Kategorija:1903	Category:1903年
Kategorija:1902	Category:1902年
Kategorija:1900	Category:1900年
Mudell:Ru	Template:Ru icon
Mudell:PaġnaPrinċipali/Proġetti	Template:WikipediaSister
Kategorija:1933	Category:1933年
Mudell:Dati pajjiż Belġju	Template:Country data Belgium
Kategorija:1912	Category:1912年
Kategorija:Klabbs tal-futbol Ingliżi	Category:イングランドのサッカークラブ
Mudell:Dati pajjiż Slovakkja	Template:Country data Slovakia
Kategorija:Mudelli tal-koordinati	Category:座標関連のテンプレート
Kategorija:Klabbs tal-futbol Spanjoli	Category:スペインのサッカークラブ
Mudell:Dati pajjiż El Salvador	Template:Country data El Salvador
Mudell:Dati pajjiż Panama	Template:Country data Panama
Kategorija:1952	Category:1952年
Mudell:Premier League	Template:プレミアリーグ
Mudell:Dati pajjiż Ekwador	Template:Country data Ecuador
Mudell:Dati pajjiż Etjopja	Template:Country data Ethiopia
Mudell:Dati pajjiż Tuneżija	Template:Country data Tunisia
Mudell:Dati pajjiż Repubblika Ċeka	Template:Country data Czech Republic
Mudell:Dati pajjiż Tajlandja	Template:Country data Thailand
Mudell:Dati pajjiż Kuba	Template:Country data Cuba
Mudell:Dati pajjiż Indoneżja	Template:Country data Indonesia
Mudell:Dati pajjiż Kambodja	Template:Country data Cambodia
Mudell:Dati pajjiż Senegal	Template:Country data Senegal
Mudell:Dati pajjiż Madagaskar	Template:Country data Madagascar
Mudell:Dati pajjiż Albanija	Template:Country data Albania
Mudell:Dati pajjiż Perù	Template:Country data Peru
Mudell:Dati pajjiż Paragwaj	Template:Country data Paraguay
Mudell:Dati pajjiż Makaw	Template:Country data Macau
Mudell:Dati pajjiż Kenja	Template:Country data Kenya
Mudell:Dati pajjiż San Marino	Template:Country data San Marino
Mudell:Dati pajjiż Nikaragwa	Template:Country data Nicaragua
Mudell:Dati pajjiż Ħonduras	Template:Country data Honduras
Mudell:Dati pajjiż Użbekistan	Template:Country data Uzbekistan
Mudell:Dati pajjiż Bolivja	Template:Country data Bolivia
Mudell:Dati pajjiż Repubblika Dominikana	Template:Country data Dominican Republic
Mudell:Dati pajjiż Liechtenstein	Template:Country data Liechtenstein
Mudell:Dati pajjiż Togo	Template:Country data Togo
Mudell:Dati pajjiż Gwatemala	Template:Country data Guatemala
Kategorija:Klabbs tal-futbol Ġermaniżi	Category:ドイツのサッカークラブ
Kategorija:Lingwistika	Category:言語学
Mudell:Dati pajjiż Ħaiti	Template:Country data Haiti
Mudell:Dati pajjiż Mali	Template:Country data Mali
Mudell:Dati pajjiż Latvja	Template:Country data Latvia
Mudell:Football kit	Template:Football kit
Mudell:Dati pajjiż Malta	Template:Country data Malta
Mudell:Dati pajjiż Monako	Template:Country data Monaco
Mudell:Dati pajjiż Danimarka	Template:Country data Denmark
Mudell:Dati pajjiż Iżlanda	Template:Country data Iceland
Mudell:Dati pajjiż Polonja	Template:Country data Poland
Kategorija:1911	Category:1911年
Kategorija:1922	Category:1922年
Kategorija:1924	Category:1924年
Mudell:Dati pajjiż Bulgarija	Template:Country data Bulgaria
Kategorija:1906	Category:1906年
Mudell:Dati pajjiż Bosnja-Ħerzegovina	Template:Country data Bosnia and Herzegovina
Kategorija:Klabbs tal-futbol	Category:サッカークラブ
Mudell:Dati pajjiż Gujana	Template:Country data Guyana
Kategorija:Mudelli tal-futbol	Category:サッカー関連のテンプレート
Kategorija:Utenti fr-1	Category:User fr-1
Mudell:Dati pajjiż Norveġja	Template:Country data Norway
Mudell:Dati pajjiż Afrika t'Isfel	Template:Country data South Africa
Mudell:Dati pajjiż Ġamajka	Template:Country data Jamaica
Mudell:Dati pajjiż Ġeorġja	Template:Country data Georgia
Mudell:Dati pajjiż Arġentina	Template:Country data Argentina
Mudell:Dati pajjiż Urugwaj	Template:Country data Uruguay
Mudell:Wikiquote	Template:Wikiquote
Mudell:Dati pajjiż Trinidad u Tobago	Template:Country data Trinidad and Tobago
Kategorija:Innijiet Nazzjonali	Category:国歌
Mudell:Dati pajjiż Brunej	Template:Country data Brunei
Mudell:Dati pajjiż Sri Lanka	Template:Country data Sri Lanka
Mudell:Dati pajjiż Messiku	Template:Country data Mexico
Mudell:Dati pajjiż Greċja	Template:Country data Greece
Mudell:Dati pajjiż Lussemburgu	Template:Country data Luxembourg
Mudell:Infobox Kumpanija Dotcom	Template:Infobox dotcom company
Mudell:Dati pajjiż Arabja Sawdija	Template:Country data Saudi Arabia
Mudell:Dati pajjiż Baħamas	Template:Country data Bahamas
Mudell:Dati pajjiż Kroazja	Template:Country data Croatia
Mudell:Afrika	Template:アフリカ
Mudell:Edizzjoni Olimpika	Template:オリンピックインフォメーション
Mudell:Dati pajjiż Emirati Għarab Magħquda	Template:Country data United Arab Emirates
Mudell:Wikimedia	Template:Wikimedia Foundation
Mudell:Infobox artist mużikali	Template:Infobox Musician
Mudell:Dati pajjiż Gżejjer Verġni Amerikani	Template:Country data U.S. Virgin Islands
Mudell:Dati pajjiż Marokk	Template:Country data Morocco
Mudell:Dati pajjiż Serbja	Template:Country data Serbia
Mudell:Dati pajjiż Awstralja	Template:Country data Australia
Mudell:WIP	Template:Inuse
Mudell:Es	Template:Es icon
Mudell:Dati pajjiż Franza	Template:Country data France
Mudell:Ambox	Template:Ambox
Mudell:Għall-aġġornament	Template:更新
Mudell:Cs	Template:Cs icon
Mudell:Infobox Pajjiż	Template:基礎情報 国
Mudell:Mas	Template:Max
Mudell:Dati pajjiż Laos	Template:Country data Laos
Mudell:Fi	Template:Fi icon
Mudell:Stampa kbira	Template:Wide image
Mudell:Dati pajjiż Awstrija	Template:Country data Austria
Mudell:Kataktar	Template:Catmore2
Mudell:Dati pajjiż Nepal	Template:Country data Nepal
Mudell:Sar	Template:済
Mudell:Dati pajjiż Finlandja	Template:Country data Finland
Mudell:Awdjo	Template:Audio
Mudell:Dati pajjiż Eġittu	Template:Country data Egypt
Mudell:Dati pajjiż Litwanja	Template:Country data Lithuania
Għajnuna:Gwida essenzjali/Ħoloq	Wikipedia:チュートリアル リンク
Kategorija:Timijiet nazzjonali tal-futbol Ewropej	Category:ヨーロッパのサッカーナショナルチーム
Mudell:Dati pajjiż Ġappun	Template:Country data Japan
Mudell:Sezzjoni-stub	Template:節スタブ
Mudell:Dati pajjiż Pajjiżi l-Baxxi	Template:Country data Netherlands
Mudell:Tmbox	Template:Tmbox
Mudell:Navbox with columns	Template:Navbox with columns
Mudell:Kaxxa tal-bidu	Template:S-start
Mudell:Biżestili	Template:Is-leap-year
Mudell:Politika	Template:Policy
Mudell:Facebook	Template:Facebook
Mudell:Dati pajjiż Ażerbajġan	Template:Country data Azerbaijan
Mudell:Dablink	Template:Dablink
Mudell:Dati pajjiż Ċekoslovakkja	Template:Country data Czechoslovakia
Mudell:Dati pajjiż Vjetnam	Template:Country data Vietnam
Mudell:Vetrina	Template:Featured article
Mudell:Dati pajjiż Libja	Template:Country data Libya
Mudell:Dati pajjiż Russja	Template:Country data Russia
Mudell:Round4	Template:Round4
Mudell:Portal bidu	Portal:Box-header
Kategorija:Utenti en-4	Category:User en-4
Kategorija:Utenti en	Category:User en
Kategorija:Utenti zh	Category:User zh
Kategorija:Kroazja	Category:クロアチア
Mudell:Ġranet f'xahar	Template:Days in month
Kategorija:Utenti zh-N	Category:User zh-N
Kategorija:Utenti en-2	Category:User en-2
Mudell:TOCright	Template:TOCright
Kategorija:Mietu fl-1902	Category:1902年没
Mudell:Skwadra Ġermaniża Tazza tad-Dinja tal-Futbol 2002	Template:2002 FIFAワールドカップドイツ代表
Mudell:Utent zh	Template:User zh
Mudell:Infobox Tim nazzjonali tal-futbol	Template:サッカーナショナルチーム
Mudell:Leġenda	Template:Legend
Mudell:Ċita web	Template:Cite web
Mudell:Dati pajjiż Italja	Template:Country data Italy
Kategorija:Unuri tal-futbol	Category:サッカーの賞
Mudell:Ombox	Template:Ombox
Mudell:Lx	Template:Lx
Mudell:Dati pajjiż	Template:Country data
Mudell:Futbol internazzjonali	Template:国際サッカー
Kategorija:Kċina	Category:飲食
Mudell:Coor URL	Template:座標URL
Mudell:Pp-mudell	Template:Pp-template
Mudell:Min	Template:Min
Mudell:Subon	Template:Subon
Mudell:Wikizzjunarju	Template:Wiktionary
Mudell:Utent nl-2	Template:User nl-2
Mudell:Dati pajjiż Żvezja	Template:Country data Sweden
Kategorija:Terminoloġija tal-futbol	Category:サッカーの用語
Mudell:Bar box	Template:Bar box
Mudell:Languageicon	Template:Languageicon
Kategorija:Agrikoltura	Category:農業
Kategorija:Utenti hi	Category:User hi
Mudell:Golden goal	Template:Golden goal
Kategorija:Seklu 20	Category:20世紀
Kategorija:Politiċi	Category:政治家
Kategorija:Amerika	Category:アメリカ
Mudell:Użioħra	Template:Otheruses
Mudell:Dati pajjiż Kosta Rika	Template:Country data Costa Rica
Mudell:Dati pajjiż Unjoni Sovjetika	Template:Country data Soviet Union
Mudell:Dati pajjiż Indja	Template:Country data India
Kategorija:Pangolin	Category:有鱗目 (哺乳類)
Kategorija:Mudelli tal-lingwi tal-utenti	Category:バベル
Kategorija:Bliet tal-Marokk	Category:モロッコの都市
Mudell:Imbox	Template:Imbox
Mudell:Data tat-twelid u età	Template:生年月日と年齢
Mudell:Dati pajjiż Alġerija	Template:Country data Algeria
Mudell:Clade	Template:Clade
Mudell:ISEMXAHAR	Template:MONTHNAME
Mudell:Rindirizzament kategorija	Template:Category redirect
Mudell:Dati pajjiż Veneżwela	Template:Country data Venezuela
Mudell:Infobox Kariga pubblika	Template:Infobox Officeholder
Mudell:Proġetti oħra	Template:Sisterlinks
Mudell:Sortname	Template:Sortname
Mudell:Dati pajjiż Andorra	Template:Country data Andorra
Mudell:Dati pajjiż Angola	Template:Country data Angola
Mudell:Dati pajjiż Botswana	Template:Country data Botswana
Mudell:Dati pajjiż Unjoni Ewropea	Template:Country data European Union
Mudell:Dati pajjiż Portugall	Template:Country data Portugal
Mudell:Data tal-mewt u età	Template:死亡年月日と没年齢
Kategorija:Twieldu fl-1879	Category:1879年生
Mudell:NUMRUXAHAR	Template:MONTHNUMBER
Kategorija:Abbozzi ta' bijografiji	Category:人物関連のスタブ項目
Mudell:Sport fil-futur	Template:予定されているスポーツイベント
Mudell:Dati pajjiż Belt tal-Vatikan	Template:Country data Vatican City
Kategorija:Twieldu fl-1955	Category:1955年生
Mudell:Ikoni tat-titlu	Template:Top icon
Kategorija:Twieldu fl-1963	Category:1963年生
Kategorija:Mudelli ta' dati tal-pajjiżi	Category:Country dataテンプレート
Kategorija:Twieldu fl-1817	Category:1817年生
Kategorija:Twieldu fl-1998	Category:1998年生
Mudell:Dati pajjiż Ċina	Template:Country data China
Mudell:Dati pajjiż Benin	Template:Country data Benin
Mudell:Wikifikazzjoni	Template:Wikify
Mudell:Dati pajjiż Ingilterra	Template:Country data England
Kategorija:Seklu 19	Category:19世紀
Mudell:Dati pajjiż Repubblika tal-Irlanda	Template:Country data Republic of Ireland
Mudell:Dati pajjiż Turkija	Template:Country data Turkey
Kategorija:Kittieba	Category:作家
Mudell:Yel	Template:Yel
Mudell:Dati pajjiż Ċipru	Template:Country data Cyprus
Mudell:Dati pajjiż Żvizzera	Template:Country data Switzerland
Mudell:Dati pajjiż Filippini	Template:Country data Philippines
Mudell:Dati pajjiż Niġerja	Template:Country data Nigeria
Mudell:Dati pajjiż Belarus	Template:Country data Belarus
Mudell:Dati pajjiż Malażja	Template:Country data Malaysia
Mudell:Dati pajjiż Armenja	Template:Country data Armenia
Mudell:Dati pajjiż Żimbabwe	Template:Country data Zimbabwe
Mudell:Dati pajjiż Timor tal-Lvant	Template:Country data Timor-Leste
Mudell:Tim ta' AC Milan	Template:ACミランのメンバー
Mudell:Dati pajjiż Tajwan	Template:Country data Taiwan
Mudell:Dati pajjiż Vjetnam t'Isfel	Template:Country data South Vietnam
Mudell:Dati pajjiż Każakistan	Template:Country data Kazakhstan
Mudell:Dati pajjiż Ċili	Template:Country data Chile
Mudell:Dati pajjiż Slovenja	Template:Country data Slovenia
Mudell:Dati pajjiż Libanu	Template:Country data Lebanon
Mudell:Dati pajjiż Tajpej Ċiniżi	Template:Country data Chinese Taipei
Mudell:Dati pajjiż Butan	Template:Country data Bhutan
Mudell:Utent pt-1	Template:User pt-1
Kategorija:1931	Category:1931年
Kategorija:1958	Category:1958年
Kategorija:1956	Category:1956年
Kategorija:1944	Category:1944年
Kategorija:Jiem ta' Jannar	Category:1月
Kategorija:1916	Category:1916年
Kategorija:1939	Category:1939年
Mudell:Tavla Perjodika kumpatta	Template:元素周期表
Kategorija:1909	Category:1909年
Kategorija:Klabbs tal-futbol Taljani	Category:イタリアのサッカークラブ
Mudell:Tazza tad-Dinja tal-Futbol tal-Klabbs	Template:FIFAクラブワールドカップ
Kategorija:Mietu fl-1221	Category:1221年没
Mudell:Utent no-2	Template:User no-2
Mudell:Kategorijamoħbija	Template:Hiddencat
Mudell:Nat fs g end	Template:サッカーナショナルチーム選手一覧 終了
Mudell:Klassifika tal-futbol	Template:Fb cl team
Mudell:Dokumentazzjoni mudell	Template:Documentation subpage
Mudell:CcTLD	Template:CcTLD
Mudell:Div col	Template:Div col
Mudell:Klassifikazzjoni	Template:Rating
Kategorija:Pittura	Category:絵画
Mudell:Div col end	Template:Div col end
Mudell:TħassirKategorija	Template:Empty category
Mudell:'	Template:'
Mudell:Goal	Template:Goal
Mudell:Paġna utent	Template:Userpage
Mudell:Bandierapajjiż2	Template:Flag2
Kategorija:UEFA Europa League	Category:UEFAヨーロッパリーグ
Mudell:Infobox Album	Template:Infobox Album
Mudell:Utent	Template:User
Jherson Vergara	ジェルソン・ベルガラ
Mudell:Tazza tad-Dinja tal-Klabbs Rawnd 8	Template:ClubWCRound8
Kategorija:Ajruporti fil-Vjetnam	Category:ベトナムの空港
Mudell:Logħba futbol	Template:Footballbox
Mudell:Emerġenza-buttuna-tifi	Template:Emergency-bot-shutoff
Mudell:Imdb	Template:IMDb name
Kategorija:Tuneżija	Category:チュニジア
Mudell:Futbol internazzjonali tal-klabbs	Template:国際クラブサッカー
Mudell:It	Template:It icon
Mudell:Infobox Stadju	Template:スタジアム情報ボックス
Mudell:Wikibarijiet	Template:Wikinews
Mudell:Cmbox	Template:Cmbox
Mudell:Rindirizz	Template:Redirect
Mudell:TwoLegStart	Template:TwoLeg start
Mudell:Pajjiżi fil-Logħob Olimpiku tas-Sajf 2008	Template:北京オリンピック選手団
Mudell:Kontra	Template:反対
Mudell:Coord/link	Template:Coord/link
Mudell:LTU	Template:LTU
Mudell:Utent SUL	Template:User SUL
Kategorija:Utenti ja-N	Category:User ja-N
Kategorija:Futbolers Belġjani	Category:ベルギーのサッカー選手
Kategorija:Futbolers Sloveni	Category:スロベニアのサッカー選手
Mudell:Kwantitajiet Ta' Bit	Template:ビットの単位表
Mudell:Pdf	Template:PDFlink
Mudell:Dati pajjiż Ġermanja tal-Punent	Template:Country data West Germany
Mudell:Dati pajjiż Ġermanja tal-Lvant	Template:Country data East Germany
Kategorija:Twieldu fl-1903	Category:1903年生
Kategorija:Imperi	Category:帝国
Kategorija:Twieldu fl-1925	Category:1925年生
Kategorija:Twieldu fl-1936	Category:1936年生
Kategorija:Twieldu fl-1916	Category:1916年生
Kategorija:Twieldu fl-1910	Category:1910年生
Kategorija:Twieldu fl-1939	Category:1939年生
Mudell:Utent it-0	Template:User it-0
Mudell:Diżambigwazzjoni	Template:Aimai
Kategorija:1962	Category:1962年
Mudell:Pt	Template:Pt icon
Mudell:Dati pajjiż Ħong Kong	Template:Country data Hong Kong
Mudell:Ma sarx	Template:中止
Mudell:QasamKat	Template:Catdiffuse
Mudell:Uk	Template:Uk icon
Kategorija:Mudelli infobox	Category:基礎情報テンプレート
Mudell:Penmiss	Template:Penmiss
Kategorija:Real Madrid CF	Category:レアル・マドリード
Kategorija:Storja ta' l-isport	Category:スポーツの歴史
Mudell:Dati pajjiż Żajr	Template:Country data Zaire
Mudell:Dati pajjiż Imperu Ġermaniż	Template:Country data German Empire
Kategorija:Futbol fi Spanja	Category:スペインのサッカー
Mudell:Pengoal	Template:Pengoal
Kategorija:Mietu fl-2013	Category:2013年没
Mudell:Fb	Template:Fb
Kategorija:Twieldu fl-1938	Category:1938年生
Kategorija:Meta-mudelli tal-Wikipedija	Category:メタテンプレート
Mudell:Is	Template:Is icon
Mudell:Utent no-3	Template:User no-3
Mudell:Annotazzjoni	Template:Annotation
Mudell:Dati pajjiż Imperu Ottoman	Template:Country data Ottoman Empire
Kategorija:Mudelli ta' ikoni tal-lingwi	Category:言語学関連のテンプレート
Mudell:Infobox Filosfu	Template:Infobox 哲学者
Mudell:Hy	Template:Hy icon
Kategorija:Teoloġija	Category:神学
Mudell:Infobox Organizzazzjoni	Template:Infobox 組織
Robin Stjernberg	ロビン・シェーンベリ
Kategorija:1663	Category:1663年
Kategorija:Mietu fl-1663	Category:1663年没
Mudell:Hr	Template:Hr icon
Mudell:Tr	Template:Tr icon
Mudell:Az	Template:Az icon
Kategorija:Arkitettura	Category:建築
Mudell:Nl	Template:Nl icon
Mudell:NATO	Template:NATO
Mudell:Dati pajjiż Qatar	Template:Country data Qatar
Mudell:Utent it-2	Template:User it-2
Mudell:De	Template:De icon
Kategorija:Bliet tal-Italja	Category:イタリアのコムーネ
Mudell:Età	Template:年数
Mudell:Għoti tal-penalties	Template:Penshootoutbox
Mudell:Bliet kapitali tal-UE	Template:欧州連合加盟国の首都
Mudell:Infobox Ċelebrità	Template:Infobox 人物
Mudell:La	Template:P
Mudell:Dati pajjiż Iżrael	Template:Country data Israel
Kategorija:1953	Category:1953年
Mudell:Tim ta' AS Roma	Template:ASローマのメンバー
Mudell:Lista ta' kapitali Ewropej skont ir-reġjun	Template:ヨーロッパの首都
Mudell:Dati pajjiż Ukraina	Template:Country data Ukraine
Mudell:Dati pajjiż Kolombja	Template:Country data Colombia
Mudell:Dati pajjiż Pakistan	Template:Country data Pakistan
Mudell:Dati pajjiż Gana	Template:Country data Ghana
Mudell:Dati pajjiż Rumanija	Template:Country data Romania
Mudell:Dati pajjiż Korea t'Isfel	Template:Country data South Korea
Mudell:L-Ewwel Diviżjoni Belġjana	Template:ジュピラーリーグ
Mudell:Football League Championship	Template:フットボールリーグ・チャンピオンシップ
Mudell:Sr	Template:Sr icon
Kategorija:Isqfijiet Kattoliċi Rumani	Category:司教
Mudell:Coord	Template:Coord
Kategorija:Twieldu fis-seklu 20	Category:20世紀生
Kategorija:Twieldu fis-seklu 19	Category:19世紀生
Kategorija:Twieldu fis-seklu 21	Category:21世紀生
Kategorija:Twieldu fis-seklu 18	Category:18世紀生
Kategorija:Twieldu fis-seklu 17	Category:17世紀生
Kategorija:Twieldu fis-seklu 16	Category:16世紀生
Kategorija:Twieldu fis-seklu 15	Category:15世紀生
Kategorija:Mudelli tal-klabbs tal-futbol Franċiżi	Category:フランスのサッカークラブテンプレート
Kategorija:FIFA	Category:FIFA
Kategorija:Timijiet nazzjonali tal-futbol Oċeaniċi	Category:オセアニアのサッカーナショナルチーム
Mudell:Dati pajjiż Boemja	Template:Country data Bohemia
Kategorija:Futbolers Ivorjani	Category:コートジボワールのサッカー選手
Mudell:Timijiet nazzjonali tal-CAF	Template:アフリカのサッカーナショナルチーム
Mudell:Utent bg	Template:User bg
Mudell:Dati pajjiż Baħrejn	Template:Country data Bahrain
Kategorija:Mietu fl-1622	Category:1622年没
Mudell:Ewropa	Template:ヨーロッパ
Kategorija:Futbolers skont in-nazzjonalità	Category:各国のサッカー選手
Kategorija:Utenti yue	Category:User zh-yue
Kategorija:Utenti az	Category:User az
Kategorija:Utenti be	Category:User be
Kategorija:Utenti hr	Category:User hr
Kategorija:Utenti eo	Category:User eo
Kategorija:Utenti fr	Category:User fr
Kategorija:Utenti cy	Category:User cy
Kategorija:Utenti id	Category:User id
Kategorija:Utenti ga	Category:User ga
Kategorija:Utenti ja	Category:User ja
Kategorija:Utenti nn	Category:User nn
Kategorija:Utenti pt	Category:User pt
Kategorija:Utenti scn	Category:User scn
Kategorija:Utenti sv	Category:User sv
Kategorija:Utenti fr-3	Category:User fr-3
Kategorija:Utenti it-3	Category:User it-3
Kategorija:Utenti no-3	Category:User no-3
Kategorija:Utenti pl-3	Category:User pl-3
Kategorija:Utenti scn-3	Category:User scn-3
Kategorija:Utenti da-1	Category:User da-1
Kategorija:Utenti ga-1	Category:User ga-1
Kategorija:Utenti nl-1	Category:User nl-1
Kategorija:Utenti scn-1	Category:User scn-1
Kategorija:Utenti tr-1	Category:User tr-1
Kategorija:Utenti ar-1	Category:User ar-1
Kategorija:Utenti it-4	Category:User it-4
Kategorija:Utenti pl-4	Category:User pl-4
Kategorija:Utenti be-2	Category:User be-2
Kategorija:Utenti da-2	Category:User da-2
Kategorija:Utenti fr-2	Category:User fr-2
Kategorija:Utenti cy-2	Category:User cy-2
Kategorija:Utenti hi-2	Category:User hi-2
Kategorija:Utenti it-2	Category:User it-2
Kategorija:Utenti ja-2	Category:User ja-2
Kategorija:Utenti nl-2	Category:User nl-2
Kategorija:Utenti pl-2	Category:User pl-2
Kategorija:Utenti scn-2	Category:User scn-2
Kategorija:Utenti tr-2	Category:User tr-2
Kategorija:Utenti be-N	Category:User be-N
Kategorija:Utenti cs-N	Category:User cs-N
Kategorija:Utenti hr-N	Category:User hr-N
Kategorija:Utenti fr-N	Category:User fr-N
Kategorija:Utenti it-N	Category:User it-N
Kategorija:Utenti nl-N	Category:User nl-N
Kategorija:Utenti no-N	Category:User no-N
Kategorija:Utenti ru-N	Category:User ru-N
Kategorija:Utenti scn-N	Category:User scn-N
Kategorija:Divertiment	Category:娯楽
Kategorija:Utenti se-3	Category:User se-3
Mudell:Nfteams	Template:Nfteams
Kategorija:Klabbs tal-futbol xolti	Category:現在活動していないサッカークラブ
Kategorija:UEFA Champions League	Category:UEFAチャンピオンズリーグ
Mudell:Utent yue	Template:User zh-yue
Kategorija:Abbozzi tal-enerġija	Category:エネルギー関連のスタブ項目
Kategorija:Għall-wikifikazzjoni	Category:Wikifyが必要な項目
Kategorija:1220	Category:1220年
Kategorija:Kompetizzjonijiet tal-UEFA	Category:UEFAサッカー大会
Kategorija:Organizzazzjonijiet tal-futbol	Category:サッカーに関する組織
Kategorija:UEFA	Category:UEFA
Kategorija:Utenti af	Category:User af
Kategorija:Utenti af-3	Category:User af-3
Kategorija:Utenti ar	Category:User ar
Mudell:Cref2	Template:Cref2
Kategorija:Utenti az-N	Category:User az-N
Kategorija:Pajjiżi fil-Festival tal-Eurovision	Category:各国のユーロビジョン・ソング・コンテスト
Kategorija:Utenti bg	Category:User bg
Kategorija:Utenti bg-1	Category:User bg-1
Kategorija:Utenti bg-N	Category:User bg-N
Kategorija:Mużiċisti Awstrijaċi	Category:オーストリアのミュージシャン
Kategorija:Utenti cs	Category:User cs
Kategorija:Utenti da	Category:User da
Kategorija:Provinċja ta' Quang Binh	Category:クアンビン省
Kategorija:Abbozzi ta' annimali	Category:動物関連のスタブ項目
Kategorija:Utenti de	Category:User de
Kategorija:Utenti de-2	Category:User de-2
Kategorija:Utenti de-3	Category:User de-3
Kategorija:Utenti de-4	Category:User de-4
Kategorija:Utenti de-N	Category:User de-N
Kategorija:Utenti el	Category:User el
Kategorija:Utenti el-N	Category:User el-N
Kategorija:Utenti en-3	Category:User en-3
Kategorija:Utenti en-N	Category:User en-N
Kategorija:Utenti eo-3	Category:User eo-3
Kategorija:Utenti es	Category:User es
Kategorija:Utenti es-1	Category:User es-1
Mudell:Pajjiżi tal-Unjoni Ewropea	Template:EU
Kategorija:Utenti es-2	Category:User es-2
Kategorija:Utenti es-3	Category:User es-3
Kategorija:Utenti es-N	Category:User es-N
Kategorija:Utenti fa	Category:User fa
Kategorija:Utenti fa-N	Category:User fa-N
Kategorija:Utenti fi	Category:User fi
Kategorija:Utenti fi-N	Category:User fi-N
Kategorija:Utenti ga-2	Category:User ga-2
Kategorija:Utenti ga-3	Category:User ga-3
Kategorija:Utenti ga-N	Category:User ga-N
Kategorija:Utenti grc	Category:User grc
Kategorija:Utenti hu	Category:User hu
Kategorija:Utenti hu-1	Category:User hu-1
Kategorija:1452	Category:1452年
Mudell:Tim ta' Bayer 04 Leverkusen	Template:レバークーゼンのメンバー
Kategorija:Plejers ta' Los Angeles Galaxy	Category:ロサンゼルス・ギャラクシーの選手
Kategorija:Mietu fl-1904	Category:1904年没
Kategorija:Politiċi Veneżwelani	Category:ベネズエラの政治家
Mudell:Tim ta' Málaga CF	Template:マラガのメンバー
Kategorija:Utenti pl-N	Category:User pl-N
Kategorija:Utenti pt-1	Category:User pt-1
Mudell:Dati pajjiż Ġermanja	Template:Country data Germany
Mudell:Dati pajjiż Renju Unit	Template:Country data United Kingdom
Kategorija:Mietu fl-1852	Category:1852年没
Kategorija:Mietu fl-1880	Category:1880年没
Kategorija:Ġeometrija	Category:幾何学
Kategorija:Mietu fl-1942	Category:1942年没
Mudell:Dati pajjiż Skozja	Template:Country data Scotland
Għajnuna:Gwida essenzjali/Ifformattjar	Wikipedia:ガイドブック 執筆する
Mudell:Dati pajjiż Estonja	Template:Country data Estonia
Mudell:Dati pajjiż Montenegro	Template:Country data Montenegro
Kategorija:Utenti it	Category:User it
Kategorija:Utenti it-1	Category:User it-1
Kategorija:Futbolers Ażerbajġani	Category:アゼルバイジャンのサッカー選手
Kategorija:Vulkani	Category:火山
Kategorija:Mietu fl-1564	Category:1564年没
Kategorija:1564	Category:1564年
Kategorija:Edizzjonijiet tat-Tazza tad-Dinja tal-Futbol	Category:FIFAワールドカップの歴代大会
Kategorija:Provinċji tal-Vjetnam	Category:ベトナムの省
Kategorija:1592	Category:1592年
Kategorija:Kompetizzjonijiet tal-futbol skont il-pajjiż	Category:各国のサッカー大会
Kategorija:Arti marzjali	Category:武術
Mudell:Informazzjoni	Template:Information
Kategorija:Plejers ta' De Graafschap	Category:デ・フラーフスハップの選手
Kategorija:Pitturi tar-Rinaxximent	Category:ルネサンス画家
Kategorija:Bijoloġi evoluzzjonarji	Category:進化生物学者
Kategorija:Knisja Kattolika Rumana	Category:カトリック
Kategorija:Kowċis Olandiżi	Category:オランダのサッカー指導者
Kategorija:Mużiċisti Olandiżi	Category:オランダのミュージシャン
Kategorija:Kantanti Olandiżi	Category:オランダの歌手
Mudell:Klassifikazzjoni xjentifika	Template:Biological classification
Kategorija:Mietu fl-1794	Category:1794年没
Kategorija:Mietu fl-1931	Category:1931年没
Kategorija:Mietu fl-1827	Category:1827年没
Kategorija:Utenti ru-1	Category:User ru-1
Mudell:TOClimit	Template:TOC limit
Wikipedija:Babel	Wikipedia:バベル
Kategorija:Mietu fl-1829	Category:1829年没
Kategorija:Mietu fl-1778	Category:1778年没
Kategorija:Mietu fl-1547	Category:1547年没
Mudell:·wrap	Template:·wrap
Kategorija:Abbozzi tal-kimika	Category:化学関連のスタブ項目
Mudell:Nat fs start	Template:サッカーナショナルチーム選手一覧 開始
Kategorija:1687	Category:1687年
Kategorija:1614	Category:1614年
Kategorija:1612	Category:1612年
Kategorija:Mietu fl-1612	Category:1612年没
Kategorija:Mietu fl-1655	Category:1655年没
Kategorija:Mietu fl-1616	Category:1616年没
Kategorija:Mietu fl-1614	Category:1614年没
Kategorija:Futbolers Olandiżi	Category:オランダのサッカー選手
Kategorija:1655	Category:1655年
Kategorija:Mietu fl-1994	Category:1994年没
Kategorija:Twieldu fl-1906	Category:1906年生
Kategorija:Kompożituri tal-opra	Category:オペラ作曲家
Kategorija:Ibħra	Category:海
Kategorija:Bliet tal-Polonja	Category:ポーランドの都市
Kategorija:Kompożituri skont in-nazzjonalità	Category:各国の作曲家
Mudell:Bundesliga (Awstrija)	Template:サッカー・ブンデスリーガ (オーストリア)
Kategorija:Futbolers f'Wales skont il-klabb	Category:ウェールズのクラブに所属するサッカー選手
Kategorija:Atturi skont in-nazzjonalità	Category:各国の俳優
Kategorija:Mietu fl-2009	Category:2009年没
Kategorija:Utenti nb-3	Category:User nb-3
Kategorija:Sistema solari	Category:太陽系
Trasformata ta' Fourier	フーリエ変換
Mudell:Coord/dms2dec	Template:Coord/dms2dec
Mudell:Dati pajjiż Brażil	Template:Country data Brazil
Mudell:FIFA	Template:FIFA player
Mudell:Dati pajjiż Irlanda ta' Fuq	Template:Country data Northern Ireland
Mudell:UEFA	Template:UEFA player
Kategorija:Entomoloġija	Category:昆虫学
Kategorija:Carnivora	Category:食肉目
Kategorija:Klabbs tal-futbol Torok	Category:トルコのサッカークラブ
Kategorija:Mietu fl-1321	Category:1321年没
Kategorija:Mietu fl-2005	Category:2005年没
Kategorija:Twieldu fl-1983	Category:1983年生
Kategorija:Mietu fl-1592	Category:1592年没
Kategorija:Futbolers Pollakki	Category:ポーランドのサッカー選手
Kategorija:Mużiċisti Bulgari	Category:ブルガリアのミュージシャン
Kategorija:Vandaliżmu tal-Wikipedija	Category:荒らし対策
Kategorija:Mietu fl-1991	Category:1991年没
Kategorija:Mietu fl-1992	Category:1992年没
Kategorija:Plejers ta' Sport Club Corinthians Paulista	Category:コリンチャンスの選手
Kategorija:Twieldu fl-1992	Category:1992年生
Kategorija:Utenti nb	Category:User nb
Kategorija:Twieldu fl-1970	Category:1970年生
Kategorija:Mietu fl-1980	Category:1980年没
Kategorija:Mietu fl-2008	Category:2008年没
Kategorija:Mietu fl-1966	Category:1966年没
Kategorija:Mietu fl-1946	Category:1946年没
Kategorija:Mietu fl-1938	Category:1938年没
Kategorija:Twieldu fl-1984	Category:1984年生
Kategorija:Mietu fl-1962	Category:1962年没
Kategorija:Twieldu fl-1990	Category:1990年生
Kategorija:Mietu fl-1934	Category:1934年没
Kategorija:Twieldu fl-1974	Category:1974年生
Kategorija:Mietu fl-1947	Category:1947年没
Kategorija:Mietu fl-2007	Category:2007年没
Kategorija:Twieldu fl-1965	Category:1965年生
Kategorija:Twieldu fl-1940	Category:1940年生
Kategorija:Twieldu fl-1898	Category:1898年生
Kategorija:Twieldu fl-1867	Category:1867年生
Kategorija:Twieldu fl-1871	Category:1871年生
Kategorija:Twieldu fl-1862	Category:1862年生
Kategorija:Twieldu fl-1977	Category:1977年生
Kategorija:Twieldu fl-1899	Category:1899年生
Kategorija:1844	Category:1844年
Kategorija:Twieldu fl-1931	Category:1931年生
Kategorija:Twieldu fl-1915	Category:1915年生
Kategorija:Twieldu fl-1929	Category:1929年生
Kategorija:Poeti Spanjoli	Category:スペインの詩人
Portal:Sport	Portal:スポーツ
Mudell:Id	Template:Id icon
Kategorija:Twieldu fl-1954	Category:1954年生
Kategorija:Xjenza soċjali	Category:社会科学
Kategorija:Bjelorussja	Category:ベラルーシ
Kategorija:Twieldu fl-1960	Category:1960年生
Kategorija:Kantanti Kanadiżi	Category:カナダの歌手
Mudell:Dati pajjiż Ungerija	Template:Country data Hungary
Kategorija:Mietu fl-1830	Category:1830年没
Kategorija:Ewropa tal-Lvant	Category:東欧
Kategorija:Mietu fl-1993	Category:1993年没
Mudell:PortaliWikimedia	Template:WikimediaForPortals
Kategorija:Pajjiżi tal-Afrika	Category:アフリカの国
Kategorija:Mietu fl-1998	Category:1998年没
Kategorija:Klabbs tal-futbol Ażerbajġani	Category:アゼルバイジャンのサッカークラブ
Kategorija:1170	Category:1170年
Kategorija:Twieldu fl-1170	Category:1170年生
Kategorija:Twieldu fl-1182	Category:1182年生
Kategorija:Twieldu fl-1185	Category:1185年生
Kategorija:Mietu fl-1220	Category:1220年没
Kategorija:1226	Category:1226年
Kategorija:Mietu fl-1226	Category:1226年没
Kategorija:1227	Category:1227年
Kategorija:Mietu fl-1227	Category:1227年没
Kategorija:Twieldu fl-1951	Category:1951年生
Kategorija:Mietu fl-1882	Category:1882年没
Kategorija:Mietu fl-1883	Category:1883年没
Kategorija:1265	Category:1265年
Kategorija:Twieldu fl-1265	Category:1265年生
Kategorija:1296	Category:1296年
Kategorija:Mietu fl-1296	Category:1296年没
Mudell:Storjafilosofija	Template:西洋哲学史
Mudell:Ballun tad-Deheb	Template:バロンドール受賞者
Mudell:Utent da-3	Template:User da-3
Mudell:Tim ta' FC Barcelona	Template:FCバルセロナのメンバー
Mudell:Utent ja-2	Template:User ja-2
Kategorija:1528	Category:1528年
Mudell:Dati pajjiż New Zealand	Template:Country data New Zealand
Kategorija:1405	Category:1405年
Mudell:Utent ru-2	Template:User ru-2
Kategorija:Twieldu fl-1405	Category:1405年生
Kategorija:1522	Category:1522年
Kategorija:1419	Category:1419年
Mudell:Lv	Template:Lv icon
Kategorija:1508	Category:1508年
Kategorija:1519	Category:1519年
Kategorija:Futbol fil-Polonja	Category:ポーランドのサッカー
Kategorija:Futbolers fil-Polonja skont il-klabb	Category:ポーランドのクラブに所属するサッカー選手
Kategorija:Twieldu fl-1452	Category:1452年生
Kategorija:1466	Category:1466年
Kategorija:1468	Category:1468年
Kategorija:Mietu fl-1468	Category:1468年没
Kategorija:1471	Category:1471年
Kategorija:Twieldu fl-1471	Category:1471年生
Mudell:Skwadra Taljana Tazza tad-Dinja tal-Futbol 2010	Template:2010 FIFAワールドカップイタリア代表
Kategorija:1478	Category:1478年
Kategorija:Twieldu fl-1478	Category:1478年生
Kategorija:Twieldu fl-1480	Category:1480年生
Kategorija:1483	Category:1483年
Kategorija:1494	Category:1494年
Kategorija:Twieldu fl-1494	Category:1494年生
Kategorija:Utenti ru	Category:User ru
Kategorija:Utenti ru-2	Category:User ru-2
Kategorija:Utenti ru-3	Category:User ru-3
Kategorija:Twieldu fl-1508	Category:1508年生
Kategorija:Utenti se	Category:User se
Kategorija:Twieldu fl-1515	Category:1515年生
Kategorija:Mietu fl-1519	Category:1519年没
Kategorija:1532	Category:1532年
Kategorija:Twieldu fl-1532	Category:1532年生
Kategorija:Twieldu fl-1533	Category:1533年生
Kategorija:Mietu fl-1535	Category:1535年没
Kategorija:Mietu fl-1539	Category:1539年没
Kategorija:1542	Category:1542年
Kategorija:Utenti sv-3	Category:User sv-3
Kategorija:1547	Category:1547年
Kategorija:Utenti sv-N	Category:User sv-N
Kategorija:Twieldu fl-1552	Category:1552年生
Kategorija:1562	Category:1562年
Kategorija:Twieldu fl-1564	Category:1564年生
Kategorija:1567	Category:1567年
Kategorija:1568	Category:1568年
Kategorija:Mietu fl-1568	Category:1568年没
Kategorija:1573	Category:1573年
Kategorija:Twieldu fl-1573	Category:1573年生
Kategorija:1581	Category:1581年
Kategorija:Twieldu fl-1582	Category:1582年生
Kategorija:1591	Category:1591年
Kategorija:1593	Category:1593年
Kategorija:1597	Category:1597年
Kategorija:1600	Category:1600年
Mudell:Esc	Template:Esc
Kategorija:1616	Category:1616年
Kategorija:1621	Category:1621年
Kategorija:Utenti tr	Category:User tr
Kategorija:Mietu fl-1621	Category:1621年没
Kategorija:1625	Category:1625年
Kategorija:Mietu fl-1625	Category:1625年没
Kategorija:Utenti uk-4	Category:User uk-4
Kategorija:1636	Category:1636年
Kategorija:1643	Category:1643年
Kategorija:Mietu fl-1643	Category:1643年没
Kategorija:1654	Category:1654年
Kategorija:Twieldu fl-1654	Category:1654年生
Kategorija:1656	Category:1656年
Kategorija:Mietu fl-1656	Category:1656年没
Kategorija:Utenti yue-N	Category:User zh-yue-N
Kategorija:1660	Category:1660年
Kategorija:1667	Category:1667年
Kategorija:Mietu fl-1667	Category:1667年没
Kategorija:1670	Category:1670年
Kategorija:Mietu fl-1670	Category:1670年没
Kategorija:1675	Category:1675年
Kategorija:1685	Category:1685年
Kategorija:Twieldu fl-1687	Category:1687年生
Mudell:En	Template:En icon
Kategorija:1694	Category:1694年
Kategorija:1695	Category:1695年
Kategorija:Twieldu fl-1696	Category:1696年生
Kategorija:Twieldu fl-1699	Category:1699年生
Kategorija:1700	Category:1700年
Kategorija:Mietu fl-1705	Category:1705年没
Kategorija:1709	Category:1709年
Kategorija:1710	Category:1710年
Kategorija:Twieldu fl-1715	Category:1715年生
Kategorija:Twieldu fl-1724	Category:1724年生
Mudell:Spazji	Template:Spaces
Kategorija:Mużiċisti	Category:音楽家
Mudell:DotNET	Template:.NET
Mudell:Dati pajjiż Stati Uniti	Template:Country data United States
Kategorija:Twieldu fl-1881	Category:1881年生
Mudell:Timijiet nazzjonali tal-UEFA	Template:ヨーロッパのサッカーナショナルチーム
Mudell:Tim ta' Manchester United FC	Template:マンチェスター・ユナイテッドFCのメンバー
Mudell:Da	Template:Da icon
Kategorija:Kantanti Irlandiżi	Category:アイルランドの歌手
Mudell:Skwadra Ġermaniża Tazza tad-Dinja tal-Futbol 2010	Template:2010 FIFAワールドカップドイツ代表
Mudell:Skwadra Ġermaniża Kampjonati Ewropej tal-Futbol 2008	Template:UEFA EURO 2008ドイツ代表
Mudell:Sq	Template:Sq icon
Mudell:Dati pajjiż Serbja u Montenegro	Template:Country data Serbia and Montenegro
Kategorija:Twieldu fl-1944	Category:1944年生
Kategorija:Twieldu fl-1932	Category:1932年生
Kategorija:Twieldu fl-1934	Category:1934年生
Kategorija:Twieldu fl-1935	Category:1935年生
Kategorija:Terminoloġija sportiva	Category:スポーツ用語
Kategorija:Twieldu fl-1941	Category:1941年生
Kategorija:Matematiċi Russi	Category:ロシアの数学者
Kategorija:Soċjoloġija	Category:社会学
Kategorija:Twieldu fis-seklu 12	Category:12世紀生
Kategorija:Twieldu fis-seklu 13	Category:13世紀生
Kategorija:Twieldu fis-seklu 14	Category:14世紀生
Kategorija:Twieldu fl-1466	Category:1466年生
Kategorija:Twieldu fl-1483	Category:1483年生
Kategorija:Twieldu fl-1542	Category:1542年生
Kategorija:Twieldu fl-1547	Category:1547年生
Kategorija:Twieldu fl-1562	Category:1562年生
Kategorija:Twieldu fl-1567	Category:1567年生
Kategorija:Twieldu fl-1581	Category:1581年生
Kategorija:Twieldu fl-1591	Category:1591年生
Kategorija:Twieldu fl-1593	Category:1593年生
Kategorija:Twieldu fl-1600	Category:1600年生
Kategorija:Twieldu fl-1636	Category:1636年生
Kategorija:Twieldu fl-1643	Category:1643年生
Kategorija:Twieldu fl-1667	Category:1667年生
Kategorija:Twieldu fl-1675	Category:1675年生
Kategorija:Twieldu fl-1685	Category:1685年生
Kategorija:Twieldu fl-1694	Category:1694年生
Kategorija:Twieldu fl-1695	Category:1695年生
Kategorija:Twieldu fl-1700	Category:1700年生
Kategorija:Twieldu fl-1710	Category:1710年生
Kategorija:Twieldu fl-1744	Category:1744年生
Kategorija:Twieldu fl-1748	Category:1748年生
Kategorija:Twieldu fl-1749	Category:1749年生
Kategorija:Twieldu fl-1756	Category:1756年生
Kategorija:Twieldu fl-1758	Category:1758年生
Kategorija:Twieldu fl-1759	Category:1759年生
Kategorija:Twieldu fl-1764	Category:1764年生
Kategorija:Twieldu fl-1767	Category:1767年生
Kategorija:Twieldu fl-1769	Category:1769年生
Kategorija:Twieldu fl-1770	Category:1770年生
Kategorija:Twieldu fl-1772	Category:1772年生
Kategorija:Twieldu fl-1773	Category:1773年生
Kategorija:Twieldu fl-1779	Category:1779年生
Kategorija:Twieldu fl-1786	Category:1786年生
Kategorija:Twieldu fl-1797	Category:1797年生
Kategorija:Twieldu fl-1801	Category:1801年生
Kategorija:Twieldu fl-1803	Category:1803年生
Kategorija:Twieldu fl-1808	Category:1808年生
Kategorija:Twieldu fl-1809	Category:1809年生
Kategorija:Twieldu fl-1813	Category:1813年生
Kategorija:Twieldu fl-1815	Category:1815年生
Kategorija:Twieldu fl-1818	Category:1818年生
Kategorija:Twieldu fl-1821	Category:1821年生
Kategorija:Twieldu fl-1822	Category:1822年生
Kategorija:Twieldu fl-1824	Category:1824年生
Kategorija:Twieldu fl-1840	Category:1840年生
Kategorija:Twieldu fl-1841	Category:1841年生
Kategorija:Twieldu fl-1844	Category:1844年生
Kategorija:Twieldu fl-1846	Category:1846年生
Kategorija:Twieldu fl-1847	Category:1847年生
Kategorija:Twieldu fl-1848	Category:1848年生
Kategorija:Twieldu fl-1849	Category:1849年生
Kategorija:Twieldu fl-1853	Category:1853年生
Kategorija:Twieldu fl-1854	Category:1854年生
Kategorija:Twieldu fl-1859	Category:1859年生
Kategorija:Twieldu fl-1860	Category:1860年生
Kategorija:Twieldu fl-1861	Category:1861年生
Kategorija:Twieldu fl-1864	Category:1864年生
Kategorija:Twieldu fl-1866	Category:1866年生
Kategorija:Twieldu fl-1869	Category:1869年生
Kategorija:Twieldu fl-1873	Category:1873年生
Kategorija:Twieldu fl-1874	Category:1874年生
Kategorija:Twieldu fl-1876	Category:1876年生
Kategorija:Twieldu fl-1877	Category:1877年生
Kategorija:Twieldu fl-1880	Category:1880年生
Kategorija:Twieldu fl-1883	Category:1883年生
Kategorija:Twieldu fl-1884	Category:1884年生
Kategorija:Twieldu fl-1885	Category:1885年生
Kategorija:Twieldu fl-1886	Category:1886年生
Kategorija:Twieldu fl-1887	Category:1887年生
Kategorija:Twieldu fl-1889	Category:1889年生
Kategorija:Twieldu fl-1890	Category:1890年生
Kategorija:Twieldu fl-1891	Category:1891年生
Kategorija:Twieldu fl-1892	Category:1892年生
Kategorija:Twieldu fl-1893	Category:1893年生
Kategorija:Twieldu fl-1894	Category:1894年生
Kategorija:Twieldu fl-1895	Category:1895年生
Kategorija:Twieldu fl-1896	Category:1896年生
Kategorija:Twieldu fl-1897	Category:1897年生
Kategorija:Twieldu fl-1900	Category:1900年生
Kategorija:Twieldu fl-1901	Category:1901年生
Kategorija:Twieldu fl-1902	Category:1902年生
Kategorija:Twieldu fl-1904	Category:1904年生
Kategorija:Twieldu fl-1905	Category:1905年生
Kategorija:Twieldu fl-1907	Category:1907年生
Kategorija:Twieldu fl-1908	Category:1908年生
Kategorija:Twieldu fl-1909	Category:1909年生
Kategorija:Twieldu fl-1912	Category:1912年生
Kategorija:Twieldu fl-1913	Category:1913年生
Kategorija:Twieldu fl-1914	Category:1914年生
Kategorija:Twieldu fl-1917	Category:1917年生
Kategorija:Twieldu fl-1918	Category:1918年生
Kategorija:Twieldu fl-1919	Category:1919年生
Kategorija:Twieldu fl-1922	Category:1922年生
Kategorija:Twieldu fl-1923	Category:1923年生
Kategorija:Twieldu fl-1927	Category:1927年生
Kategorija:Twieldu fl-1928	Category:1928年生
Kategorija:Twieldu fl-1942	Category:1942年生
Kategorija:Twieldu fl-1943	Category:1943年生
Kategorija:Twieldu fl-1945	Category:1945年生
Kategorija:Twieldu fl-1947	Category:1947年生
Kategorija:Twieldu fl-1949	Category:1949年生
Kategorija:Twieldu fl-1952	Category:1952年生
Kategorija:Twieldu fl-1953	Category:1953年生
Kategorija:Twieldu fl-1957	Category:1957年生
Kategorija:Twieldu fl-1958	Category:1958年生
Kategorija:Twieldu fl-1959	Category:1959年生
Kategorija:Twieldu fl-1961	Category:1961年生
Kategorija:Twieldu fl-1962	Category:1962年生
Kategorija:Twieldu fl-1966	Category:1966年生
Kategorija:Twieldu fl-1967	Category:1967年生
Kategorija:Twieldu fl-1968	Category:1968年生
Kategorija:Twieldu fl-1969	Category:1969年生
Kategorija:Twieldu fl-1971	Category:1971年生
Kategorija:Twieldu fl-1972	Category:1972年生
Kategorija:Twieldu fl-1973	Category:1973年生
Kategorija:Twieldu fl-1975	Category:1975年生
Kategorija:Twieldu fl-1976	Category:1976年生
Kategorija:Twieldu fl-1978	Category:1978年生
Kategorija:Twieldu fl-1979	Category:1979年生
Kategorija:Twieldu fl-1980	Category:1980年生
Kategorija:Twieldu fl-1981	Category:1981年生
Kategorija:Twieldu fl-1982	Category:1982年生
Kategorija:Twieldu fl-1985	Category:1985年生
Kategorija:Twieldu fl-1986	Category:1986年生
Kategorija:Twieldu fl-1987	Category:1987年生
Kategorija:Twieldu fl-1988	Category:1988年生
Kategorija:Twieldu fl-1989	Category:1989年生
Kategorija:Twieldu fl-1991	Category:1991年生
Kategorija:Twieldu fl-1993	Category:1993年生
Kategorija:Twieldu fl-1994	Category:1994年生
Kategorija:Twieldu fl-1995	Category:1995年生
Kategorija:Twieldu fl-1996	Category:1996年生
Kategorija:Twieldu fl-1997	Category:1997年生
Kategorija:Twieldu fl-1999	Category:1999年生
Kategorija:Twieldu fl-2000	Category:2000年生
Mudell:Tazza tad-Dinja tal-Futbol 2006	Template:FIFA2006
Mudell:Dati pajjiż Afganistan	Template:Country data Afghanistan
Mudell:Dati pajjiż Bangladexx	Template:Country data Bangladesh
Kategorija:1715	Category:1715年
Kategorija:1797	Category:1797年
Kategorija:1787	Category:1787年
Kategorija:1539	Category:1539年
Kategorija:1321	Category:1321年
Mudell:Dati pajjiż RFS Jugożlavja	Template:Country data SFR Yugoslavia
Mudell:Nowrap end	Template:Nowrap end
Mudell:Tazza tad-Dinja tal-Klabbs Rawnd 7	Template:ClubWCRound7
Mudell:90minut	Template:90minut
Mudell:Tim ta' ACF Fiorentina	Template:フィオレンティーナのメンバー
Kategorija:Seklu 17	Category:17世紀
Kategorija:Deċennju tal-1260	Category:1260年代
Mudell:Tim ta' Arsenal FC	Template:アーセナルFCのメンバー
Mudell:CopyrightByWikimedia	Template:Copyright by Wikimedia
Kategorija:1182	Category:1182年
Kategorija:1185	Category:1185年
Kategorija:Proġetti tal-Wikimedia	Category:ウィキメディア・プロジェクト
Kategorija:1221	Category:1221年
Kategorija:Plejers ta' Celta de Vigo	Category:セルタ・デ・ビーゴの選手
Mudell:Bar percent	Template:Bar percent
Mudell:Bk	Template:Bk
Mudell:Tim ta' Bologna FC 1909	Template:ボローニャFCのメンバー
Kategorija:2014	Category:2014年
Mudell:Skwadra Brażiljana Tazza tal-Konfederazzjonijiet 2005	Template:FIFAコンフェデレーションズカップ2005ブラジル代表
Mudell:Skwadra Brażiljana Tazza tal-Konfederazzjonijiet 2009	Template:FIFAコンフェデレーションズカップ2009ブラジル代表
Mudell:Skwadra Brażiljana Tazza tad-Dinja tal-Futbol 2010	Template:2010 FIFAワールドカップブラジル代表
Mudell:Utent sv-3	Template:User sv-3
Mudell:Timijiet nazzjonali tal-CONMEBOL	Template:南アメリカのサッカーナショナルチーム
Mudell:Fr	Template:Fr icon
Kategorija:1515	Category:1515年
Mudell:Twitter	Template:Twitter
Kategorija:Mietu fl-1522	Category:1522年没
Kategorija:Portali	Category:ウィキポータル
Kategorija:Mietu fl-1528	Category:1528年没
Kategorija:1533	Category:1533年
Kategorija:1535	Category:1535年
Kategorija:1546	Category:1546年
Kategorija:1552	Category:1552年
Kategorija:Futbolers Sud-Koreani	Category:韓国のサッカー選手
Kategorija:1580	Category:1580年
Kategorija:Mietu fl-1580	Category:1580年没
Kategorija:1582	Category:1582年
Kategorija:1595	Category:1595年
Mudell:Utent af-3	Template:User af-3
Kategorija:1622	Category:1622年
Kategorija:1642	Category:1642年
Kategorija:Mietu fl-1642	Category:1642年没
Kategorija:Mietu fl-1660	Category:1660年没
Kategorija:1696	Category:1696年
Kategorija:1699	Category:1699年
Kategorija:1705	Category:1705年
Kategorija:1726	Category:1726年
Kategorija:Mietu fl-1726	Category:1726年没
Kategorija:Mietu fl-1727	Category:1727年没
Kategorija:Mietu fl-1748	Category:1748年没
Kategorija:Mietu fl-1757	Category:1757年没
Kategorija:Mietu fl-1759	Category:1759年没
Kategorija:Mietu fl-1760	Category:1760年没
Kategorija:1764	Category:1764年
Kategorija:1767	Category:1767年
Kategorija:1769	Category:1769年
Kategorija:Mietu fl-1772	Category:1772年没
Kategorija:1779	Category:1779年
Kategorija:Mietu fl-1782	Category:1782年没
Kategorija:Mietu fl-1787	Category:1787年没
Kategorija:Mietu fl-1789	Category:1789年没
Kategorija:Mietu fl-1790	Category:1790年没
Kategorija:1778	Category:1778年
Mudell:Artiklu prinċipali	Template:Main
Kategorija:Mudelli ta' kampjonati bl-eliminatorji	Category:トーナメントに関するテンプレート
Mudell:Plejers fit-tim tal-futbol/tmiem	Template:サッカークラブチーム選手一覧 終了
Kategorija:Avvenimenti sportivi	Category:スポーツに関するイベント
Kategorija:Avvenimenti sportivi futuri	Category:予定されているスポーツイベント
Kategorija:Avvenimenti futuri	Category:予定
Kategorija:It-Tieni Gwerra Dinjija	Category:第二次世界大戦
Kategorija:L-Ewwel Gwerra Dinjija	Category:第一次世界大戦
Kategorija:Plejers ta' AC Milan	Category:ACミランの選手
Kategorija:Logħob tal-mejda	Category:ボードゲーム
Kategorija:Mudelli ta' ċitazzjoni tas-sorsi	Category:出典テンプレート
Mudell:Ħs	Template:Aet
Kategorija:UC Sampdoria	Category:UCサンプドリア
Mudell:PD-utent	Template:PD-self
Mudell:Tim ta' FC Bayern Munich	Template:バイエルン・ミュンヘンのメンバー
Kategorija:Tubulidentata	Category:管歯目
Kategorija:Klabbs tal-futbol Albaniżi	Category:アルバニアのサッカークラブ
Kategorija:Kittieba Spanjoli	Category:スペインの著作家
Kategorija:Klabbs tal-futbol Bjelorussi	Category:ベラルーシのサッカークラブ
Kategorija:Klabbs tal-futbol Latvjani	Category:ラトビアのサッカークラブ
Kategorija:Klabbs tal-futbol Maltin	Category:マルタのサッカークラブ
Mudell:Round8	Template:Round8
Mudell:Pso	Template:Pso
Mudell:Cquote	Template:Cquote
Mudell:Tim ta' Chelsea FC	Template:チェルシーFCのメンバー
Kategorija:Mietu fl-1937	Category:1937年没
Kategorija:Mietu fl-1950	Category:1950年没
Kategorija:Angola	Category:アンゴラ
Kategorija:Libja	Category:リビア
Kategorija:Marokk	Category:モロッコ
Kategorija:1480	Category:1480年
Kategorija:Mietu fl-1595	Category:1595年没
Kategorija:Mietu fl-1597	Category:1597年没
Kategorija:1610	Category:1610年
Kategorija:Mietu fl-1610	Category:1610年没
Mudell:Kaxxa ġenb	Template:Side box
Kategorija:Unuri u trofej sportivi	Category:スポーツの賞
Kategorija:Mietu fl-2011	Category:2011年没
Kategorija:Kantanti Taljani	Category:イタリアの歌手
Mudell:Rquote	Template:Rquote
Kategorija:Mietu fl-1546	Category:1546年没
Kategorija:1724	Category:1724年
Kategorija:1748	Category:1748年
Kategorija:1749	Category:1749年
Kategorija:1750	Category:1750年
Kategorija:Mietu fl-1750	Category:1750年没
Kategorija:1756	Category:1756年
Kategorija:1757	Category:1757年
Kategorija:1758	Category:1758年
Kategorija:1759	Category:1759年
Kategorija:1760	Category:1760年
Kategorija:1770	Category:1770年
Kategorija:1772	Category:1772年
Kategorija:1773	Category:1773年
Kategorija:1782	Category:1782年
Kategorija:1786	Category:1786年
Kategorija:1791	Category:1791年
Kategorija:Mietu fl-1791	Category:1791年没
Kategorija:1792	Category:1792年
Kategorija:Mietu fl-1792	Category:1792年没
Kategorija:1794	Category:1794年
Kategorija:1801	Category:1801年
Kategorija:1803	Category:1803年
Kategorija:1804	Category:1804年
Kategorija:Mietu fl-1804	Category:1804年没
Kategorija:1807	Category:1807年
Kategorija:Mietu fl-1807	Category:1807年没
Kategorija:1809	Category:1809年
Kategorija:1813	Category:1813年
Kategorija:1815	Category:1815年
Kategorija:1818	Category:1818年
Kategorija:Mietu fl-1818	Category:1818年没
Kategorija:Mietu fl-1821	Category:1821年没
Kategorija:1827	Category:1827年
Kategorija:Mietu fl-1828	Category:1828年没
Kategorija:1830	Category:1830年
Kategorija:Mietu fl-1832	Category:1832年没
Kategorija:1835	Category:1835年
Kategorija:1840	Category:1840年
Kategorija:1842	Category:1842年
Kategorija:Mietu fl-1842	Category:1842年没
Kategorija:1846	Category:1846年
Kategorija:1847	Category:1847年
Kategorija:Mietu fl-1847	Category:1847年没
Kategorija:1848	Category:1848年
Kategorija:1849	Category:1849年
Kategorija:1852	Category:1852年
Kategorija:1853	Category:1853年
Kategorija:1854	Category:1854年
Kategorija:1859	Category:1859年
Kategorija:Mietu fl-1859	Category:1859年没
Kategorija:1860	Category:1860年
Kategorija:1861	Category:1861年
Kategorija:Mietu fl-1861	Category:1861年没
Kategorija:1862	Category:1862年
Kategorija:1864	Category:1864年
Kategorija:1866	Category:1866年
Kategorija:1869	Category:1869年
Kategorija:Mietu fl-1869	Category:1869年没
Kategorija:1870	Category:1870年
Kategorija:1871	Category:1871年
Kategorija:1872	Category:1872年
Kategorija:Mietu fl-1873	Category:1873年没
Kategorija:1874	Category:1874年
Kategorija:1875	Category:1875年
Kategorija:1876	Category:1876年
Kategorija:1877	Category:1877年
Kategorija:1879	Category:1879年
Kategorija:1880	Category:1880年
Kategorija:1881	Category:1881年
Kategorija:1882	Category:1882年
Kategorija:1883	Category:1883年
Kategorija:1884	Category:1884年
Kategorija:1885	Category:1885年
Kategorija:1886	Category:1886年
Kategorija:1887	Category:1887年
Kategorija:1889	Category:1889年
Kategorija:1890	Category:1890年
Kategorija:Mietu fl-1890	Category:1890年没
Kategorija:1891	Category:1891年
Kategorija:1892	Category:1892年
Kategorija:1893	Category:1893年
Kategorija:Mietu fl-1893	Category:1893年没
Kategorija:1894	Category:1894年
Kategorija:Mietu fl-1894	Category:1894年没
Kategorija:1895	Category:1895年
Kategorija:Mietu fl-1895	Category:1895年没
Kategorija:1897	Category:1897年
Kategorija:Mietu fl-1897	Category:1897年没
Kategorija:Mietu fl-1898	Category:1898年没
Kategorija:1899	Category:1899年
Kategorija:Mietu fl-1900	Category:1900年没
Kategorija:Mietu fl-1901	Category:1901年没
Kategorija:Mietu fl-1905	Category:1905年没
Kategorija:Mietu fl-1915	Category:1915年没
Kategorija:Mietu fl-1916	Category:1916年没
Kategorija:Mietu fl-1917	Category:1917年没
Kategorija:Mietu fl-1918	Category:1918年没
Kategorija:Mietu fl-1920	Category:1920年没
Kategorija:Mietu fl-1921	Category:1921年没
Kategorija:Mietu fl-1925	Category:1925年没
Kategorija:Mietu fl-1926	Category:1926年没
Kategorija:Mietu fl-1927	Category:1927年没
Kategorija:Mietu fl-1935	Category:1935年没
Kategorija:Mietu fl-1936	Category:1936年没
Kategorija:Mietu fl-1939	Category:1939年没
Kategorija:Mietu fl-1940	Category:1940年没
Kategorija:Mietu fl-1954	Category:1954年没
Kategorija:1961	Category:1961年
Kategorija:1964	Category:1964年
Kategorija:Mietu fl-1964	Category:1964年没
Kategorija:1965	Category:1965年
Kategorija:1966	Category:1966年
Kategorija:1967	Category:1967年
Kategorija:Mietu fl-1967	Category:1967年没
Kategorija:Mietu fl-1968	Category:1968年没
Kategorija:1969	Category:1969年
Kategorija:1970	Category:1970年
Kategorija:Mietu fl-1970	Category:1970年没
Kategorija:Mietu fl-1971	Category:1971年没
Kategorija:1972	Category:1972年
Kategorija:Mietu fl-1972	Category:1972年没
Kategorija:1973	Category:1973年
Kategorija:Mietu fl-1973	Category:1973年没
Kategorija:1974	Category:1974年
Kategorija:1975	Category:1975年
Kategorija:1976	Category:1976年
Kategorija:Mietu fl-1977	Category:1977年没
Kategorija:1978	Category:1978年
Kategorija:1979	Category:1979年
Kategorija:1980	Category:1980年
Kategorija:1981	Category:1981年
Kategorija:1982	Category:1982年
Kategorija:Mietu fl-1982	Category:1982年没
Kategorija:1983	Category:1983年
Kategorija:Mietu fl-1983	Category:1983年没
Kategorija:1984	Category:1984年
Kategorija:Mietu fl-1984	Category:1984年没
Kategorija:1985	Category:1985年
Kategorija:1986	Category:1986年
Kategorija:1987	Category:1987年
Kategorija:Mietu fl-1987	Category:1987年没
Kategorija:1988	Category:1988年
Kategorija:1989	Category:1989年
Kategorija:Mietu fl-1989	Category:1989年没
Kategorija:1990	Category:1990年
Kategorija:Mietu fl-1990	Category:1990年没
Kategorija:1991	Category:1991年
Kategorija:1992	Category:1992年
Kategorija:1993	Category:1993年
Kategorija:1994	Category:1994年
Kategorija:1995	Category:1995年
Kategorija:Mietu fl-1995	Category:1995年没
Kategorija:Fußball-Bundesliga	Category:サッカー・ブンデスリーガ (ドイツ)
Kategorija:1996	Category:1996年
Kategorija:Mietu fl-1996	Category:1996年没
Kategorija:1997	Category:1997年
Kategorija:Mietu fl-1997	Category:1997年没
Kategorija:1999	Category:1999年
Kategorija:2000	Category:2000年
Kategorija:Mietu fl-2000	Category:2000年没
Kategorija:2001	Category:2001年
Kategorija:Mietu fl-2001	Category:2001年没
Kategorija:2002	Category:2002年
Kategorija:Mietu fl-2002	Category:2002年没
Kategorija:Mietu fl-2003	Category:2003年没
Kategorija:2004	Category:2004年
Kategorija:Mietu fl-2004	Category:2004年没
Kategorija:2005	Category:2005年
Kategorija:2006	Category:2006年
Kategorija:Mietu fl-2006	Category:2006年没
Kategorija:2007	Category:2007年
Kategorija:2008	Category:2008年
Kategorija:2009	Category:2009年
Kategorija:2010	Category:2010年
Kategorija:2011	Category:2011年
Kategorija:Ajruporti skont il-pajjiż	Category:各国の空港
Kategorija:Pajjiżi gżejjer	Category:島国
Kategorija:Pajjiżi interkjużi	Category:内陸国
Kategorija:Ġurnalisti Franċiżi	Category:フランスのジャーナリスト
Kategorija:Storja tal-futbol	Category:サッカーの歴史
Kategorija:Grawnds tal-futbol fl-Italja	Category:イタリアのサッカー競技施設
Kategorija:Futbol fil-Gambja	Category:ガンビアのサッカー
Kategorija:Futbol fil-Greċja	Category:ギリシャのサッカー
Kategorija:Futbol fin-Niġerja	Category:ナイジェリアのサッカー
Kategorija:Futbol fl-Afrika t'Isfel	Category:南アフリカのサッカー
Kategorija:Futbol fil-Latvja	Category:ラトビアのサッカー
Kategorija:Futbol fir-Rumanija	Category:ルーマニアのサッカー
Kategorija:Futbol fil-Litwanja	Category:リトアニアのサッカー
Kategorija:Futbol fil-Montenegro	Category:モンテネグロのサッカー
Kategorija:Futbol f'Malta	Category:マルタのサッカー
Kategorija:Futbol fl-Istati Uniti	Category:アメリカ合衆国のサッカー
Kategorija:Futbol fil-Belġju	Category:ベルギーのサッカー
Kategorija:Futbol fil-Bożnija u Ħerżegovina	Category:ボスニア・ヘルツェゴビナのサッカー
Kategorija:Futbol fil-Bulgarija	Category:ブルガリアのサッカー
Kategorija:Futbol fis-Serbja	Category:セルビアのサッカー
Kategorija:Futbol fl-Unjoni Sovjetika	Category:ソビエト連邦のサッカー
Kategorija:Timijiet parteċipanti fit-Tazza tad-Dinja tal-Futbol	Category:FIFAワールドカップ参加チーム
Kategorija:Futbol fl-Iżvizzera	Category:スイスのサッカー
Kategorija:Futbol fl-Iskozja	Category:スコットランドのサッカー
Kategorija:Futbol fis-Slovakkja	Category:スロバキアのサッカー
Kategorija:Futbol fl-Arġentina	Category:アルゼンチンのサッカー
Kategorija:Futbol fl-Iżlanda	Category:アイスランドのサッカー
Kategorija:Futbol fl-Irlanda	Category:アイルランドのサッカー
Kategorija:Futbol fl-Albanija	Category:アルバニアのサッカー
Kategorija:Futbol fl-Angola	Category:アンゴラのサッカー
Kategorija:Futbol fl-Estonja	Category:エストニアのサッカー
Kategorija:Futbol fl-Awstralja	Category:オーストラリアのサッカー
Kategorija:Futbol f'Wales	Category:ウェールズのサッカー
Kategorija:Futbol fl-Iżrael	Category:イスラエルのサッカー
Kategorija:Futbol fiċ-Ċina	Category:中国のサッカー
Kategorija:Futbol fil-Kamerun	Category:カメルーンのサッカー
Kategorija:Futbol fil-Kosta tal-Avorju	Category:コートジボワールのサッカー
Kategorija:Futbol f'Ċipru	Category:キプロスのサッカー
Mudell:Utent be	Template:User be
Mudell:Utent ga-2	Template:User ga-2
Mudell:Utent hu-1	Template:User hu-1
Mudell:Utent ru-1	Template:User ru-1
Mudell:Utent tr-1	Template:User tr-1
Mudell:Utent uk-4	Template:User uk-4
Mudell:Utent zh-1	Template:User zh-1
Kategorija:Poeti skont in-nazzjonalità	Category:各国の詩人
Kategorija:Mużiċisti skont in-nazzjonalità	Category:各国の音楽家
Kategorija:Skulturi skont in-nazzjonalità tagħhom	Category:各国の彫刻家
Kategorija:Filosfi skont in-nazzjonalità	Category:各国の哲学者
Kategorija:Vulkani skont il-pajjiż	Category:各国の火山
Kategorija:Storja ta' Malta	Category:マルタの歴史
Mudell:Dati pajjiż Beliże	Template:Country data Belize
Kategorija:Futbol fil-Gana	Category:ガーナのサッカー
Kategorija:Futbol fl-Olanda	Category:オランダのサッカー
Kategorija:Futbol fin-Norveġja	Category:ノルウェーのサッカー
Kategorija:Futbol fil-Ġermanja	Category:ドイツのサッカー
Kategorija:Futbol fil-Bjelorussja	Category:ベラルーシのサッカー
Kategorija:Futbol fl-Irlanda ta' Fuq	Category:北アイルランドのサッカー
Kategorija:Futbol fil-Brażil	Category:ブラジルのサッカー
Kategorija:Futbol fl-Armenja	Category:アルメニアのサッカー
Kategorija:Futbol fl-Ażerbajġan	Category:アゼルバイジャンのサッカー
Kategorija:Futbol fl-Awstrija	Category:オーストリアのサッカー
Kategorija:Futbol fl-Urugwaj	Category:ウルグアイのサッカー
Kategorija:Futbol fl-Italja	Category:イタリアのサッカー
Mudell:Dati pajjiż Jugożlavja	Template:Country data Yugoslavia
Kategorija:Futbol fl-Ingilterra	Category:イングランドのサッカー
Kategorija:Futbol fir-Repubblika Ċeka	Category:チェコのサッカー
Kategorija:Futbol fil-Każakistan	Category:カザフスタンのサッカー
Kategorija:Futbol fil-Kolombja	Category:コロンビアのサッカー
Kategorija:Futbol fit-Turkija	Category:トルコのサッカー
Kategorija:Futbol fil-Portugall	Category:ポルトガルのサッカー
Kategorija:Futbol fl-Ungerija	Category:ハンガリーのサッカー
Mudell:TwoLegResult	Template:TwoLegResult
Kategorija:Festival tal-Eurovision	Category:ユーロビジョン・ソング・コンテスト
Kategorija:Kowċis Arġentini	Category:アルゼンチンのサッカー指導者
Kategorija:Kowċis Awstrijaċi	Category:オーストリアのサッカー指導者
Kategorija:Kowċis Belġjani	Category:ベルギーのサッカー指導者
Kategorija:Kowċis Brażiljani	Category:ブラジルのサッカー指導者
Kategorija:Kowċis Ingliżi	Category:イングランドのサッカー指導者
Kategorija:Kowċis Skoċċiżi	Category:スコットランドのサッカー指導者
Kategorija:Teatru	Category:演劇
Kategorija:Kowċis Kroati	Category:クロアチアのサッカー指導者
Kategorija:Kowċis Ġermaniżi	Category:ドイツのサッカー指導者
Mudell:Dati pajjiż Kosovo	Template:Country data Kosovo
Kategorija:Kantanti skont in-nazzjonalità	Category:各国の歌手
Kategorija:Kowċis Rumeni	Category:ルーマニアのサッカー指導者
Kategorija:Kowċis Spanjoli	Category:スペインのサッカー指導者
Kategorija:Futbolers Albaniżi	Category:アルバニアのサッカー選手
Kategorija:Futbolers Angoliżi	Category:アンゴラのサッカー選手
Kategorija:Futbolers Arġentini	Category:アルゼンチンのサッカー選手
Kategorija:Futbolers Armeni	Category:アルメニアのサッカー選手
Kategorija:Futbolers Awstraljani	Category:オーストラリアのサッカー選手
Kategorija:Futbolers Awstrijaċi	Category:オーストリアのサッカー選手
Kategorija:Immaġini tal-Creative Commons Attribution-ShareAlike 2.5	Category:クリエイティブ・コモンズ 表示 - 継承 2.5の画像
Kategorija:Futbolers Bożnijaċi	Category:ボスニア・ヘルツェゴビナのサッカー選手
Kategorija:Futbolers Brażiljani	Category:ブラジルのサッカー選手
Kategorija:Futbolers Ingliżi	Category:イングランドのサッカー選手
Kategorija:Mudelli ta' diżambigwazzjoni u riindirizzi	Category:曖昧さ回避テンプレート
Mudell:Dati pajjiż Abkażja	Template:Country data Abkhazia
Mudell:Newtrali	Template:ニュートラル
Kategorija:Kantanti Żvediżi	Category:スウェーデンの歌手
Kategorija:Kantanti Iżlandiżi	Category:アイスランドの歌手
Kategorija:Kantanti Iżraeljani	Category:イスラエルの歌手
Kategorija:Kantanti Pollakki	Category:ポーランドの歌手
Kategorija:Kantanti Franċiżi	Category:フランスの歌手
Mudell:Dati pajjiż Aruba	Template:Country data Aruba
Kategorija:Utenti nl	Category:User nl
Kategorija:Ekonomisti Russi	Category:ロシアの経済学者
Kategorija:Utenti nn-3	Category:User nn-3
Kategorija:Utenti no-2	Category:User no-2
Kategorija:Utenti no	Category:User no
Kategorija:Utenti zh-1	Category:User zh-1
Kategorija:Armenja	Category:アルメニア
Kategorija:Fiżiċi Brittaniċi	Category:イギリスの物理学者
Mudell:Dati pajjiż Antigwa u Barbuda	Template:Country data Antigua and Barbuda
Mudell:Dati pajjiż Stati Federati tal-Mikroneżja	Template:Country data Federated States of Micronesia
Kategorija:Atturi Taljani	Category:イタリアの俳優
Kategorija:Finanza	Category:金融
Kategorija:Diskografiji	Category:ディスコグラフィ
Kategorija:Kompetizzjonijiet tal-futbol	Category:サッカー大会
Kategorija:Sports għal persuni b'diżabbilità	Category:障害者スポーツ
Kategorija:Sports ta' studenti	Category:大学スポーツ
Kategorija:Rumanziera Spanjoli	Category:スペインの小説家
Kategorija:Sports ta' ġewwa	Category:インドアスポーツ
Kategorija:Televiżjoni	Category:テレビ
Kategorija:Mietu fl-1945	Category:1945年没
Kategorija:Mietu fl-1963	Category:1963年没
Kategorija:1832	Category:1832年
Kategorija:Mietu fl-1930	Category:1930年没
Kategorija:1822	Category:1822年
Kategorija:Skulturi	Category:彫刻家
Kategorija:Seklu 14	Category:14世紀
Kategorija:Sekli	Category:世紀
Kategorija:Seklu 13	Category:13世紀
Kategorija:Seklu 16	Category:16世紀
Kategorija:Seklu 12	Category:12世紀
Kategorija:Seklu 18	Category:18世紀
Kategorija:Kompożituri Russi	Category:ロシアの作曲家
Kategorija:Kompożituri Franċiżi	Category:フランスの作曲家
Kategorija:Kompożituri Barokki	Category:バロックの作曲家
Kategorija:Kompożituri Pollakki	Category:ポーランドの作曲家
Kategorija:Kompożituri Ġermaniżi	Category:ドイツの作曲家
Kategorija:Kompożituri Awstrijaċi	Category:オーストリアの作曲家
Kategorija:Mużiċisti Pollakki	Category:ポーランドのミュージシャン
Kategorija:Skulturi Taljani	Category:イタリアの彫刻家
Kategorija:Storiċi Russi	Category:ロシアの歴史学者
Kategorija:Mużiċisti Norveġiżi	Category:ノルウェーのミュージシャン
Kategorija:Mużiċisti Daniżi	Category:デンマークのミュージシャン
Kategorija:Mużiċisti Russi	Category:ロシアのミュージシャン
Kategorija:Mużiċisti Brażiljani	Category:ブラジルのミュージシャン
Kategorija:Mużiċisti Żvediżi	Category:スウェーデンのミュージシャン
Kategorija:Mużiċisti Irlandiżi	Category:アイルランドのミュージシャン
Kategorija:Mużiċisti Brittaniċi	Category:イギリスのミュージシャン
Kategorija:Mużiċisti Taljani	Category:イタリアのミュージシャン
Kategorija:Mużiċisti Ġeorġjani	Category:グルジアのミュージシャン
Kategorija:Mużiċisti Kanadiżi	Category:カナダのミュージシャン
Kategorija:Mużiċisti Franċiżi	Category:フランスのミュージシャン
Kategorija:1829	Category:1829年
Kategorija:Kompożituri Rumeni	Category:ルーマニアの作曲家
Kategorija:Kompożituri Taljani	Category:イタリアの作曲家
Kategorija:Mużiċisti Ġermaniżi	Category:ドイツのミュージシャン
Kategorija:Politiċi Maltin	Category:マルタの政治家
Kategorija:Politiċi Taljani	Category:イタリアの政治家
Kategorija:Politiċi Franċiżi	Category:フランスの政治家
Kategorija:Filosfi Griegi	Category:ギリシャの哲学者
Kategorija:Filosfi Ġermaniżi	Category:ドイツの哲学者
Kategorija:Filosfi Brittaniċi	Category:イギリスの哲学者
Kategorija:Bavarja	Category:バイエルン
Kategorija:Futbolers Niġerjani	Category:ナイジェリアのサッカー選手
Kategorija:Futbolers Rumeni	Category:ルーマニアのサッカー選手
Kategorija:Futbolers Bulgari	Category:ブルガリアのサッカー選手
Kategorija:Futbolers Żvediżi	Category:スウェーデンのサッカー選手
Kategorija:Futbolers Skoċċiżi	Category:スコットランドのサッカー選手
Kategorija:.NET	Category:.NET Framework
Kategorija:Futbolers Ekwadorjani	Category:エクアドルのサッカー選手
Kategorija:Futbolers Urugwajani	Category:ウルグアイのサッカー選手
Kategorija:Futbolers Eġizzjani	Category:エジプトのサッカー選手
Kategorija:Futbolers Ċiniżi	Category:中国のサッカー選手
Kategorija:Futbolers Franċiżi	Category:フランスのサッカー選手
Kategorija:Teorija tal-logħob	Category:ゲーム理論
Kategorija:1789	Category:1789年
Kategorija:Mietu fl-1809	Category:1809年没
Kategorija:1821	Category:1821年
Kategorija:1828	Category:1828年
Kategorija:1841	Category:1841年
Kategorija:1867	Category:1867年
Kategorija:1873	Category:1873年
Kategorija:1878	Category:1878年
Kategorija:1896	Category:1896年
Kategorija:1963	Category:1963年
Kategorija:Mietu fl-1981	Category:1981年没
Kategorija:Mietu fl-1999	Category:1999年没
Kategorija:2012	Category:2012年
Kategorija:Sportivi Sud-Koreani	Category:韓国のスポーツ選手
Kategorija:Imprendituri Amerikani	Category:アメリカ合衆国の実業家
Kategorija:Inventuri Brittaniċi	Category:イギリスの発明家
Kategorija:Futbolers Torok	Category:トルコのサッカー選手
Kategorija:Futbolers Montenegrini	Category:モンテネグロのサッカー選手
Kategorija:Futbolers Żvizzeri	Category:スイスのサッカー選手
Kategorija:Futbolers Spanjoli	Category:スペインのサッカー選手
Kategorija:Futbolers Ungeriżi	Category:ハンガリーのサッカー選手
Kategorija:Futbolers Serbi	Category:セルビアのサッカー選手
Kategorija:Futbolers Taljani	Category:イタリアのサッカー選手
Kategorija:Futbolers Daniżi	Category:デンマークのサッカー選手
Kategorija:Futbolers Galliċi	Category:ウェールズのサッカー選手
Kategorija:Futbolers Nord-Irlandiżi	Category:北アイルランドのサッカー選手
Kategorija:Futbolers Irlandiżi	Category:アイルランドのサッカー選手
Kategorija:Futbolers Kolombjani	Category:コロンビアのサッカー選手
Kategorija:Futbolers Kroati	Category:クロアチアのサッカー選手
Kategorija:Futbolers Portugiżi	Category:ポルトガルのサッカー選手
Kategorija:Kantanti Norveġiżi	Category:ノルウェーの歌手
Kategorija:Kantanti Brażiljani	Category:ブラジルの歌手
Kategorija:Kantanti Russi	Category:ロシアの歌手
Kategorija:Kantanti Daniżi	Category:デンマークの歌手
Kategorija:Denominazzjonijiet Kristjani	Category:キリスト教の教派
Kategorija:Kategoriji ta' abbozzi	Category:スタブカテゴリ
Kategorija:Abbozzi tat-trasport	Category:交通スタブ
Kategorija:Abbozzi tal-militar	Category:軍事関連のスタブ
Kategorija:Abbozzi tal-matematika	Category:数学関連のスタブ項目
Kategorija:Abbozzi tal-bijoloġija	Category:生物学関連のスタブ項目
Kategorija:Abbozzi tal-ġeografija	Category:世界地理関連のスタブ項目
Kategorija:Abbozzi ta' ikel u xorb	Category:食文化関連のスタブ項目
Kategorija:Seklu 15	Category:15世紀
Kategorija:Mietu fis-seklu 16	Category:16世紀没
Kategorija:Mietu fis-seklu 17	Category:17世紀没
Kategorija:Mietu fis-seklu 18	Category:18世紀没
Kategorija:Mietu fis-seklu 19	Category:19世紀没
Kategorija:Mietu fis-seklu 20	Category:20世紀没
Kategorija:Mietu fis-seklu 21	Category:21世紀没
Kategorija:Futbol fi New Zealand	Category:ニュージーランドのサッカー
Kategorija:Futbol fil-Messiku	Category:メキシコのサッカー
Kategorija:Futbol fl-Iżvezja	Category:スウェーデンのサッカー
Kategorija:Futbol fl-Ukrajna	Category:ウクライナのサッカー
Kategorija:Futbol fil-Kroazja	Category:クロアチアのサッカー
Kategorija:Futbol fi Franza	Category:フランスのサッカー
Kategorija:Ġeorġja	Category:グルジア
Kategorija:Kantanti Amerikani	Category:アメリカ合衆国の歌手
Kategorija:Bijoloġi Brittaniċi	Category:イギリスの生物学者
Kategorija:Naturalisti Brittaniċi	Category:イギリスの博物学者
Kategorija:Mużiċisti Żvizzeri	Category:スイスのミュージシャン
Kategorija:Mużiċisti Armeni	Category:アルメニアのミュージシャン
Kategorija:Mużiċisti Ażerbajġani	Category:アゼルバイジャンのミュージシャン
Kategorija:Mużiċisti Iżraeljani	Category:イスラエルのミュージシャン
Kategorija:Ġeoloġi Brittaniċi	Category:イギリスの地質学者
Kategorija:Futbolers Ganiżi	Category:ガーナのサッカー選手
Kategorija:1727	Category:1727年
Kategorija:1744	Category:1744年
Kategorija:1808	Category:1808年
Kategorija:1824	Category:1824年
Kategorija:Mietu fl-1835	Category:1835年没
Kategorija:Mietu fl-1868	Category:1868年没
Kategorija:Mietu fl-1888	Category:1888年没
Kategorija:Mietu fl-1933	Category:1933年没
Kategorija:Mietu fl-1961	Category:1961年没
Kategorija:1968	Category:1968年
Kategorija:Futbol fir-Russja	Category:ロシアのサッカー
Kategorija:Futbol fl-Ekwador	Category:エクアドルのサッカー
Kategorija:Futbol fl-Eġittu	Category:エジプトのサッカー
Mudell:Dati pajjiż Repubblika Ċentru-Afrikana	Template:Country data Central African Republic
Kategorija:Kantanti Torok	Category:トルコの歌手
Kategorija:Plejers ta' FC Spartak Moscow	Category:スパルタク・モスクワの選手
Kategorija:Futbol fl-Andorra	Category:アンドラのサッカー
Kategorija:Nies Maltin	Category:マルタの人物
Kategorija:Matematiċi Brittaniċi	Category:イギリスの数学者
Mudell:Infobox Eurovision	Template:Infobox Eurovision
Kategorija:Mużiċisti Belġjani	Category:ベルギーのミュージシャン
Kategorija:Futbolers Gambjani	Category:ガンビアのサッカー選手
Kategorija:Futbolers Griegi	Category:ギリシャのサッカー選手
Kategorija:Futbolers Sud-Afrikani	Category:南アフリカのサッカー選手
Kategorija:Futbolers Litwani	Category:リトアニアのサッカー選手
Kategorija:Futbolers Maċedoni	Category:マケドニア共和国のサッカー選手
Kategorija:Futbolers Maltin	Category:マルタのサッカー選手
Kategorija:Futbolers Senegaliżi	Category:セネガルのサッカー選手
Kategorija:Futbolers Iżlandiżi	Category:アイスランドのサッカー選手
Kategorija:Futbolers Iżraeljani	Category:イスラエルのサッカー選手
Kategorija:Futbolers Kamerunjani	Category:カメルーンのサッカー選手
Kategorija:1817	Category:1817年
Kategorija:1898	Category:1898年
Kategorija:1998	Category:1998年
Mudell:Klassifika tal-futbol tmiem	Template:Fb cl footer
Kategorija:Libanu	Category:レバノン
Kategorija:Mietu fis-seklu 15	Category:15世紀没
Kategorija:Kantanti Ġermaniżi	Category:ドイツの歌手
Kategorija:Kantanti Belġjani	Category:ベルギーの歌手
Kategorija:Mużiċisti Iżlandiżi	Category:アイスランドのミュージシャン
Kategorija:Kompożituri Irlandiżi	Category:アイルランドの作曲家
Kategorija:Futbolers Messikani	Category:メキシコのサッカー選手
Kategorija:2003	Category:2003年
Kategorija:Mietu fis-seklu 14	Category:14世紀没
Kategorija:Futbol fid-Danimarka	Category:デンマークのサッカー
Kategorija:Mudelli tal-Unjoni Ewropea	Category:欧州連合関連のテンプレート
Kategorija:Xjenzati Brittaniċi	Category:イギリスの学者
Kategorija:Mudelli tal-klabbs tal-futbol Taljani	Category:イタリアのサッカークラブテンプレート
Kategorija:Mudelli ta' tħassir	Category:削除関連のテンプレート
Kategorija:1971	Category:1971年
Kategorija:Mietu fis-seklu 13	Category:13世紀没
Kategorija:Mudelli kkumplikati	Category:複雑なテンプレート
Mudell:Isem tal-lingwa	Template:ISO639言語名
Kategorija:Mudelli għall-kulur tat-test	Category:テキスト色テンプレート
Kategorija:Abbozzi tal-politika	Category:政治関連のスタブ項目
Kategorija:Abbozzi tal-astronomija	Category:天文学関連のスタブ項目
Kategorija:Abbozzi tal-istorja	Category:歴史関連のスタブ項目
Kategorija:Abbozzi tal-arti	Category:美術関連のスタブ項目
Kategorija:Abbozzi tar-reliġjon	Category:宗教スタブ
Mudell:Utent de-4	Template:User de-4
Kategorija:Abbozzi tat-teknoloġija	Category:工学関連のスタブ
Kategorija:Abbozzi tal-ekonomija	Category:経済関連のスタブ項目
Kategorija:Futbol Asjatiku	Category:アジアのサッカー
Kategorija:Futbol fl-Afrika	Category:アフリカのサッカー
Kategorija:Futbol fl-Amerika t'Isfel	Category:南アメリカのサッカー
Kategorija:Futbol fl-Ewropa	Category:ヨーロッパのサッカー
Kategorija:Futbol fl-Oċeanja	Category:オセアニアのサッカー
Kategorija:Plejers ta' PSV Eindhoven	Category:PSVアイントホーフェンの選手
Kategorija:Plejers ta' Aston Villa FC	Category:アストン・ヴィラFCの選手
Kategorija:Plejers ta' CA Osasuna	Category:CAオサスナの選手
Kategorija:Plejers ta' AFC Ajax	Category:アヤックス・アムステルダムの選手
Kategorija:Plejers ta' MSV Duisburg	Category:MSVデュイスブルクの選手
Kategorija:Plejers ta' Empoli FC	Category:エンポリFCの選手
Kategorija:Plejers ta' Eintracht Braunschweig	Category:アイントラハト・ブラウンシュヴァイクの選手
Kategorija:Futbolers fil-Bulgarija skont il-klabb	Category:ブルガリアのクラブに所属するサッカー選手
Kategorija:Plejers ta' Red Star Belgrade	Category:レッドスター・ベオグラードの選手
Kategorija:Plejers ta' FC Basel	Category:FCバーゼルの選手
Kategorija:Plejers ta' Bayer 04 Leverkusen	Category:バイエル・レバークーゼンの選手
Kategorija:Plejers ta' Birmingham City FC	Category:バーミンガム・シティFCの選手
Kategorija:Plejers ta' Blackburn Rovers FC	Category:ブラックバーン・ローヴァーズFCの選手
Kategorija:Plejers ta' VfL Bochum	Category:VfLボーフムの選手
Kategorija:Plejers ta' Portsmouth FC	Category:ポーツマスFCの選手
Kategorija:Plejers ta' Borussia Dortmund	Category:ボルシア・ドルトムントの選手
Kategorija:Plejers ta' Bolton Wanderers FC	Category:ボルトン・ワンダラーズFCの選手
Kategorija:Plejers ta' Piacenza Calcio	Category:ピアチェンツァ・カルチョの選手
Kategorija:Plejers ta' Charlton Athletic FC	Category:チャールトン・アスレティックFCの選手
Kategorija:Plejers ta' Torino FC	Category:トリノFCの選手
Kategorija:Plejers ta' Genoa CFC	Category:ジェノアCFCの選手
Kategorija:Plejers ta' FC Dynamo Moscow	Category:ディナモ・モスクワの選手
Kategorija:Plejers ta' Stade de Reims	Category:スタッド・ランスの選手
Kategorija:Plejers ta' Racing de Santander	Category:ラシン・サンタンデールの選手
Kategorija:Plejers ta' Real Valladolid	Category:レアル・バリャドリードの選手
Kategorija:Plejers ta' R. Charleroi SC	Category:シャルルロワSCの選手
Kategorija:Plejers ta' Sporting de Gijón	Category:スポルティング・デ・ヒホンの選手
Kategorija:Plejers ta' RCD Mallorca	Category:RCDマヨルカの選手
Kategorija:Plejers ta' Recreativo de Huelva	Category:レクレアティーボ・ウェルバの選手
Kategorija:Plejers ta' FC Zürich	Category:FCチューリッヒの選手
Kategorija:Plejers ta' UC Sampdoria	Category:UCサンプドリアの選手
Kategorija:Plejers ta' Santos Futebol Clube	Category:サントスFCの選手
Kategorija:Plejers ta' São Paulo Futebol Clube	Category:サンパウロFCの選手
Kategorija:Plejers ta' Sporting Clube de Portugal	Category:スポルティング・リスボンの選手
Kategorija:Plejers ta' Stoke City FC	Category:ストーク・シティFCの選手
Kategorija:Plejers ta' Sunderland AFC	Category:サンダーランドAFCの選手
Kategorija:Plejers ta' VfB Stuttgart	Category:VfBシュトゥットガルトの選手
Kategorija:Plejers ta' Sheffield Wednesday FC	Category:シェフィールド・ウェンズデイFCの選手
Kategorija:Plejers ta' Sheffield United FC	Category:シェフィールド・ユナイテッドFCの選手
Kategorija:Plejers ta' Grêmio Foot-Ball Porto Alegrense	Category:グレミオの選手
Kategorija:Plejers ta' KAA Gent	Category:KAAヘントの選手
Mudell:Dati pajjiż Wales	Template:Country data Wales
Kategorija:Plejers ta' Fluminense Football Club	Category:フルミネンセFCの選手
Kategorija:Plejers ta' Fulham FC	Category:フラムFCの選手
Kategorija:Plejers ta' Cagliari Calcio	Category:カリアリ・カルチョの選手
Kategorija:Plejers ta' AS Cannes	Category:ASカンヌの選手
Kategorija:Plejers ta' 1. FC Kaiserslautern	Category:1.FCカイザースラウテルンの選手
Kategorija:Futbolers fi Spanja skont il-klabb	Category:スペインのクラブに所属するサッカー選手
Kategorija:Futbolers fl-Iskozja skont il-klabb	Category:スコットランドのクラブに所属するサッカー選手
Kategorija:Futbolers fil-Portugall skont il-klabb	Category:ポルトガルのクラブに所属するサッカー選手
Kategorija:Futbolers fl-Ungerija skont il-klabb	Category:ハンガリーのクラブに所属するサッカー選手
Kategorija:Futbolers fir-Russja skont il-klabb	Category:ロシアのクラブに所属するサッカー選手
Kategorija:Futbolers fir-Rumanija skont il-klabb	Category:ルーマニアのクラブに所属するサッカー選手
Mudell:MONTHABBREV	Template:MONTHABBREVEN
Kategorija:Plejers ta' Cruzeiro Esporte Clube	Category:クルゼイロECの選手
Kategorija:Plejers ta' KV Kortrijk	Category:KVコルトレイクの選手
Kategorija:Plejers ta' Queens Park Rangers FC	Category:クイーンズ・パーク・レンジャーズFCの選手
Kategorija:Imwiet skont is-sena	Category:没年
Mudell:Dati pajjiż Papwa Ginea Ġdida	Template:Country data Papua New Guinea
Kategorija:Plejers ta' US Lecce	Category:USレッチェの選手
Kategorija:San Marino	Category:サンマリノ
Kategorija:Liechtenstein	Category:リヒテンシュタイン
Kategorija:Andorra	Category:アンドラ
Kategorija:Serbja	Category:セルビア
Kategorija:Pajjiżi skont il-kontinent	Category:大陸別の国
Kategorija:Albanija	Category:アルバニア
Kategorija:Pajjiżi tal-Karibew	Category:カリブの国
Kategorija:Pajjiżi tal-Oċeanja	Category:オセアニアの国
Kategorija:Pajjiżi tal-Amerika ta' Fuq	Category:北アメリカの国
Kategorija:Klabbs tal-futbol Litwani	Category:リトアニアのサッカークラブ
Kategorija:Plejers ta' Modena FC	Category:モデナFCの選手
Kategorija:Plejers ta' AC Monza Brianza 1912	Category:ACモンツァ・ブリアンツァ1912の選手
Kategorija:Plejers ta' SSC Napoli	Category:SSCナポリの選手
Kategorija:Plejers ta' Calcio Padova	Category:カルチョ・パドヴァの選手
Kategorija:Plejers ta' Perugia Calcio	Category:ペルージャ・カルチョの選手
Kategorija:Plejers ta' Burnley FC	Category:バーンリーFCの選手
Kategorija:Plejers ta' Getafe CF	Category:ヘタフェCFの選手
Kategorija:Plejers ta' Swansea City AFC	Category:スウォンジ・シティAFCの選手
Kategorija:Plejers ta' Villarreal CF	Category:ビジャレアルCFの選手
Kategorija:Plejers ta' Málaga CF	Category:マラガの選手
Kategorija:Plejers ta' Watford FC	Category:ワトフォードFCの選手
Kategorija:Plejers ta' Novara Calcio	Category:ノヴァーラ・カルチョの選手
Kategorija:Plejers ta' Newcastle United FC	Category:ニューカッスル・ユナイテッドFCの選手
Kategorija:Plejers ta' Hannover 96	Category:ハノーファー96の選手
Kategorija:Plejers ta' Huddersfield Town FC	Category:ハダースフィールド・タウンFCの選手
Kategorija:Plejers ta' Hertha BSC	Category:ヘルタ・ベルリンの選手
Kategorija:Plejers ta' Hellas Verona FC	Category:エラス・ヴェローナの選手
Kategorija:Plejers ta' Wigan Athletic FC	Category:ウィガン・アスレティックFCの選手
Kategorija:Plejers ta' West Bromwich Albion FC	Category:ウェスト・ブロムウィッチ・アルビオンFCの選手
Kategorija:Rebbieħa tal-Festival tal-Eurovision	Category:ユーロビジョン・ソング・コンテスト優勝者
Kategorija:Referis tal-futbol skond in-nazzjonalita	Category:各国のサッカー審判員
Kategorija:Referis tal-futbol Ingliżi	Category:イングランドのサッカー審判員
Kategorija:Referis tal-futbol Taljani	Category:イタリアのサッカー審判員
Kategorija:Plejers ta' FC Barcelona	Category:FCバルセロナの選手
Kategorija:Plejers ta' Valencia CF	Category:バレンシアCFの選手
Kategorija:Plejers ta' Liverpool FC	Category:リヴァプールFCの選手
Kategorija:Plejers ta' FC Bayern Munich	Category:バイエルン・ミュンヘンの選手
Kategorija:Plejers ta' Manchester City FC	Category:マンチェスター・シティFCの選手
Kategorija:Plejers ta' Atlético Madrid	Category:アトレティコ・マドリードの選手
Kategorija:Plejers ta' Arsenal FC	Category:アーセナルFCの選手
Kategorija:Plejers ta' FC Porto	Category:FCポルトの選手
Kategorija:Plejers ta' AS Roma	Category:ASローマの選手
Kategorija:Kampjonati tal-futbol nazzjonali	Category:国内の最上位サッカーリーグ
Kategorija:Timijiet nazzjonali tal-futbol	Category:サッカーのナショナルチーム
Kategorija:Rivisti tal-logħob	Category:ゲーム雑誌
Kategorija:Reġjuni tal-Ewropa	Category:ヨーロッパの地域
Kategorija:Vulkani tal-Italja	Category:イタリアの火山
Kategorija:Oċeani	Category:大洋
Kategorija:Antropoloġija	Category:人類学
Kategorija:Pajjiżi stabbiliti fl-1801	Category:1801年に設立された州・地域
Kategorija:Pajjiżi stabbiliti fl-1803	Category:1803年に設立された州・地域
Kategorija:Bliet tal-Veneżwela	Category:ベネズエラの都市
Mudell:Tim ta' Inter Milan	Template:インテルナツィオナーレ・ミラノのメンバー
Kategorija:Repubbliki	Category:共和国
Kategorija:Chelsea FC	Category:チェルシーFC
Kategorija:Arsenal FC	Category:アーセナルFC
Kategorija:Liverpool FC	Category:リヴァプールFC
Kategorija:Inter Milan	Category:インテルナツィオナーレ・ミラノ
Kategorija:Manchester United FC	Category:マンチェスター・ユナイテッドFC
Kategorija:AC Milan	Category:ACミラン
Kategorija:Blackburn Rovers FC	Category:ブラックバーン・ローヴァーズFC
Kategorija:Klabbs tal-futbol Olandiżi	Category:オランダのサッカークラブ
Kategorija:Lagomorpha	Category:ウサギ目
Kategorija:Proboscidea	Category:長鼻目
Kategorija:Hyracoidea	Category:イワダヌキ目
Kategorija:Kantanti Albaniżi	Category:アルバニアの歌手
Kategorija:Kantanti Rumeni	Category:ルーマニアの歌手
Kategorija:Kontestanti fil-Festival tal-Eurovision	Category:ユーロビジョン・ソング・コンテスト参加者
Kategorija:Pajjiżi tal-Amerika t'Isfel	Category:南アメリカの国
Kategorija:Abbozzi tal-isport	Category:スポーツ関連のスタブ項目
Kategorija:Timijiet nazzjonali tal-futbol Ażjatiċi	Category:アジアのサッカーナショナルチーム
Kategorija:Timijiet nazzjonali tal-futbol Afrikani	Category:アフリカのサッカーナショナルチーム
Kategorija:Timijiet nazzjonali li m'għadhomx jeżistu	Category:消滅したサッカーのナショナルチーム
Kategorija:Teoristi	Category:理論家
Kategorija:Staġuni tas-Serie A	Category:セリエA (サッカー) シーズン
Kategorija:Klabbs tal-futbol tal-Andorra	Category:アンドラのサッカークラブ
Kategorija:Analisi matematika	Category:解析学
Kategorija:Sirenia	Category:海牛目
Kategorija:Mitoloġija Griega	Category:ギリシア神話
Kategorija:Bliet kapitali	Category:首都
Kategorija:Avvenimenti	Category:事件
Kategorija:HIV/AIDS	Category:HIV/AIDS
Kategorija:Tazza Ażjatika tal-Futbol	Category:AFCアジアカップ
Kategorija:Mudelli tal-vetrina tal-Wikipedija	Category:秀逸なページ用のテンプレート
Kategorija:Filatelija	Category:郵趣
Kategorija:Arkeoloġija	Category:考古学
Kategorija:Astroloġija	Category:占星術
Kategorija:Logħob Olimpiku tas-sajf 2008	Category:北京オリンピック
Kategorija:Ho Chi Minh (belt)	Category:ホーチミン市
Kategorija:Elettriċità	Category:電気
Kategorija:Posta	Category:郵便
Kategorija:Utenti pl	Category:User pl
Kategorija:Trasport	Category:交通
Kategorija:Ir-Rivoluzzjoni Franċiża	Category:フランス革命
Kategorija:Żfin	Category:ダンス
Kategorija:Sports tat-timijiet	Category:団体競技
Kategorija:Ċaħdiet tal-Wikipedija	Category:ウィキペディアにおける免責事項
Kategorija:Teorija tal-grafi	Category:グラフ理論
Kategorija:Teorija tan-numri	Category:数論
Kategorija:Kantanti	Category:歌手
Kategorija:Futbolers	Category:サッカー選手
Kategorija:Matematiċi	Category:数学者
Kategorija:Futbolers fl-Italja skont il-klabb	Category:イタリアのクラブに所属するサッカー選手
Kategorija:Futbolers fl-Olanda skont il-klabb	Category:オランダのクラブに所属するサッカー選手
Kategorija:Futbolers fl-Ingilterra skont il-klabb	Category:イングランドのクラブに所属するサッカー選手
Kategorija:Futbolers skont il-klabb	Category:クラブごとにおけるサッカー選手
Mudell:Coord/dec2dms/d	Template:Coord/dec2dms/d
Mudell:Bandierapajjiż	Template:Flagcountry
Mudell:Tazza tad-Dinja tal-Klabbs Rawnd 6	Template:ClubWCRound6
Kategorija:Presidenti tal-Italja	Category:イタリア共和国の大統領
Kategorija:Kompetizzjonijiet tal-futbol fil-Ġermanja	Category:ドイツのサッカー大会
Kategorija:Sportivi	Category:スポーツ選手
Kategorija:Dermoptera	Category:皮翼目
Kategorija:Skultura	Category:彫刻
Kategorija:Montenegro	Category:モンテネグロ
Kategorija:Plejers ta' Everton FC	Category:エヴァートンFCの選手
Kategorija:Plejers ta' West Ham United FC	Category:ウェストハム・ユナイテッドFCの選手
Kategorija:Plejers ta' Manchester United FC	Category:マンチェスター・ユナイテッドFCの選手
Mudell:Hu	Template:Hu icon
Kategorija:Ewropa tat-Tramuntana	Category:北ヨーロッパ
Kategorija:Pajjiżi stabbiliti fl-1800	Category:1800年に設立された州・地域
Mudell:Utent ga-1	Template:User ga-1
Kategorija:Peramelemorphia	Category:バンディクート目
Mudell:G14	Template:ヨーロッパビッグクラブ連合体
Kategorija:Kultura tal-Veneżwela	Category:ベネズエラの文化
Kategorija:Bliet ta' Malta	Category:マルタの都市
Kategorija:Bliet tal-Vjetnam	Category:ベトナムの都市
Kategorija:Bliet kapitali fl-Ewropa	Category:ヨーロッパの首都
Kategorija:Plejers ta' Djurgårdens IF Fotboll	Category:ユールゴーデンIFの選手
Mudell:Dati pajjiż Renju tal-Bulgarija	Template:Country data Kingdom of Bulgaria
Kategorija:Sports tal-bord	Category:ボード系スポーツ
Kategorija:Logħob tal-ballun	Category:球技
Kategorija:Kittieba Maltin	Category:マルタの著作家
Kategorija:Ewropa tal-Punent	Category:西欧
Kategorija:Ewropa tan-Nofsinhar	Category:南欧
Kategorija:Mużiċisti Albaniżi	Category:アルバニアのミュージシャン
Kategorija:Storja tal-matematika	Category:数学史
Kategorija:Mudelli tal-klabbs tal-futbol Ingliżi	Category:イングランドのサッカークラブテンプレート
Kategorija:Gwida essenzjali tal-Wikipedija	Category:Wikipedia ガイドブック
Mudell:Żoni tal-ħin	Template:タイムゾーン
Kategorija:Plejers ta' Lille OSC	Category:LOSCリール・メトロポールの選手
Kategorija:Abbozzi tal-ambjent	Category:環境関連のスタブ項目
Kategorija:Abbozzi tal-lingwistika	Category:言語学関連のスタブ
Kategorija:Abbozzi tal-elettronika	Category:エレクトロニクス関連のスタブ
Kategorija:Plejers ta' Millwall FC	Category:ミルウォールFCの選手
Mudell:Fb-lemin	Template:Fb-rt
Kategorija:Etoloġi	Category:動物行動学者
Kategorija:Klabbs tal-futbol Belġjani	Category:ベルギーのサッカークラブ
Kategorija:Saħħa	Category:健康
Kategorija:Futbolers fil-Ġermanja skont il-klabb	Category:ドイツのクラブに所属するサッカー選手
Mudell:Fussballdaten	Template:Fussballdaten
Mudell:Dati pajjiż Spanja	Template:Country data Spain
Kategorija:Grawnds tal-futbol skont il-pajjiż	Category:各国のサッカー競技施設
Mudell:Dati pajjiż Kanada	Template:Country data Canada
Mudell:Klassifika tal-futbol bidu	Template:Fb cl header
Mudell:Tim ta' Club Brugge KV	Template:クラブ・ブルッヘのメンバー
Kategorija:Klabbs tal-futbol Russi	Category:ロシアのサッカークラブ
Mudell:Coord/prec dec	Template:Coord/prec dec
Mudell:Dati pajjiż Angwilla	Template:Country data Anguilla
Mudell:Dati pajjiż Barbados	Template:Country data Barbados
Mudell:Dati pajjiż Bermuda	Template:Country data Bermuda
Mudell:Dati pajjiż Gżejjer Verġni Brittaniċi	Template:Country data British Virgin Islands
Mudell:Dati pajjiż Burma	Template:Country data Burma
Mudell:Dati pajjiż Gżejjer Kokos	Template:Country data Cocos (Keeling) Islands
Mudell:Dati pajjiż Komunità tal-Istati Indipendenti	Template:Country data Commonwealth of Independent States
Mudell:Dati pajjiż Reġjun Fjamming	Template:Country data Flemish Region
Mudell:Dati pajjiż Renju tal-Jugożlavja	Template:Country data Kingdom of Yugoslavia
Mudell:Dati pajjiż Martinika	Template:Country data Martinique
Mudell:Dati pajjiż Antilli Olandiżi	Template:Country data Netherlands Antilles
Mudell:Dati pajjiż Singapor	Template:Country data Singapore
Kategorija:Mudelli tat-timijiet tat-Tazza tal-Konfederazzjonijiet 2009	Category:FIFAコンフェデレーションズカップ2009のテンプレート
Kategorija:Mudelli tal-klabbs tal-futbol Belġjani	Category:ベルギーのサッカークラブテンプレート
Kategorija:Mudelli tal-klabbs tal-futbol Ġermaniżi	Category:ドイツのサッカークラブテンプレート
Kategorija:Mudelli tal-klabbs tal-futbol Spanjoli	Category:スペインのサッカークラブテンプレート
Mudell:Utent pl-4	Template:User pl-4
Kategorija:Abbozzi tax-xjenza	Category:自然科学関連のスタブ項目
Kategorija:Plejers ta' US Avellino	Category:ASアヴェッリーノ1912の選手
Kategorija:Plejers ta' Albacete Balompié	Category:アルバセテの選手
Kategorija:Plejers ta' SC Rheindorf Altach	Category:ラインドルフ・アルタッハの選手
Kategorija:Plejers ta' Royal Antwerp FC	Category:ロイヤル・アントワープの選手
Kategorija:Plejers ta' FC Aarau	Category:FCアーラウの選手
Kategorija:Plejers ta' Brighton & Hove Albion FC	Category:ブライトン・アンド・ホーヴ・アルビオンFCの選手
Kategorija:Plejers ta' Bristol City FC	Category:ブリストル・シティFCの選手
Kategorija:Plejers ta' RKC Waalwijk	Category:RKCヴァールヴァイクの選手
Kategorija:Isqfijiet Taljani	Category:イタリアの司教
Kategorija:Plejers ta' Wellington Phoenix FC	Category:ウェリントン・フェニックスFCの選手
Kategorija:Plejers ta' Chivas de Guadalajara	Category:グアダラハラの選手
Kategorija:Plejers ta' KRC Genk	Category:KRCヘンクの選手
Kategorija:Plejers ta' Defensor Sporting Club	Category:デフェンソール・スポルティングの選手
Kategorija:Plejers ta' Beerschot AC	Category:ゲルミナル・ベールショットの選手
Kategorija:Plejers ta' SV Zulte Waregem	Category:ズルテ・ワレヘムの選手
Kategorija:Plejers ta' FC Crotone	Category:FCクロトーネの選手
Kategorija:Plejers ta' KSC Lokeren Oost-Vlaanderen	Category:スポルティング・ロケレンの選手
Kategorija:Plejers ta' PFC Lokomotiv Sofia	Category:ロコモティフ・ソフィアの選手
Kategorija:Plejers ta' AC Lugano	Category:ACルガーノの選手
Kategorija:Plejers ta' Luton Town FC	Category:ルートン・タウンFCの選手
Kategorija:Plejers ta' Lierse SK	Category:リールセSKの選手
Kategorija:Plejers ta' FC Lucerne	Category:FCルツェルンの選手
Kategorija:Plejers ta' Manisaspor	Category:マニサスポルの選手
Kategorija:Plejers ta' KV Mechelen	Category:KVメヘレンの選手
Kategorija:Plejers ta' RAEC Mons	Category:RAECモンスの選手
Kategorija:Plejers ta' CD Nacional	Category:CDナシオナルの選手
Kategorija:Plejers ta' AC Omonia	Category:オモニア・ニコシアの選手
Kategorija:Plejers ta' SK Rapid Wien	Category:ラピード・ウィーンの選手
Kategorija:Plejers ta' Rimini Calcio FC	Category:リミニ・カルチョFCの選手
Kategorija:Plejers ta' FC St. Gallen	Category:ザンクト・ガレンの選手
Kategorija:Plejers ta' FK Sarajevo	Category:FKサラエヴォの選手
Kategorija:Plejers ta' Servette FC	Category:セルヴェットFCの選手
Kategorija:Plejers ta' Cercle Brugge KSV	Category:サークル・ブルッヘの選手
Kategorija:Plejers ta' Standard Liège	Category:スタンダール・リエージュの選手
Kategorija:Plejers ta' FC Sion	Category:FCシオンの選手
Kategorija:Plejers ta' Ferencváros TC	Category:フェレンツヴァーロシュの選手
Kategorija:Plejers ta' Hibernian FC	Category:ハイバーニアンの選手
Kategorija:Plejers ta' Hull City AFC	Category:ハル・シティAFCの選手
Kategorija:Plejers ta' SD Eibar	Category:エイバルの選手
Kategorija:Plejers ta' El Nacional	Category:エル・ナシオナルの選手
Kategorija:Plejers ta' BSC Young Boys	Category:BSCヤングボーイズの選手
Kategorija:Plejers ta' Sociedade Esportiva e Recreativa Caxias do Sul	Category:SERカシアス・ド・スルの選手
Kategorija:Plejers ta' PFC CSKA Sofia	Category:CSKAソフィアの選手
Portal:Matematika	Portal:数学
Kategorija:Mużiċisti Litwani	Category:リトアニアのミュージシャン
Kategorija:Kompożituri Iżlandiżi	Category:アイスランドの作曲家
Timijiet parteċipanti fit-Tazza tad-Dinja tal-Futbol 2006	2006 FIFAワールドカップ参加チーム
Kategorija:Lingwi Internazzjonali Awżiljari	Category:国際補助語
Mudell:Tim ta' RSC Anderlecht	Template:RSCアンデルレヒトのメンバー
Kategorija:William Shakespeare	Category:シェイクスピア
Kategorija:Wolverhampton Wanderers FC	Category:ウルヴァーハンプトン・ワンダラーズFC
Kategorija:Plejers ta' Galatasaray SK	Category:ガラタサライの選手
Kategorija:Mudelli tal-Festival tal-Eurovision	Category:ユーロビジョン・ソング・コンテスト関連のテンプレート
Kategorija:Mudelli tal-mużika	Category:音楽関連のテンプレート
Kategorija:Mudelli ta' protezzjoni	Category:保護テンプレート
Kategorija:Kantanti Armeni	Category:アルメニアの歌手
Mudell:Infobox Kulur	Template:Infobox color
Kategorija:Kompożituri	Category:作曲家
Kategorija:Macroscelididae	Category:長脚目
Kategorija:Futbolers f'Ċipru skont il-klabb	Category:キプロスのクラブに所属するサッカー選手
Mudell:Kampjonati tal-UEFA	Template:ヨーロッパのサッカーリーグ
Mudell:Kimika	Template:化学
Mudell:Pajjiżi tal-Eurovision	Template:Eurovision countries
Mudell:Skwadra Ġermaniża Kampjonati Ewropej tal-Futbol 2012	Template:UEFA欧州選手権2012ドイツ代表
Mudell:Skwadra Ġermaniża Tazza tad-Dinja tal-Futbol 2006	Template:2006 FIFAワールドカップドイツ代表
Mudell:Plejer tas-Sena tal-FIFA	Template:FIFA最優秀選手賞
Kategorija:Mudelli skont it-tip	Category:スタイル別のテンプレート
Kategorija:Mudelli semi-protetti	Category:編集半保護中のテンプレート
Mudell:Utent scn-3	Template:User scn-3
Mudell:Utent scn-2	Template:User scn-2
Mudell:Utent hi-2	Template:User hi-2
Kategorija:Artikli li jeħtieġu aġġornament	Category:情報の更新が必要とされている項目
Mudell:Utent ga	Template:User ga
Mudell:Suboff	Template:Suboff
Mudell:Sent off	Template:Sent off
Mudell:Oc	Template:Oc icon
Mudell:Mt	Template:Mt icon
Mudell:MLT	Template:MLT
Kategorija:Plejers ta' FC Dynamo Kyiv	Category:ディナモ・キエフの選手
Mudell:Dati pajjiż Prussja	Template:Country data Prussia
Mudell:Kontribuzzjonijiet utent	Template:User contrib
Kategorija:Tazza tad-Dinja tal-Futbol 2006	Category:2006 FIFAワールドカップ
Kategorija:Kwalifikazzjoni għat-Tazza tad-Dinja tal-Futbol 2010	Category:2010 FIFAワールドカップ 地区予選
Kategorija:Grawnds tal-futbol fil-Ġermanja	Category:ドイツのサッカー競技施設
Kategorija:Plejers ta' AC ChievoVerona	Category:ACキエーヴォ・ヴェローナの選手
Kategorija:Plejers ta' AFC Bournemouth	Category:AFCボーンマスの選手
Kategorija:ACF Fiorentina	Category:ACFフィオレンティーナ
Kategorija:Plejers ta' ACF Fiorentina	Category:ACFフィオレンティーナの選手
Kategorija:Plejers ta' AS Monaco FC	Category:ASモナコの選手
Kategorija:Plejers ta' AS Saint-Étienne	Category:ASサンテティエンヌの選手
Kategorija:Abbozzi tal-agrikoltura	Category:農業関連のスタブ項目
Kategorija:Federazzjonijiet tal-futbol	Category:サッカー運営団体
Kategorija:Plejers ta' Atalanta BC	Category:アタランタBCの選手
Kategorija:Kantanti Ażerbajġani	Category:アゼルバイジャンの歌手
Kategorija:Plejers ta' Barnsley FC	Category:バーンズリーFCの選手
Kategorija:Kantanti Bjelorussi	Category:ベラルーシの歌手
Mudell:Tim ta' Valencia CF	Template:バレンシアのメンバー
Kategorija:Plejers ta' Boca Juniors	Category:ボカ・ジュニアーズの選手
Kategorija:Borussia Dortmund	Category:ボルシア・ドルトムント
Mudell:Dati pajjiż Gwadelup	Template:Country data Guadeloupe
Kategorija:Referis tal-futbol Brażiljani	Category:ブラジルのサッカー審判員
Mudell:TOCleft	Template:TOCleft
Kategorija:Abbozzi tal-edukazzjoni	Category:教育に関するスタブ
Kategorija:Plejers ta' Eintracht Frankfurt	Category:アイントラハト・フランクフルトの選手
Kategorija:Empoli FC	Category:エンポリFC
Kategorija:Plejers Ewropej tas-Sena	Category:バロンドール受賞者
Kategorija:Edizzjonijiet tal-Festival tal-Eurovision	Category:各年のユーロビジョン・ソング・コンテスト
Kategorija:FC Barcelona	Category:FCバルセロナ
Kategorija:FC Bayern Munich	Category:バイエルン・ミュンヘン
Kategorija:Plejers ta' FC Girondins de Bordeaux	Category:FCジロンダン・ボルドーの選手
Kategorija:Plejers ta' FC Lausanne-Sport	Category:ローザンヌ・スポルトの選手
Kategorija:Plejers ta' FC Schalke 04	Category:シャルケの選手
Kategorija:Plejers ta' FC Sochaux-Montbéliard	Category:FCソショーの選手
Kategorija:Plejers ta' FC Thun	Category:トゥーンの選手
Kategorija:Plejers ta' FC Utrecht	Category:FCユトレヒトの選手
Kategorija:Tazza tad-Dinja tal-Futbol tal-Klabbs	Category:FIFAクラブワールドカップ
Kategorija:Tazza tad-Dinja tal-Futbol	Category:FIFAワールドカップ
Kategorija:Plejers tas-Sena tal-FIFA	Category:FIFA年間最優秀選手賞受賞者
Kategorija:Plejers ta' FK Partizan	Category:パルチザン・ベオグラードの選手
Kategorija:Klabbs tal-futbol Armeni	Category:アルメニアのサッカークラブ
Kategorija:Klabbs tal-futbol Awstrijaċi	Category:オーストリアのサッカークラブ
Kategorija:Klabbs tal-futbol Bożnijaċi	Category:ボスニア・ヘルツェゴビナのサッカークラブ
Kategorija:Klabbs tal-futbol Estonjani	Category:エストニアのサッカークラブ
Kategorija:Klabbs tal-futbol Iżraeljani	Category:イスラエルのサッカークラブ
Kategorija:Klabbs tal-futbol Serbi	Category:セルビアのサッカークラブ
Kategorija:Futbol fil-Korea t'Isfel	Category:韓国のサッカー
Kategorija:Grawnds tal-futbol fil-Belġju	Category:ベルギーのサッカー競技施設
Kategorija:Futbolers fl-Arġentina skont il-klabb	Category:アルゼンチンのクラブに所属するサッカー選手
Kategorija:Futbolers fil-Belġju skont il-klabb	Category:ベルギーのクラブに所属するサッカー選手
Kategorija:Futbolers fil-Bożnija u Ħerżegovina skont il-klabb	Category:ボスニア・ヘルツェゴビナのクラブに所属するサッカー選手
Kategorija:Futbolers fil-Brażil skont il-klabb	Category:ブラジルのクラブに所属するサッカー選手
Kategorija:Futbolers fl-Ekwador skont il-klabb	Category:エクアドルのクラブに所属するサッカー選手
Kategorija:Futbolers fi Franza skont il-klabb	Category:フランスのクラブに所属するサッカー選手
Kategorija:Futbolers fil-Greċja skont il-klabb	Category:ギリシャのクラブに所属するサッカー選手
Kategorija:Futbolers fl-Iżrael skont il-klabb	Category:イスラエルのクラブに所属するサッカー選手
Kategorija:Futbolers fil-Messiku skont il-klabb	Category:メキシコのクラブに所属するサッカー選手
Kategorija:Futbolers fin-Norveġja skont il-klabb	Category:ノルウェーのクラブに所属するサッカー選手
Kategorija:Futbolers fis-Serbja skont il-klabb	Category:セルビアのクラブに所属するサッカー選手
Kategorija:Futbolers fil-Korea t'Isfel skont il-klabb	Category:韓国のクラブに所属するサッカー選手
Kategorija:Futbolers fl-Iżvezja skont il-klabb	Category:スウェーデンのクラブに所属するサッカー選手
Kategorija:Futbolers fl-Iżvizzera skont il-klabb	Category:スイスのクラブに所属するサッカー選手
Kategorija:Futbolers fit-Turkija skont il-klabb	Category:トルコのクラブに所属するサッカー選手
Kategorija:Futbolers fl-Urugwaj skont il-klabb	Category:ウルグアイのクラブに所属するサッカー選手
Kategorija:Mudelli ta' kwotazzjoni	Category:引用文テンプレート
Mudell:Preċiżjoni1	Template:Precision1
Mudell:Preċiżjoni/tz/1	Template:Precision/tz/1
Kategorija:Plejers ta' Grasshopper-Club Zürich	Category:グラスホッパーの選手
Kategorija:Plejers ta' Hamburger SV	Category:ハンブルガーSVの選手
Kategorija:Plejers ta' Inter Milan	Category:インテルナツィオナーレ・ミラノの選手
Kategorija:Plejers ta' Ipswich Town FC	Category:イプスウィッチ・タウンFCの選手
Kategorija:Irlanda	Category:アイルランド島
Għajnuna:Kronoloġija	Help:履歴
Kategorija:Festival tal-Eurovision taż-Żgħar	Category:ジュニア・ユーロビジョン・ソング・コンテスト
Kategorija:Plejers ta' Juventus FC	Category:ユヴェントスFCの選手
Kategorija:KRC Genk	Category:KRCヘンク
Kategorija:Plejers ta' Kyoto Purple Sanga	Category:京都パープルサンガの選手
Kategorija:Plejers ta' Larissa FC	Category:AEL 1964の選手
Kategorija:Plejers ta' Legia Warszawa	Category:レギア・ワルシャワの選手
Portal:Kimika	Portal:化学
Kategorija:Abbozzi tal-letteratura	Category:文学関連のスタブ
Kategorija:Kompożituri Maltin	Category:マルタの作曲家
Kategorija:Poeti Maltin	Category:マルタの詩人
Għajnuna:Verżjoni għall-ipprintjar	Help:印刷用バージョン
Kategorija:RSC Anderlecht	Category:RSCアンデルレヒト
Kategorija:Plejers ta' RSC Anderlecht	Category:RSCアンデルレヒトの選手
Kategorija:Abbozzi tal-mediċina	Category:医学関連のスタブ項目
Kategorija:Plejers ta' RC Strasbourg	Category:RCストラスブールの選手
Kategorija:Plejers ta' Racing Club	Category:ラシン・クラブの選手
Kategorija:Mikelanġlu	Category:ミケランジェロ・ブオナローティ
Kategorija:Plejers ta' Real Madrid CF	Category:レアル・マドリードの選手
Kategorija:Plejers ta' Real Zaragoza	Category:レアル・サラゴサの選手
Kategorija:Modena FC	Category:モデナFC
Kategorija:Mużiċisti Montenegrini	Category:モンテネグロのミュージシャン
Kategorija:Plejers ta' NEC Nijmegen	Category:NECナイメヘンの選手
Kategorija:Plejers ta' River Plate	Category:CAリーベル・プレートの選手
Kategorija:Kompożituri Romantiċi	Category:ロマン派の作曲家
Kategorija:Plejers ta' Rosario Central	Category:ロサリオ・セントラルの選手
Kategorija:SSC Napoli	Category:SSCナポリ
Kategorija:Plejers ta' SS Lazio	Category:SSラツィオの選手
Kategorija:Abbozzi tas-sesswalità	Category:性科学に関するスタブ項目
Kategorija:Abbozzi tal-filosofija	Category:哲学関連のスタブ項目
Kategorija:Plejers ta' SC Heerenveen	Category:SCヘーレンフェーンの選手
Kategorija:SK Rapid Wien	Category:SKラピード・ウィーン
Kategorija:Plejers ta' SV Werder Bremen	Category:ヴェルダー・ブレーメンの選手
Kategorija:Ortografija	Category:正書法
Kategorija:Plejers ta' PFC CSKA Moscow	Category:CSKAモスクワの選手
Kategorija:Pitturi ta' Pablo Picasso	Category:パブロ・ピカソの絵画
Kategorija:Plejers ta' Parma FC	Category:パルマFCの選手
Kategorija:Lingwi Semitiċi	Category:セム語派
Kategorija:Kantanti Ġeorġjani	Category:グルジアの歌手
Kategorija:Mużiċisti Slovakki	Category:スロバキアのミュージシャン
Kategorija:Kantanti Slovakki	Category:スロバキアの歌手
Kategorija:Futbolers fl-Istati Uniti skont il-klabb	Category:アメリカ合衆国のクラブに所属するサッカー選手
Kategorija:Grawnds tal-futbol fl-Afrika t'Isfel	Category:南アフリカのサッカー競技施設
Kategorija:Plejers ta' Sociedade Esportiva Palmeiras	Category:SEパルメイラスの選手
Kategorija:Referis tal-futbol Spanjoli	Category:スペインのサッカー審判員
Kategorija:Okkupazzjonijiet sportivi	Category:スポーツ関連の職業
Kategorija:Provinċja ta' Agrigento	Category:アグリジェント県
Kategorija:Provinċja ta' Kaltanissetta	Category:カルタニッセッタ県
Kategorija:Ludwig van Beethoven	Category:ベートーヴェン
Kategorija:Ateiżmu	Category:無神論
Kategorija:Plejers ta' Stade Rennais FC	Category:スタッド・レンヌFCの選手
Kategorija:Standard Liège	Category:スタンダール・リエージュ
Kategorija:Artikli fi traduzzjoni	Category:翻訳中途
Kategorija:Pajjiżi stabbiliti fl-1798	Category:1798年に設立された州・地域
Kategorija:Plejers ta' Swindon Town FC	Category:スウィンドン・タウンFCの選手
Kategorija:Edizzjonijiet tal-Kampjonati Ewropej tal-Futbol	Category:UEFA欧州選手権
Kategorija:Kompożituri Klassiċi	Category:クラシック音楽の作曲家
Mudell:Dati pajjiż Repubblika Għarbija Magħquda	Template:Country data United Arab Republic
Kategorija:Bolol	Category:切手
Kategorija:Xjenza Applikati	Category:応用科学
Kategorija:Għall-kontroll	Category:正確性
Kategorija:Ewropa Ċentrali	Category:中欧
Kategorija:Trattati tal-Unjoni Ewropea	Category:欧州連合基本条約
Kategorija:Futbol fil-Maċedonja	Category:マケドニア共和国のサッカー
Kategorija:Football League	Category:フットボールリーグ
Kategorija:Logħob tat-tfal	Category:子供の遊び
Kategorija:Provinċja ta' Bergamo	Category:ベルガモ県
Kategorija:Kantanti Bulgari	Category:ブルガリアの歌手
Mudell:Xjenzi soċjali	Template:社会科学のフッター
Kategorija:Provinċja ta' Lodi	Category:ローディ県
Kategorija:Kantanti Żvizzeri	Category:スイスの歌手
Kategorija:Plejers ta' Beşiktaş JK	Category:ベシクタシュの選手
Kategorija:Plejers ta' Chelsea FC	Category:チェルシーFCの選手
Kategorija:Plejers ta' Club Brugge KV	Category:クラブ・ブルージュの選手
Kategorija:Plejers ta' Coventry City FC	Category:コヴェントリー・シティFCの選手
Kategorija:Plejers ta' Neuchâtel Xamax	Category:ヌーシャテル・ザマックスの選手
Kategorija:Plejers ta' Nottingham Forest FC	Category:ノッティンガム・フォレストFCの選手
Kategorija:Plejers ta' Panathinaikos	Category:パナシナイコスFCの選手
Kategorija:Plejers ta' Paris Saint-Germain FC	Category:パリ・サンジェルマンFCの選手
Kategorija:Plejers ta' Tottenham Hotspur FC	Category:トッテナム・ホットスパーFCの選手
Kategorija:Plejers ta' VfL Wolfsburg	Category:VfLヴォルフスブルクの選手
Kategorija:Plejers ta' 1. FC Köln	Category:1.FCケルンの選手
Kategorija:Plejers ta' OGC Nice	Category:OGCニースの選手
Kategorija:Plejers ta' Olympique Lyonnais	Category:オリンピック・リヨンの選手
Kategorija:Pedagoġija	Category:教育学
Serie A 2013–14	セリエA (サッカー) 2013-2014
Kategorija:Preistorja	Category:先史時代
Kategorija:Drammi ta' William Shakespeare	Category:シェイクスピアの戯曲
Kategorija:Mużiċisti Torok	Category:トルコのミュージシャン
Kategorija:Mużiċisti Bjelorussi	Category:ベラルーシのミュージシャン
Kategorija:Mużiċisti Ċiprijotti	Category:キプロスのミュージシャン
Kategorija:Xogħol għaddej	Category:編集中の記事
Kategorija:Abbozzi tal-mitoloġija	Category:神話のスタブ項目
Kategorija:Abbozzi tal-arkitettura	Category:建築関連のスタブ項目
Kategorija:Artikli b'sezzjonijiet għall-espansjoni	Category:書きかけの節のある項目
Kategorija:Mudelli tal-Paġna prinċipali	Category:メインページ用テンプレート
Mudell:Infobox Gazzetta	Template:Infobox Newspaper
Mudell:IMSLP	Template:IMSLP
Kategorija:Klassifikazzjoni xjentifika	Category:科学的分類
Kategorija:Utenti en-1	Category:User en-1
Kategorija:Twieldu fl-1930	Category:1930年生
Kategorija:Twieldu fl-1946	Category:1946年生
Kategorija:Utenti de-1	Category:User de-1
Kategorija:Twieldu fl-1920	Category:1920年生
Kategorija:Twieldu fl-1956	Category:1956年生
Kategorija:Twieldu fl-1933	Category:1933年生
Kategorija:Twieldu fl-1911	Category:1911年生
Kategorija:Twieldu fl-1937	Category:1937年生
Kategorija:Twieldu fl-1948	Category:1948年生
Kategorija:Mudelli protetti	Category:編集保護中のテンプレート
Kategorija:Mietu fl-1978	Category:1978年没
Kategorija:Twieldu fl-1921	Category:1921年生
Kategorija:Twieldu fl-1924	Category:1924年生
Kategorija:Twieldu fl-1926	Category:1926年生
Kategorija:Twieldu fl-1950	Category:1950年生
Kategorija:Twieldu fl-1964	Category:1964年生
Kategorija:Atturi Amerikani	Category:アメリカ合衆国の俳優
Kategorija:Mietu fl-1979	Category:1979年没
Kategorija:Mietu fl-2010	Category:2010年没
Kategorija:Mużiċisti Rumeni	Category:ルーマニアのミュージシャン
Mudell:Fb cl2 header navbar	Template:Fb cl2 header navbar
Mudell:Nowrap begin	Template:Nowrap begin
Mudell:Soccerbase	Template:Soccerbase
Mudell:Tim ta' Sunderland AFC	Template:サンダーランドAFCのメンバー
Mudell:Tim ta' Borussia Dortmund	Template:ドルトムントのメンバー
Mudell:Tim ta' VfL Wolfsburg	Template:VfLヴォルフスブルクのメンバー
Mudell:Tim ta' SS Lazio	Template:SSラツィオのメンバー
Mudell:Fbf	Template:Fbw
Għajnuna:Żbalji komuni fl-użu tal-Wikipedija	Wikipedia:ウィキペディアでやってはいけないこと
Għajnuna:Medja	Help:音声・動画の再生
Mudell:Coord/negzeropad	Template:Coord/negzeropad
Wikipedija:Ċaħda medika	Wikipedia:医療に関する免責事項
Mudell:Kunsill Nordiku	Template:北欧理事会
Kategorija:Premier League	Category:FAプレミアリーグ
Mudell:Tim ta' Real Madrid CF	Template:レアル・マドリードのメンバー
Mudell:Nat fs player	Template:サッカーナショナルチーム選手一覧 選手
Għajnuna:Gwida essenzjali/Diskussjoni	Wikipedia:チュートリアル ノートページ
Għajnuna:Gwida essenzjali/Linji gwida	Wikipedia:チュートリアル 注意点
Mudell:Tim ta' Wigan Athletic FC	Template:ウィガン・アスレティックFCのメンバー
Mudell:Userbox-livell	Template:Userbox-level
Mudell:Tim ta' KRC Genk	Template:KRCヘンクのメンバー
Mudell:Football kit box	Template:Football kit box
Mudell:Nat fs g player	Template:サッカーナショナルチーム選手一覧 ゴール
Mudell:...	Template:Empty section
Mudell:Kunsilli lokali ta' Malta u Għawdex	Template:マルタの地方行政区画
Wikipedija:Wikipedija fis-sit tiegħek	Wikipedia:バナー
Mudell:Skwadra Spanjola Tazza tal-Konfederazzjonijiet 2009	Template:FIFAコンフェデレーションズカップ2009スペイン代表
Mudell:Skwadra Taljana Tazza tal-Konfederazzjonijiet 2009	Template:FIFAコンフェデレーションズカップ2009イタリア代表
Għajnuna:Gwida essenzjali/Konklużjoni	Wikipedia:チュートリアル まとめ
Mudell:Tim ta' Manchester City FC	Template:マンチェスター・シティFCのメンバー
Mudell:Leqstat	Template:Leqstat
Mudell:Infobox kompetizzjoni sportiva	Template:スポーツリーグ
Mudell:MSAPI	Template:Microsoft APIs
Mudell:Utent scn	Template:User scn
Mudell:Federazzjonijiet tal-UEFA	Template:ヨーロッパのサッカー協会
Mudell:Skwadra Slovena Tazza tad-Dinja tal-Futbol 2010	Template:2010 FIFAワールドカップスロベニア代表
Mudell:Tim ta' Liverpool FC	Template:リヴァプールFCのメンバー
Mudell:Tim ta' Birmingham City FC	Template:バーミンガム・シティFCのメンバー
Mudell:Tim ta' Hull City AFC	Template:ハル・シティAFCのメンバー
Mudell:Skwadra Eġizzjana Tazza tal-Konfederazzjonijiet 2009	Template:FIFAコンフェデレーションズカップ2009エジプト代表
Mudell:Tim ta' Aston Villa FC	Template:アストン・ヴィラFCのメンバー
Wikipedija:Ċaħda fuq il-kontenut	Wikipedia:内容に関する免責事項
Mudell:Lfpfr	Template:LFP.fr
Mudell:Tim ta' Tottenham Hotspur FC	Template:トッテナム・ホットスパーFCのメンバー
Mudell:Tim ta' Villareal CF	Template:ビジャレアルのメンバー
Wikipedija:VisualEditor	Wikipedia:ビジュアルエディター
Mudell:Tim ta' Paris Saint-Germain FC	Template:パリ・サンジェルマンFCのメンバー
Mudell:Skwadra Taljana Kampjonati Ewropej tal-Futbol 2012	Template:UEFA欧州選手権2012イタリア代表
Mudell:Gwida essenzjali	Wikipedia:チュートリアル/タブヘッダ
Premier League 2013–14	プレミアリーグ2013-2014
Kategorija:Abbozzi ta' logħob	Category:ゲーム関連のスタブ記事
Mudell:Tim ta' Standard Liège	Template:スタンダール・リエージュのメンバー
Mudell:Tim ta' Olympique Lyonnais	Template:リヨンのメンバー
Mudell:Tim ta' Fulham FC	Template:フラムFCのメンバー
Mudell:UEFA Jubilee Awards	Template:UEFAジュビリーアウォーズ
Mudell:Fb-kbira	Template:Fb-big
Mudell:Skwadra Brażiljana Tazza tal-Konfederazzjonijiet 2013	Template:FIFAコンフェデレーションズカップ2013ブラジル代表
Birdman (film)	バードマン あるいは（無知がもたらす予期せぬ奇跡）
Mudell:Skwadra Ġermaniża Kampjonati Ewropej tal-Futbol 2004	Template:UEFA EURO 2004ドイツ代表
Mudell:Hs	Template:Hs
Mudell:Infobox weather/line	Template:Infobox Weather/line
Mudell:Infobox Temp/kolp	Template:Infobox Weather/colp
Mudell:Infobox Temp/kolt	Template:Infobox Weather/colt
Mudell:Skwadra Taljana Tazza tal-Konfederazzjonijiet 2013	Template:FIFAコンフェデレーションズカップ2013イタリア代表
Edward Snowden	エドワード・スノーデン
Mudell:Rawnd16	Template:Round16
Mudell:VisualEditor	Template:VisualEditor Portal
Mudell:Dati pajjiż Kamerun	Template:Country data Cameroon
Speċjali:TibdilRiċenti	特別:最近の更新
Kategorija:Utenti ja-4	Category:User ja-4
Module:Navbox	モジュール:Navbox
Kategorija:Mietu fl-1976	Category:1976年没
Kategorija:Mietu fl-1975	Category:1975年没
Kategorija:Mietu fl-1974	Category:1974年没
Krimea	クリミア共和国
