Naakaii Łizhiní Bikéyah	アフリカ
Binaʼadaałtzózí Dinéʼiʼ Bikéyah	日本
Bitsiighaʼ Łichííʼí Bikéyah	アイルランド
Hángewii	ハンガリー
Dibé Diníí Bikéyah	スペイン
Wááshindoon Bikéyah Ałhidadiidzooígíí	アメリカ合衆国
Bélgii Bikéyah	ベルギー
Látsębooʼ	ルクセンブルク
Yágháhookáán	宇宙
Nahasdzáán	地球
Nahoditsʼǫʼłání	フィンランド
Déinish Dineʼé Bikéyah	デンマーク
Póolish Dineʼé Bikéyah	ポーランド
Łitʼoowę́ęya	リトアニア
Ídelii	イタリア
Swis Bikéyah	スイス
Óóswiya	オーストリア
Gwíík Dineʼé Bikéyah	ギリシャ
Tʼóok Bikéyah	トルコ
Béésh Bichʼahníí Bikéyah	ヨーロッパ
(*"asia")	アジア
Shádiʼááhjí kéyah yistinígíí	南極大陸
Kéyah Wóyahgo Siʼánígíí	オランダ
Béésh bee akʼeʼelchíhí tʼáá bí nitsékeesígíí	コンピュータ
Hastiin alą́ąjįʼ dahsidáhígíí Barack Obama	バラク・オバマ
Táłtłʼááh Chʼosh Bitooh (Kéyah Dah Siʼánígíí)	ウルグアイ
Bilasáana	リンゴ
Méhigo	メキシコ
Akééháshį́į́h Hahoodzo	カリフォルニア州
Máaz	火星
Kénya	ケニア
Iithiyópya	エチオピア
Gáana	ガーナ
Náshdóítsoh bitsiijįʼ daditłʼooígíí	ライオン
Dáághahii Dinéʼiʼ Bikéyah	フランス
Łééchąąʼí	イヌ
Tótaʼ Dinéʼiʼ Bikéyah	イギリス
Mósí	ネコ
Dáághahii bizaad	フランス語
Łóóʼ	魚類
Bwazííl	ブラジル
Biʼééʼ Łichííʼí Bikéyah	ロシア
Łóóʼtsoh dóó Tééh hóyáanii	クジラ目
Élábéemah Hahoodzo	アラバマ州
Béésh Bichʼahii Bikéyah	ドイツ
Bééshbichʼahii bizaad	ドイツ語
Tin Bikéyah	アイスランド
Ééstii Bikéyah	エストニア
Séetin	土星
Didzéchííʼ	サクランボ
Chidí naatʼaʼí	飛行機
Hastiin alą́ąjįʼ dahsidáhígíí George W. Bush	ジョージ・W・ブッシュ
Létbiiya	ラトビア
Yóókwein	ウクライナ
Chek Bikéyah	チェコ
Słóbaʼ Bikéyah	スロバキア
Słobíín Bikéyah	スロベニア
Wooméiniya	ルーマニア
Bálgaa Bikéyah	ブルガリア
Dziłigaii Bikéyah	アルバニア
Haʼaʼaahjí Hakʼaz Dineʼé Bikéyah	グリーンランド
Kwóóʼad Bikéyah	クロアチア
Bosna dóó Hetsog Bikéyah	ボスニア・ヘルツェゴビナ
Azééwii Bikéyah	アゼルバイジャン
Andówa	アンドラ
Béésh Łichíiʼii Bikéyah	キプロス
Jóojah (Kéyah)	グルジア
Kʼazah Bikéyah	カザフスタン
Dziłizhin Bikéyah	モンテネグロ
Bádikin Sídii	バチカン
San Mawínoo Bikéyah	サンマリノ
Kyóoba	キューバ
Hashkʼaan Bikéyah	バルバドス
Indoníízha	インドネシア
Tʼóok bizaad	トルコ語
Kéyah Naakai Łizhinii Bikéyah Shádiʼááhjí Siʼánígíí	南アフリカ共和国
Aljííya	アルジェリア
Ózbeʼ Bikéyah	ウズベキスタン
Tó	水
Níłchʼi naalkidí	テレビ
Chíilii	チリ
Doodaatsaahii (Jíísas)	イエス・キリスト
Mókiwii	水星
Ákáʼátʼįįł (béésh ntsékeesígíí álʼíní)	アップル インコーポレイテッド
Biinis	金星
Jíbitoo	木星
Yoowéinis	天王星
Néʼtoon	海王星
Sį́ʼgaboo	シンガポール
Tłóotoo	冥王星
Łííhtensain	リヒテンシュタイン
Dágháilchįįh	アドルフ・ヒトラー
Naaltsoos biniiʼ	Facebook
Naaki góneʼ yéigo daʼahijoogą́ą́ʼ	第二次世界大戦
Ałhíʼayiiltááh	数学
Aooméénii Bikéyah	アルメニア
Ooljééʼ	月
Nahatʼeʼiitsoh Bikéyah	オーストラリア
Béésh Łigaii Bikéyah	アルゼンチン
Kolíya Bikéyah Náhookǫsjí Siʼánígíí	朝鮮民主主義人民共和国
Naayééʼ	恐竜
Bilasáana bitseeʼ nineezígíí	ナシ属
Naturalis Historia of Pliny the Elder	博物誌
Encyclopædia Britannica	ブリタニカ百科事典
Tó yaʼnidaʼaazgééd	水道橋
Chʼil łitsooí díkʼǫ́zhígíí	レモン
Hashkʼaan (łitsooígíí)	バナナ
Sǫʼ	恒星
Jóhonaaʼéí	太陽
Háájiʼjin	水素
Níłchʼi Ászólí	ヘリウム
Haʼaʼaahjí Tíímow	東ティモール
Séwes	ケレス (準惑星)
Haʼooméya	ハウメア (準惑星)
Maakiimaakii	マケマケ (準惑星)
Ééwis	エリス (準惑星)
Káábin	炭素
Níłchʼi Yáʼátʼéehii	酸素
Hadoh dóó hakʼaz neiłkidígíí	温度計
Níłchʼi Łitsxooí	ネオン
Chihuahua Hahoodzo	チワワ州
Soodin	ナトリウム
Béésh Łikoní	マグネシウム
Béésh Ászólí	アルミニウム
Tó Wónaanídę́ę́ʼ Bitsįʼ Yishtłizhii Bikéyah	インド
Tʼoobááloo	ツバル
Béésh (Fe)	鉄
Tʼónga	トンガ
Łeetsoii	硫黄
Samóa	サモア
Sólomon Tó Bináhaazyínígíí	ソロモン諸島
Banoʼáátʼoo	バヌアツ
Páápowa Bigíní Ániidí	パプアニューギニア
Níłchʼi Dootłʼizhí	アルゴン
Eʼeʼaahjí Tónteel bikáaʼgi Kéyah Yázhí dah Ndaaʼeełgo Ałhidadiidzooígíí	ミクロネシア連邦
Káálsiiyin	カルシウム
Dilyį́hí	鉛
Kílíbas	キリバス
Chʼah Diʼilii Bikéyah	モンゴル国
Fííjii	フィジー
Béésh doo Ńdiniichxíihii	チタン
Táłkááʼ Bighan Dineʼé Bikéyah	ベネズエラ
Méíin Hahoodzo	メイン州
Łį́į́ʼ	ウマ
Naaldeehii	動物
Sówinam	スリナム
Kéyah Nahasdzáán Ałníiʼgi Siʼánígíí	エクアドル
Kolámbiya	コロンビア
Béésh Łibáhí	コバルト
Bolíbiya	ボリビア
Béésh Łichíiʼii	銅
Niihémpshoo Hahoodzo	ニューハンプシャー州
Chʼosh doo yitʼíinii dláádí dóó Ábishjaaʼ	菌類
Jaméíkʼa	ジャマイカ
Méésíchóoshish Hahoodzo	マサチューセッツ州
Kanédikiʼ Hahoodzo	コネチカット州
Naaʼahóóhai	ニワトリ
Antíígwa dóó Hashkʼaan Bikéyah Yázhí	アンティグア・バーブーダ
Kéyah Ałkéé Nitį́įgo Dah Ndaaʼeełí	ハワイ州
Damóo Bikéyah	ドミニカ国
Domingo Bikéyah	ドミニカ共和国
Bisóodi	ブタ
Héítii	ハイチ
Iiwą́ą́	イラン
Iiwááʼ	イラク
Hakʼaz Dineʼé Bikéyah Hahoodzo	アラスカ州
Ízrel Bikéyah	イスラエル
Shádiʼááhjí Ásáí Bikéyah	イエメン
Jóoʼdan	ヨルダン
Gah Bikeeʼ Taahíʼahí	フロリダ州
Kíígiz Bikéyah	キルギス
Hoozdo Hahoodzo	アリゾナ州
Kóóweiʼ	クウェート
Lááʼos	ラオス
Łíbanoo	レバノン
Óogin Hahoodzo	オレゴン州
Naakaii Dootłʼizhí Bikéyah Yázhí (Tó Bináhaazyínígíí)	モルディブ
Kéyah dah siʼánígíí	アメリカ州
Áshįįh Biiʼtó Hahoodzo	ユタ州
Béégashii	ウシ
Maléízha	マレーシア
Dziłgaiitsoh Honeezkʼazii Bikéyah	ネパール
Omą́ą́	オマーン
Eʼeʼaahjí Naakaii Dootłʼizhí Bikéyah	パキスタン
Kʼatár	カタール
Ásáí Bikéyah Saʼoodí	サウジアラビア
Swii Lankʼa	スリランカ
Sííwiya	シリア
Tʼajiʼ Bikéyah	タジキスタン
Tʼáí Bikéyah	タイ王国
Kǫʼ naʼałbąąsii diné bee nágéhéʼ	列車
Tʼóokmen Bikéyah	トルクメニスタン
Ásáí Bikéyah Yázhí Ałhidadiidzooígíí	アラブ首長国連邦
Biʼednam	ベトナム
Kolíya Bikéyah Shádiʼááhjí Siʼánígíí	大韓民国
Óola	金
Naʼałkaahí	科学者
Bangla Bikéyah	バングラデシュ
Angóola	アンゴラ
Iiʼniʼ Tłʼiishtsoh Bikéyah	ブータン
Bwoonéí	ブルネイ
Tʼanzanííya	タンザニア
Béésh Tózháanii	水銀
Kéyah Dańlíinii	フィリピン
Naakaii Łizhinii Bikéyah Beʼałnííʼ	中央アフリカ共和国
Hastiin Albert Einstein	アルベルト・アインシュタイン
Tʼóogo	トーゴ
Hooghan Tsé Bee Ádaalyaaí Bikéyah	ジンバブエ
Shádiʼááhjí Soodą́ą	南スーダン
Tswana Dineʼé Bikéyah	ボツワナ
Wóndii Dineʼé Bikéyah	ブルンジ
Ooljééʼ Bikéyah Yázhí	コモロ
Kéyah Káango Náhookǫsjí Siʼánígíí	コンゴ共和国
Kéyah Káango Shádiʼááhjí Siʼánígíí	コンゴ民主共和国
Jibótii	ジブチ
Gíní Nahasdzáán Ałníiʼgi Siʼánígíí	赤道ギニア
Gabǫ́ǫ́ (Kéyah)	ガボン
Géémbiya	ガンビア
Gíní	ギニア
Gíní Bisó	ギニアビサウ
Chį́į́h Yee Adilohii Bideeʼ Tónteel Bibąąh	コートジボワール
Táłtłʼááh Chʼosh Daadánígíí Bitooh (Łizhinii Bikéyahdi)	カメルーン
Tónteel Bibąąh Dootłʼizhí	カーボベルデ
Sotho Dineʼé Bikéyah	レソト
Łíbya	リビア
Madaʼgéésgáá	マダガスカル
Malááwii	マラウイ
Moowitéínya	モーリタニア
Moroko	モロッコ
Namííbya	ナミビア
Yogénda	ウガンダ
Wánda Dineʼé Bikéyah	ルワンダ
Seishel	セーシェル
Náshdóítsoh Bitsiijįʼ Daditłʼooʼígíí Bidził	シエラレオネ
Soomáálii Bikéyah	ソマリア
Soodą́ą	スーダン
Swáazi Dineʼé Bikéyah	スワジランド
Nahasdzáán Bikáaʼgi Kéyah Naaznilgo Ałhidadiidzooígíí	国際連合
Nidaashchʼąąʼígíí	色
Béésh Łigaii	銀
Béésh Dildǫʼí	スズ
Łéétsoh	ウラン
Hastiin alą́ąjįʼ dahsidáhígíí Bill Clinton	ビル・クリントン
Míshigin Hahoodzo	ミシガン州
Tó Nitsaa Nílį́bąąh Hahoodzo	イリノイ州
Náhookǫsjí Dzígaii	ノースダコタ州
Ałnííʼjí Dzígaii	サウスダコタ州
Ayání Naakaii Hahoodzo	モンタナ州
Tóʼííbézhí	ワイオミング州
Nímasii Kʼidadilyéhé	アイダホ州
Ahééhałtį́į́h Hahoodzo	ワシントン州
Naʼazhǫǫsh Hahoodzo	ネバダ州
Kayíbíyinsíí (tónteel)	カリブ海
Dibé Nitsaa Hahoodzo	コロラド州
Naakaii bizaad	スペイン語
Naʼashjéʼii	クモ
Chʼosh bijáád tseebíhígíí	クモ綱
Chʼosh bideeʼ ádaadinígíí	鋏角亜門
Chʼosh bijáád dahólónígíí	節足動物
Béeso	貨幣
Bijíniyah Hahoodzo	バージニア州
Eʼeʼaahjí Bijiniyah Hahoodzo	ウェストバージニア州
Kin Yótʼááh Deezʼá Hahoodzo	ニューヨーク州
Wóód Áalin Hahoodzo	ロードアイランド州
Chʼosh bijáád hastání	昆虫
Méelin Hahoodzo	メリーランド州
Déláwee Hahoodzo	デラウェア州
Oohááyoo Hahoodzo	オハイオ州
Pénsówéíniyah Hahoodzo	ペンシルベニア州
Niijéízii Hahoodzo	ニュージャージー州
Índíʼyéenah Hahoodzo	インディアナ州
Chidí	自動車
Jóojah Hahoodzo	ジョージア州
Akałii Bikéyah	テキサス州
Náhookǫsjí Kééláanah Hahoodzo	ノースカロライナ州
Shádiʼááhjí Kééláanah Hahoodzo	サウスカロライナ州
Méhigoʼ sídii	メキシコシティ
Bilasáana diwozhí	パイナップル
Mísísípii Hahoodzo	ミシシッピ州
Ténésii Hahoodzo	テネシー州
Yootó Hahoodzo	ニューメキシコ州
Mínisóodah Hahoodzo	ミネソタ州
Wiskaansin Hahoodzo	ウィスコンシン州
Haʼaʼaahjí Dzígaii	アイオワ州
Nabeeskah Hahoodzo	ネブラスカ州
Shádiʼááhjí Dzígaii	カンザス州
Tó Dzígaii Nílį́	ミズーリ州
Tónteel Chʼínílį́	ルイジアナ州
Kentákii Hahoodzo	ケンタッキー州
Dził Biiʼ Dzígaii	アーカンソー州
Halgai Hóteel Hahoodzo	オクラホマ州
Ho Chi Min Sídii	ホーチミン市
Bilagáana bizaad	英語
Náhookǫsjí Hakʼaz Dineʼé Bikéyah	ヌナブト準州
1901 – 1950	1902年
Tłʼiish	ヘビ
1951 – 2000	1979年
Pope Benedict XVI	ベネディクト16世 (ローマ教皇)
Maʼii Ashkii	ジェロニモ
Tsin naaʼeeł táłtłʼááh naagháhígíí	潜水艦
Tahoniigááh	インフルエンザ
Tłʼízí	ヤギ
Kǫʼ	火
Tʼááłáhági átʼéego:Templates	Category:ウィキペディアのテンプレート
Dloziłchííʼ	キタリス
Tʼááłáhági átʼéego:Bideeʼtsʼinígíí	Category:ウシ科
Tʼááłáhági átʼéego:Ndaaʼnaʼii	Category:有鱗目 (爬虫類)
Tiníléítsoh	コモドオオトカゲ
Chʼosh bijáád neeznánígíí	十脚目
Aymara bizaad	アイマラ語
Łeeyiʼ chʼoshtsoh binááʼ hólónígíí	アシナシイモリ
Tʼááłáhági átʼéego:Dééł dóó Tóidoozohii	Category:ツル目
Médíwííyin Sii	地中海
Jóojah (Ałtsʼáʼáztiin)	ジョージア
Alóós	米
Tsídii	鳥類
Kéłánii bikágí yilzhólígíí	有爪動物
Kéchwa bizaad	ケチュア語
Ínsadoobíídiiya	百科事典
Íiyisíí Naaltsoos	メインページ
Dziłgaiitsoh Honeezkʼazii	ヒマラヤ山脈
Tʼááłáhági átʼéego:Candidates for speedy deletion	Category:即時削除対象のページ
Chʼil ahwééh	茶
Adijiłii	ハリネズミ
Kéyah Sahééwa Eʼeʼaahjí Siʼánígíí	西サハラ
1801 – 1850	1815年
Łį́į́ʼ Bideeʼłáaʼii	ユニコーン
Hastiin Hernán Cortés	エルナン・コルテス
Tsʼíʼii daʼaneezí	カ
Dibé	ヒツジ
Łóóʼ hashkéhé	サメ
Ghą́ą́ʼaskʼidii	ラクダ
Bidił Daazdoígíí dóó Daʼałtʼoʼígíí	哺乳類
Bíchį́į́h yee adilohii	ゾウ
Mágí dóó Mágí Ndahalinígíí	サル目
(*wálá-)	アリ
Tsísʼná	ハナバチ
Naayízítsʼósí	ズッキーニ
Sęęschʼil	カリフラワー
Ayęęzhii yiltʼąąʼí	ナス
Naalʼeełí	カモ科
Yas	雪
Jádí dághaaʼígíí	ヌー
1851 – 1900	1865年
Biʼééʼ Łichííʼí bizaad	ロシア語
1751 – 1800	1784年
Bááh	パン
Bee Hazʼą́ą Ił Chʼétʼaah	世界人権宣言
Kéyah haʼdéísná	地震
Tó nitéél nitságoʼ atságáá	津波
Níyoltsoh	竜巻
Saad bee alʼį́į́hni	文字
Tʼááłáhági átʼéego:Dáághahii	Category:フランス
Mąʼii łitsooí	アカギツネ
Naaltéʼ	奴隷
Ahwééh	コーヒー
Abeʼ	乳
Dził	山
Doo Nidahałtingóó	砂漠
Cryptographic	暗号理論
Guadalajara	グアダラハラ (メキシコ)
Tsídii naʼałkʼaiʼí	ペンギン
Kolíya Dineʼé bizaad	朝鮮語
Gah	ウサギ
Tó niteel	大洋
Hodíłchʼil Níłtsánígíí	多雨林
HiTSʼezh	IPod
Hazéí	リス
Hazéí naatʼáʼii	モモンガ
Ééʼ néíshoodí	カトリック教会
Kwį́į́n Elizabeth II	エリザベス2世
Hastiin alą́ąjįʼ dahsidáhígíí Ronald Reagan	ロナルド・レーガン
Hastiin Emperor Yongle	永楽帝
Naʼashjéʼiitsoh	コモリグモ
Naaldlooshii dadichʼízhii	爬虫類
Tsin Deigházhígíí	ネズミ目
Hasbídí	ハト科
Tééh hóyáanii	ネズミイルカ科
Biyáázh Tsʼǫʼasánígíí (Táyiʼ dóó Niʼkáágóó Ndaakaaígíí)	両生類
Géeso	チーズ
Chʼil naʼatłʼoʼii (chʼiyáán)	ブドウ
Tsísʼná bitłʼizh	蜂蜜
Atsįʼ	食肉
Naʼashjéʼii tsiizisí	ユウレイグモ科
Nímasii	ジャガイモ
Áshįįh łikan	砂糖
Haʼałtsédii	種実類
Wááshindoon bisiláołtsooí	アメリカ軍
Naʼiiniʼ bá Hooghantsoh	ワールドトレードセンター (ニューヨーク)
Áshįįh	塩
Wááshindoondi bee hazʼáanii ádeiłʼíní	アメリカ合衆国議会
Tsin naaʼeeł	船
Nidaʼąnyéézh	灌漑
Naadą́ą́ʼ	トウモロコシ
Naʼashchʼąąʼ	絵画
Wótáahgoo ałnaaʼáłtʼahiʼ	宇宙飛行士
Azhish	ダンス
Naʼashjéʼii nahachaʼígíí	ハエトリグモ
Kéyah Daʼnaaznilígíí	国の一覧
Shash	クマ
Hastiin alą́ąjįʼ dahsidáhígíí John Adams	ジョン・アダムズ
Hastiin alą́ąjįʼ dahsidáhígíí Thomas Jefferson	トーマス・ジェファーソン
Hastiin alą́ąjįʼ dahsidáhígíí Andrew Jackson	アンドリュー・ジャクソン
Ńdíshchííʼ	マツ
Tłʼoh naadą́ą́ʼ	コムギ
Naałniih yichʼą́ą́h naabaahígíí bąąh dahooʼaahgo	後天性免疫不全症候群
Abeʼ bee neezmasí	クレープ
Jéíʼádįįh	結核
Łóódtsoh	天然痘
Zelda bahaneʼ	ゼルダの伝説シリーズ
Naakáí dinéʼiʼ biempire Méhigodi	アステカ
Łéétsoh bee atsiniltłʼish álʼį́	原子力
Łéétsoh beeʼeldǫǫhtsoh beeʼalį́į́h	核兵器
Chidí naaʼnaʼí beeʼeldǫǫh bikááʼ dah naaznilígíí	戦車
Dah woozh	イチゴ
Jalisco Hahoodzo	ハリスコ州
Dzidzé łikaní dootłʼizhígíí	ブルーベリー
Dzidzé łikaní dinilchííʼígíí	ラズベリー
Mágí bichʼiyąʼ	ココナッツ
Dzidzétsoh	モモ
Chʼil łitsxooí	オレンジ
Chʼil dishooí	キウイフルーツ
Chʼil dootłʼizhí díkʼǫ́zhígíí	ライム
Abeʼ yistiní	アイスクリーム
Méhigo bizaad	ナワトル語
Diné bizaad	ナバホ語
Jeeʼiighááh	ハサミムシ
Tenochtitlan	テノチティトラン
Ásáí Bizaad	アラビア語
Honeezílígi	亜熱帯
Atʼaʼ yiltʼąąʼí	ヤシ
Niłchiis	クズリ
Tsin yilátah ayání	キリン
Naalʼeełídaaʼí	カモノハシ
Naʼashǫ́ʼii	トカゲ
Béésh bee akʼeʼelchí áłtsisígíí	パーソナルコンピュータ
Wikiibíídiiya:Naaltsoos nizhónígo ádaalyaaígíí	Wikipedia:秀逸な記事
Bee álnééhí:Link FA	Template:Link FA
Bimááʼ Hahoodzo	バーモント州
Hoozdoh	フェニックス (アリゾナ州)
Tʼáyaałchííʼ	ハシボソキツツキ
Táłkááʼ tsʼin bíchį́į́hnézí	インドガビアル
Tsin naaʼeeł chidí naatʼaʼí bee nágéhéʼ	航空母艦
Tsídiitsoh	ダチョウ
Kolíya bikéyah (Ałtsʼáʼáztiin)	朝鮮
Mąʼiitsoh	オオカミ
Chʼídeeldlóohiitsoh	ハシビロコウ
Tóidoozohii bidaaʼ łichííʼígíí	バン (鳥類)
Táłtłʼááh yilcháazhii	海綿動物
Tónteel naʼashjéʼii	ウミグモ目
Séigoʼ bíláshgaanézí	ウデムシ目
Naʼashjéʼii jáádnézí	ザトウムシ
Séigoʼchilí bitseeʼ ádinígíí	カニムシ
Séigoʼ	サソリ
Zahalchíʼii	ヒヨケムシ目
Hastiin Emperor Qianlong	乾隆帝
Séigoʼ bitseeʼ áłtsʼózígíí	サソリモドキ
Yaaʼ doo yitʼíinii	ダニ
Tsídii doo ndaatʼáʼii	平胸類
Hodíłchʼilgi naaʼahóóhai	シギダチョウ科
Tłʼiishkʼosí (tsídii)	ヘビウ属
Télii	ロバ
Náshdóítsoh noodǫ́zígíí	トラ
Kʼíneeshbízhiinééz	スパゲッティ
Azeeʼ hókániitsoh	アメリカオニアザミ
Táłkáaʼgi Tsídii	カモ目
Tązhii dóó Naaʼahóóhai Ndahalinígíí	キジ目
Naalʼeełii keelóól	カイツブリ科
Tsídii Deílʼésígíí	コウノトリ目
Daʼałtʼoʼígíí Biyęęzhii Deiłchíhígíí	カモノハシ目
Adijiłii bíchį́į́hnézí	ハリモグラ科
Biyázhí neiyéhé	オポッサム
Hazéítsʼósii	シマリス
Chidí bikʼah	石油
Chéłchaaʼ	甲虫類
Łį́į́ʼ ałchiní	モウコノウマ
Dlǫ́ʼii yił aheełtʼéhii noodǫ́zígíí	シママングース
Shash naʼazísí	ウォンバット
Nahatʼeʼiitsohchilí	ネズミカンガルー科
Bįįh Danilínígíí	シカ
Tin	氷
Tłʼohchin díchʼííʼí	ニンニク
Taʼneeskʼání áłtsʼóózígíí	キュウリ
Tłʼohchin (chʼil daadánígíí)	タマネギ
Chʼil łichxíʼí	トマト
Béésh Łichíiʼii Bikéyah Náhookǫsjígo Siʼanígíí	北キプロス・トルコ共和国
Naʼazhǫǫsh Hátsoh	ラスベガス
Náshdóí dilwoʼí	チーター
Tsékǫʼ	石炭
Néʼéshjaaʼ	フクロウ目
Bíígháán Dahólónígíí	脊椎動物
Kʼishchííʼ	カバノキ属
Ǫǫbǫʼii	ヤツガシラ
Náshdóí Ndahalinígíí	ネコ科
Yádiłhił yiiyídíʼ nahosdzáán yináádáłiʼ	国際宇宙ステーション
Tó wónaanídę́ę́ʼ toohjįʼ noołnahii	アオサギ
Hashkʼaan dijéʼé	ナツメヤシ
Wááshindoon (Ałtsʼáʼáztiin)	ワシントン
Bidił Daazdoígíí dóó Daʼalghałígíí	ネコ目
Chʼoshtsoh	ゴキブリ
Dlǫ́ʼii yázhí	イイズナ
Tsʼíʼii dóó Tséʼédǫ́ʼii	ハエ目
Biniiʼłigaii (néʼéshjaaʼ)	メンフクロウ
Mąʼii Ndahalinígíí	イヌ科
Bijáád Ádaadinígíí	軟体動物
Chʼosh łitsxooí dóó Chʼosh łichííʼí	テントウムシ
Táłkááʼ naalzheehí	ミサゴ
Bizaʼazis Dahólónígíí	有袋類
Dlǫ́ʼiiłgaii	オコジョ
Naalʼeełí bitsiiʼ dootłʼizhí	マガモ
Sǫʼ łóóʼ	ヒトデ
Giníłbáhí	オオタカ
Tʼádootłʼizhii	カケス
Zhį́ʼii	ワタリガラス
Táłkááʼ tsʼin Danilínígíí	ワニ
Chʼosh bikágí dantłʼizí	甲殻類
Dééł	ツル
Chʼosh bitsʼaʼígíí	二枚貝
Atsá dóó Giní Ndahalinígíí	ハヤブサ下目 (Sibley)
Łóóʼ ooshgę́ęzhii	軟骨魚綱
Tániilʼáí	トンボ
Wóláchííʼ yildeełí bikágí ntłʼizí	センザンコウ
Gah Danilínígíí	ウサギ目
Tsísʼnátsoh	マルハナバチ
Hazéí yiltseeʼí	セイヨウノコギリソウ
Chʼosh bikǫʼí	ホタル
Zéédzísgaii	コウライキジ
Dlǫ́ʼii Ndahalinígíí	イタチ科
Tsin yiłkaałii	キツツキ科
Bideeʼtsʼinígíí	ウシ科
Dééł dóó Tóidoozohii Ndahalinígíí	ツル目
Gáagii dóó Joogii Ndahalinígíí	カラス科
Chʼiltaatʼagii	ハイイロチュウヒ
Tsin naaʼeeł diné bee nágéhéʼ	フェリー
Gad	ビャクシン属
Jááłánii	多足類
Biishchʼid Dahólónígíí	真獣下綱
Chʼosh Deildeełii	モグラ目
Tó wónaanídę́ę́ʼ naalʼeełítsoh łibáhígíí	ハイイロガン
Tónteel dóó Tábąąhgi Tsídii	チドリ目
Ńdíshchíitah dlǫ́ʼii	マツテン
Biyaatsʼiin Dahólónígíí	顎口上綱
Tooh łéʼétsoh	マスクラット
Chaatʼíní	スイバ
Łóóʼ hashkéhé dootłʼizhígíí	ヨシキリザメ
Wóʼatsʼǫǫsii Ádaatʼéhígíí	カメムシ目
Atsáłgaii	ケアシノスリ
Béégashiiʼilí	ヤク
Tsxį́į́łnaalkʼįhii	アマツバメ科
Dziłditłʼoii Bił Hahoodzo	サンフアン郡 (ユタ州)
Hakʼaz naalʼeełí	ホンケワタガモ
Naalʼeełítsoh bitsiiʼ halzhinígíí	カナダガン
Chʼó	トウヒ属
Łóóʼtsoh łizhin dóó łigaígíí	シャチ
Jáádtsʼósí	セイタカシギ科
Naalʼeełítsoh diłhiłígíí	コクガン
Dlǫ́ʼii bitéél halgaií	ムナジロテン
Tábąąstííntsoh łibáhígíí	ハイイロアザラシ
Naakaii Łizhiní Bikéyahdi Hadahóólįįdígíí	アフリカ獣上目
Diné Nááhódlóonii bizaad	アサバスカ諸語
Łį́į́ʼ bitsísʼná	ヒツジバエ科
Tónteel tsídii	カモメ科
Hazaʼaleehtsoh (dííshjį́ ááłjiní)	セロリ
Kʼaalógii dóó Iichʼąhii	チョウ目
Díłdánii yił aheełtʼéhii	ヨーロッパウズラ
Chʼałdą́ą́ʼ / Jádí nátʼoh (chʼil daadánígíí)	アスパラガス
Tséʼédǫ́ʼii dootłʼizhí	クロバエ科
Jaaʼabaní Danilínígíí	コウモリ
Wóónałchídii	コメツキムシ
Tsídii bidaanézí	コウノトリ科
Dlǫ́ʼii	イタチ
Lókʼaaʼ	ヨシ
Tsídiiłbáhí	スズメ科
Biłʼeʼeliníʼ	ベーキングパウダー
Táłtłʼááh chʼoshchilí	オキアミ
Tsiiʼyiishbizhí Dinéʼiʼ Bikéyah	中国
Naalʼeełí binááʼ łitsooígíí	ホオジロガモ
Tábąąstíín	ユーラシアカワウソ
Jélii łóóʼ	クラゲ
Náshdóíłgaii łikizhígíí	ユキヒョウ
Tábąąstííntsoh Danilínígíí	鰭脚類
Dlǫ́ǫ́ʼ	プレーリードッグ
Náshdóí bijaałizhiní	カラカル
Chʼóhojilyééh	シロバナヨウシュチョウセンアサガオ
Chʼah Diʼilii Bikéyahdę́ę́ʼ naalʼeełítsoh	サカツラガン
Tsídii yáłtiʼí	オウム目
Tééh łį́į́ʼ	シマウマ
Náshdóí łikizhígíí	オセロット
Dííłdzid jeeshóóʼ	エジプトハゲワシ
Tʼáadoo leʼé danílʼį́ bił hazʼą́	博物館
Shash łizhin dóó łigaígíí	ジャイアントパンダ
Shash łigaígíí	ホッキョクグマ
Gaantsʼosí	ウミユリ綱
Hastiin alą́ąjįʼ dahsidáhígíí Theodore Roosevelt	セオドア・ルーズベルト
Neeshchʼííłgai	カシューナッツ
Beeʼódleehí	罠
Dilní bee Nidaʼanéhígíí	楽器
Dééłgai	ハクチョウ属
Bikááʼ náʼoobałí	ヘリコプター
Dziʼizítsoh	オートバイ
Tééhoołtsódii	カバ
Séí	砂
Naakaii Łizhiní Bikéyahdę́ę́ʼ náshdóítsoh łikizhígíí	ヒョウ
Déélgééd	サイ
Beeʼeldííl Dahsinil	アルバカーキ
Hashkʼaan dootłʼizhí (babáayah)	パパイア
Chʼil łigaii (atʼééké bijish)	キャベツ
Náshdóítsoh	ピューマ
Ásáí dinéʼiʼ	アラブ人
Deeteel	ヘラジカ
Shádiʼááhdę́ę́ʼ náshdóítsoh łikizhígíí	ジャガー
Lókʼaatsoh	竹
Káango (Ałtsʼáʼáztiin)	コンゴ (曖昧さ回避)
Kʼaiʼ	ヤナギ
Shash bizaʼazis hólóní	コアラ
Náshdóí kʼos bee naashchʼąąʼígíí	ウンピョウ
Shashtsoh	ヒグマ
Łéʼétsoh	クマネズミ属
Akʼáán	穀粉
Mágítsoh	ゴリラ
Bitsįʼ yishtłizhii	アメリカ州の先住民族
Chʼil akʼahí	アボカド
Neeshchʼííłbáhí	ラッカセイ
Dzidzétsoh díkʼǫ́ǫzhii	アンズ
Naʼashǫ́ʼii łahgo ánééhé	カメレオン科
Yootó	サンタフェ (ニューメキシコ州)
Łééchąąłgaii	イングリッシュ・グレイハウンド
Nahatʼeʼiitsoh Bikéyahdę́ę́ʼ łééchąąʼí ałchiní	ディンゴ
Chʼééhjiyáán	スイカ
Teide	テイデ山
Naʼastsʼǫǫsí	ハツカネズミ属
Hakʼaz bįįh	トナカイ
Chʼosh doo yitʼínii	微生物
Táshchozhii	ツバメ科
Neeshchʼííʼ hááheeshchiiʼí	アーモンド
Łóóʼ bigaan tseebíí	タコ
Chʼosh bikágí ntłʼizí	カニ
Tábąąstííntsoh bideeʼ hólónígíí	セイウチ
Mágí diʼilí	オランウータン
Atsátsoh	イヌワシ
Łóóʼtʼą́hí atsiniltłʼish ííłʼínígíí	シビレエイ目
Chʼil łitsxooí ntsxaaígíí	グレープフルーツ
Kʼíníjíłʼahí (dííshjį́ ááłjiní)	セイヨウスグリ
Kʼaalógiiłgaígíí	シロチョウ科
Naʼastsʼǫǫsí binááʼ áłtsʼíísígíí	トガリネズミ
Dzaanééz	ラバ
Tsinlátah shash łichíʼígíí	レッサーパンダ
Tsídii jáádnézí	フラミンゴ
Tééh łééchąąʼí	ハイエナ
Łóóʼtsoh dootłʼizhígíí	シロナガスクジラ
Sóól	カエデ
Aghaaʼ	ウール
Deesdoigi	熱帯
Shádiʼááhdę́ę́ʼ tłʼízí	リャマ
Mósíʼilí	ペルシャ (ネコ)
Lókʼaatah mósí ałchiní	ジャングルキャット
Náátsʼózídę́ę́ʼ mósíłkizhii ałchinígíí	ベンガルヤマネコ
Náshdóítʼą́ʼí łikizhígíí	サーバル
Tábąąh béégashii	スイギュウ
Béégashiitsoh naʼałkǫ́ǫ́ʼígíí	マナティー
Hastiin Leiw Éíwiksson	レイフ・エリクソン
Akágí yitsʼǫǫsii	ヒル (動物)
Anáʼálwoʼ:TʼAN (FAQ)	Wikipedia:FAQ
Táłkááʼ tsʼin	クロコダイル科
Chidítsoh	貨物自動車
Gáagii	カラス属
Tó wónaanídę́ę́ʼ náshdóí	ヨーロッパオオヤマネコ
Jááłánii (bitsiitsʼiin nteelígíí)	ムカデ
Giní	ハヤブサ属
Dahiitį́hii	ハチドリ
Tsídii biyęęzhtsohígíí	キーウィ (鳥)
Tązhii	シチメンチョウ属
Chʼosh (Bíígháán Ádaadinígíí)	無脊椎動物
Gáagii naashchʼąąʼígíí	ブッポウソウ科
Mąʼii	コヨーテ
Dah Naatʼaʼí Sǫʼ bił Sinil	星条旗 (国歌)
Akʼah sisíʼí tsin	ユーカリ
Mááya dinéʼiʼ	マヤ人
Gahtsoh	ノウサギ属
Bisóodi bíchį́į́h nineezí	ツチブタ
Sonora Hahoodzo	ソノラ州
Nahakʼízii	コオロギ
Chaaʼ	ビーバー
Chʼilzooł	ブロッコリー
Kááʼtsʼiní	アルマジロ
Atsʼiis naałdzid	肺癌
Yágháhoníkáángóó ałánátʼahí	スペースシャトル
Béésh náábałí atsiniltłʼish ííłʼínígíí	風力原動機
Méhigo tééh	メキシコ盆地
Shą́ą́ʼnahalghałí (naaldeehii)	ハイラックス
Nahatʼeʼiitsoh łichíiʼii	アカカンガルー
Azeeniłchin	シソ科
Chʼał	カエル
Tsxilghááh	有尾目
Shádiʼááhdę́ę́ʼ atsátsoh	オウギワシ
Shádiʼááhdę́ę́ʼ chʼał kʼaasdáhígíí	ヤドクガエル科
Chʼał dichʼízhí	ヒキガエル科
Tónteel tsídiitsoh	アホウドリ科
Chidí nadlééh	オープンカー
Bisóodi ałchiní	イノシシ
Naʼastsʼǫǫsí dóó Łéʼétsoh Danilínígíí	ネズミ上科
Mariner 10	マリナー10号
Sǫʼ łóóʼ bigaanézí	クモヒトデ
Dághaałóóʼ	ナマズ目
Łóóʼtʼą́hí	カレイ目
Kʼaalógii bitseeʼ hólóní	アゲハチョウ科
Mágí binááʼtsohígíí	メガネザル
Díłdánii	ナンベイウズラ科
Táłtłʼááh łį́į́ʼ	タツノオトシゴ
Łóóʼ bíígháántsiighąąʼ ádaadinígíí	ヌタウナギ
Achʼįʼ Náhiłtį́į́	サフォード (アリゾナ州)
Tó wónaanídę́ę́ʼ dzeeh	アカシカ
Kinłání (Hoozdoh Hahoodzo)	フラッグスタッフ (アリゾナ州)
Michoacán Hahoodzo	ミチョアカン州
Táłtłʼááh chʼosh daadánígíí	コエビ下目
Mágíshzhin	チンパンジー属
Łóóʼntsxaaí łikizhígíí	ジンベエザメ
Dlǫ́ʼii yił Aheedaałtʼéhígíí	マングース科
Béésh Bichʼahníí Bikéyahdę́ę́ʼ ayání	ヨーロッパバイソン
Łóóʼtsoh bitsiiʼ dikʼání	マッコウクジラ
Waaʼ (dííshjį́ ááłjiní)	ホウレンソウ
Néʼéshjaatsoh	アメリカワシミミズク
Shádiʼááhdę́ę́ʼ tłʼízíʼilí	アルパカ
Chʼosh ditłʼooí	ケムシ
Łóóʼ bigaan neeznání	イカ
Bijáád noodǫ́ǫzii	オカピ
Méhigo Hahoodzo	メヒコ州
Ayání	アメリカバイソン
Mąʼiiłgaii	ホッキョクギツネ
Táłtłʼááh chʼosh chʼééh digháhii bideetsohígíí	アメフラシ
Gólízhii Danilínígíí	スカンク
Táłtłʼááh adijiłii	ウニ
Nahachagii	バッタ
Wóóneeshchʼįįdii (nahachaʼígíí)	ワタリバッタ
Tsídiitsoh ditsʼozígíí	エミュー
Ałhaʼdeetʼaah	契約
Naayééʼ tsídii	始祖鳥
Tsísʼná (bitłʼizh ííłʼínígíí)	ミツバチ
Chééwokii dinéʼiʼ	チェロキー
Tsin naaʼeeł hééł bee nágéhéʼ	貨物船
Ałtį́į́ jikʼáshí áłtsʼózígíí (chʼil)	スギナ
Yéigo ałhoshii	ヤマネ科
Naʼashjéʼii bijéí dah łichíiʼii	クロゴケグモ
Naałání	コマンチェ
Oozéí / Ayahkinii	ホピ族
Bidááʼ Haʼaztʼiʼ Tsékooh	グランド・キャニオン
Táłtłʼááh naʼashjéʼii	ミズグモ
Táłtłʼááh tsisteełtsoh	オサガメ
Tsídii yáłtiʼí yázhí	セキセイインコ
Tábąąh mąʼii	アライグマ
Hołchʼíʼí	イラクサ属
Tsįdláád	サルオガセ
Dáághahii dinéʼiʼ	フランス人
Shash łizhinígíí	アメリカグマ
Náshdóí bizaʼazis hólóní	フクロオオカミ
Łeeyiʼ chʼosh	ミミズ
Shash bitéélgaígíí	ツキノワグマ
Chʼoshtʼą́hí	扁形動物
Hashtłʼish jeeshóóʼ	ヒゲワシ
Jádí bíchį́į́htsohígíí	サイガ
Táłtłʼááh chʼoshtsoh chʼééh digháhii	ナマコ
Chidí naatʼaʼí dilwoʼí	戦闘機
Bíchį́į́h naatsʼǫǫdí	バク
Tó wónaanídę́ę́ʼ mąʼii	キンイロジャッカル
Łóóʼ Bigaan Dahólónígíí	頭足類
Naʼashǫ́ʼii łóóʼ	ウナギ目
Dahbaʼ (tsin)	トネリコ属
Łóóʼ hashkéhétsoh	ホホジロザメ
Neeshchʼííłchííʼ	クリ属
Chį́į́hnézí nahatʼeʼígíí	ハネジネズミ
Táłtłʼááh ayání	ジュゴン
Dibé Diníí Bikéyahdę́ę́ʼ náshdóí	スペインオオヤマネコ
Toohjįʼ ndiigaiitsoh	ダイサギ
Wóóneeshchʼįįdii	セミ
Dééshzhiin	コクチョウ
Naakaii náásééł	カマキリ
Dlǫ́ǫ́ʼ ntsxaaígíí	カピバラ
Mąʼii bijaaʼtsohí	フェネック
Dilchaʼ	マーモット
Náshdóí łibáhígíí	ボブキャット
Chʼilhaatʼaʼii	コチョウゲンボウ
Tééh hóyáaniitsoh	シロイルカ
Jádí bideeʼ yisdizígíí	インパラ
Náátsʼózídę́ę́ʼ mąʼiiłchííʼ	ドール
Łóóʼtsoh bighą́ą́ʼ yílkʼidígíí	ザトウクジラ
Ghą́ą́ʼnaakiskʼidii	フタコブラクダ
Tábąąh mąʼiiniiʼí	タヌキ
Naʼazhǫǫsh (ndajiné dóó adazhdikaʼgi)	カジノ
Dlǫ́tʼą́ʼí	ミーアキャット
Azeeʼ hókániitsoh (chʼil daadánígíí)	アーティチョーク
Kéchwa dinéʼiʼ	ケチュア
Mąʼii bizaʼazis hólóní	タスマニアデビル
Shash bítááʼłgaígíí	メガネグマ
Jádítsoh	クーズー
Naatʼáanii Moctezuma II	モクテスマ2世
Biwooʼ Ádaałtsʼíísígíí	有毛目
Ásáí dinéʼiʼ bikéyah	アラブ世界
Shash yázhí	マレーグマ
Shash ndilnaʼii	ナマケグマ
Hwéeldi	ロング・ウォーク・オブ・ナバホ
Łéʼétsoh yiljaaʼí	キンポウゲ属
Hakʼaz náshdóí	カナダオオヤマネコ
Mąʼii yił Ałhidanoolinígíí Yázhí	アライグマ科
Béésh Bichʼahii beʼakétłʼóól dijoolí	コールラビ
Tłʼoh waaʼí nahalinígíí	シロツメクサ
Tábąąstííntsoh dághaaʼígíí	アゴヒゲアザラシ
Atʼééké bijish yázhí	メキャベツ
Tsékooh	峡谷
Noodah	リュウゼツラン
Łeeʼdoolʼeezí	ハマウツボ科
Kinteel Bił Hahoodzo	サンファン郡 (ニューメキシコ州)
Beeʼeldííl Dahsinil Bił Hahoodzo	ベルナリオ郡 (ニューメキシコ州)
Aniłtʼánii	アミメカゲロウ目
Kʼaalógii bijáád dį́įʼii	タテハチョウ科
Nímasii yiyání	コロラドハムシ
Awééʼchíʼí (chʼil)	ホタルブクロ属
Taʼaghálii	ゲンゲ属
Naaʼołí yiltʼąąʼí	レンリソウ属
Hastóí tsiiyéélí	クレマチス
Chʼilátah atsʼos	アカバナ属
Táłkááʼbéésh	オモダカ属
Tsinyaa tłʼoh	イチゴツナギ属
Tłʼééʼ yiigáhii	マツヨイグサ
Tłʼoh deeskʼidí	アオゲイトウ
Wóóseekʼidii	スズメガ科
Tʼąąʼdoolghasí	ヨウシュツルキンバイ
Tséghániłchʼi	スベリヒユ
Tséyaa hataałí	ルタバガ
Tłʼoh dichʼíízh	スゲ属
Shashdą́ą́ʼ	メギ属
Díkʼǫ́ǫ́zhí yiltʼąąʼí	シロザ
Kʼaalógii bitʼaʼ ndikʼąʼ nahalinígíí	シジミチョウ科
Hosh niteelí	オプンティア
Teeł bitʼąąʼłánígíí	ホタルイ属 (広義)
Chʼał nineezí	ウシガエル
Tééh hóyáanii bíchį́į́htsahí	イッカク
Mágí bíchį́į́htsohígíí	ヒヒ
Bįįh łikizhígíí (Béésh Bichʼahníí Bikéyahdę́ę́ʼígíí)	ダマジカ
Tábąąh ayání	アフリカスイギュウ
Nátʼostsoh	ビロードモウズイカ
Dibé diníí dinéʼiʼ	スペイン人
Binaʼadaałtzózí	日本人
Gad yił aheełtʼéhígíí	ギョリュウ
Łóóʼ bíchį́į́h nineezí	メカジキ
Łį́į́ʼ Ndahalinígíí	ウマ科
Binááʼ Ádaałtsʼózí bichʼil łigaií	ハクサイ
Azeedíchʼííʼ	唐辛子
Kolíya Tááʼ Bikéyahą́ą	三国時代 (朝鮮半島)
Łeehdoolʼeez łichííʼí	テーブルビート
Hashkʼaantsoh yiltʼeesígíí	プランテン
Iiʼnótʼį́į́	感染
Chʼah Diʼilii Bikéyahdę́ę́ʼ mósí ałchinígíí	マヌルネコ
Tááʼyaʼniiltʼóshiiłbáhígíí	ムネアカコウカンチョウ
Jááłánii (bikágí ntłʼizígíí)	ヤスデ
Iichʼąhii ntsxaaígíí	ヨナグニサン
Łóóʼ ńdídzihígíí	ハイギョ
Chʼíshiibeezhii	シジュウカラ科
Giní jáádnézí	ヘビクイワシ
Hakʼaz néʼéshjaaʼ	シロフクロウ
Shádiʼááhdę́ę́ʼ jeeshóóʼ	コンドル
Chidí naatʼaʼítsoh beeʼeldǫǫh bikǫʼ neiyéhé	爆撃機
Shash bighą́ąʼgi hadzíbáhí	ハイイログマ
Kǫʼ naʼałbąąsii	蒸気機関車
Ndíyíliitsoh	ヒマワリ
Naaʼahóóhaiłkizhígíí	ホロホロチョウ科
Tłʼiish yighání	ラーテル
Dadilhóni aheltłʼidígíí	手榴弾
Naakaii Łizhiní Bikéyahdę́ę́ʼ łééchąąʼí ałchiní	リカオン
Aniłtʼánii (tʼááłaʼajínígoʼígíí)	カゲロウ
Ayánítsoh bighą́ą́ʼaskʼidígíí	ガウル
Máaz yikááʼ nandahí Spirit	スピリット (探査機)
Hakʼaz giníłgaii	シロハヤブサ
Tsétah jeeshóóʼ łibáhí	シロエリハゲワシ
Tééh łééchąąʼí łikizhígíí	ブチハイエナ
Tłʼízí ałchiní	パサン
Yaaʼ dóó chʼosh bíchį́į́h dadichʼízhí	鉤頭動物
Beeʼeldǫǫh	マスケット銃
Chʼosh bitsʼaʼígíí bigaan dahólónígíí	腕足動物
Tʼąąʼdoolghasí (daadánígíí)	エンダイブ
Dlǫ́ʼii (bílaʼashdlaʼii bilį́į́ʼ)	フェレット
Łóóʼtsoh łibáhígíí	コククジラ
Chʼah Diʼilii Bikéyahdę́ę́ʼ atsátsoh	ソウゲンワシ
Yiisnááh	捕虜
Dzeeh	アメリカアカシカ
Tsinlátahgi tsídii nahatʼeʼígíí	ネズミドリ科
Nátʼoh (chʼil)	タバコ
Tsísʼná yiyání	ハチクイ科
Bisóodi bizęęs dį́įʼii	イボイノシシ
Dlǫ́ʼiitsoh naalzheehígíí	フォッサ
Nahachagii biyázhí	アブラムシ
Naalkʼįhiitsoh	ヒヨケザル目
Łóóʼ naatʼaʼí	トビウオ
Hakʼaz ayání	ジャコウウシ
Tsétah gah	ナキウサギ
Mąʼiitsoh bikʼos bineʼdę́ę́ʼ łizhinígíí	タテガミオオカミ
Iichʼąhiitsʼósí	トビケラ
Kéyah Dańlínídę́ę́ʼ atsátsoh	フィリピンワシ
Tábąąstííntsoh bíchį́į́htsohígíí	ゾウアザラシ属
Łóóʼntsxaaí díníchʼahii	ウバザメ
Chʼosh yighání	アードウルフ
Mágí bitseeʼ noodǫ́zígíí	ワオキツネザル
Táyiʼ chʼoshnézí	ヒモムシ
Dlǫ́tsʼósí łibáhígíí	ホソスジマングース
Tó naagoʼ	滴
Dlǫ́ʼiitsoh Danilínígíí	ジャコウネコ科
Mágí bigaanézí	テナガザル
Bílaneezii	アイアイ
Naalʼeełítsoh bitéél halchíʼí	アオガン
Tłʼízí bideeʼ yisdizígíí	マーコール
Jádí	プロングホーン
Wónikǫsí	ナナフシ
Tééh łééchąąʼí noodǫ́zígíí	シマハイエナ
Tsídiiłchxoní	ツメバケイ
Táłtłʼááh chʼoshtʼą́hí bikááʼtsʼinígíí	多板綱
Mąʼii bighą́ąʼgi hadzíjiní	セグロジャッカル
Naakaii Łizhiní Bikéyahdę́ę́ʼ mąʼiiłchííʼ	アビシニアジャッカル
Tsétah dibé	ビッグホーン
Dibé dóó Tłʼízí Ndahalinígíí	ヤギ亜科
Mágí bíchį́į́h dootłʼizhígíí	マンドリル
Tó wónaanídę́ę́ʼ dibé ałchiní	ムフロン
Tsiighájíłchí	ネナシカズラ属
Dzeeh łikizhígíí	ニホンジカ
Tábąąh mósí ałchiní	スナドリネコ
Chį́į́h yee achʼiishíhii	ノコギリエイ
Shádiʼááhdę́ę́ʼ hodíłchʼil mąʼii	ヤブイヌ
Hakʼaz mágí	ニホンザル
Tsé Biiʼ Ndzisgaii	モニュメント・バレー
Mágí bíchį́į́h niilyoolígíí	テングザル
Ayání dóó Béégashii Danilínígíí	ウシ族
Náátsʼózídę́ę́ʼ mósíłtsxooí ałchinígíí	アジアゴールデンキャット
Łóóʼnteeltsoh	マンボウ
Gaanłáníchilí dóó Gaanłání doo yitʼíinii	ヒドラ (生物)
Atłʼóóh	織り
Chʼoshkʼaaʼ	毛顎動物
Hodíłchʼil jeeshóóʼ	トキイロコンドル
Achʼąąʼ adáʼatsʼiʼ	予防接種
Néʼéshjaaʼ bíńdáhii	オナガフクロウ
Bitseeʼ yee adiłhałii	アメリカアリゲーター
Jádítsoh noodǫ́zígíí	ボンゴ (偶蹄目)
Níyolgi naatʼaʼígíí (tónteel tsídii)	ウミツバメ科
Tádídíín yiyání	ハムシ
Tsídiidaashiyishí	トキ亜科
Yílnoodii (łóóʼ)	カマス
Chʼosh bitsʼaʼłáaʼii	単板綱
Naʼashǫ́ʼii łóóʼ hashkéhé	ラブカ
Jeeshóóʼ	カリフォルニアコンドル
Chʼosh dilwoʼígíí	ハンミョウ科
Chʼosh doo yitʼíinii bee nílʼíní	顕微鏡
Joogii	アオカケス
Łeeyiʼ nahakʼízii	ケラ
Náátsʼózídę́ę́ʼ naalʼeełí	オシドリ
Mąʼii bijaaʼabanígíí	オオミミギツネ
Tsídiitsoh bikʼos dootłʼizhí	ヒクイドリ属
Atsiniltłʼish ííłʼíinii (naʼashǫ́ʼii łóóʼ)	デンキウナギ
Łeeyiʼ tłʼiish áłtsʼíísígíí	メクラヘビ
Niicháadii (łóóʼ)	フグ
Tééhoołtsódiichilí	コビトカバ
Kʼiiznoodǫ́ǫzii (tsin yigházhígíí)	パカ
Wóláchííʼ yildeełítsoh	オオアリクイ
Dibéʼniiʼí	チャイロツキヒメハエトリ
Bináʼadaałtsózí bitsin naaʼeeł	ジャンク (船)
Níłtsą́goʼ (bideeneezígíí)	カミキリムシ
Tséʼédǫ́ʼii bitsiinézí	シリアゲムシ目
Tłʼohtahgi díłdánii yił aheełtʼéhii	ミフウズラ科
Łóóʼyiniʼįįhí (tónteel tsídii)	トウゾクカモメ科
Shádiʼááhdę́ę́ʼ tó hóyáanii	アマゾンカワイルカ
Binaʼadaałtsózí dinéʼi	東洋
Łóóʼ adishishí	アカエイ科
Tsin yąąh dzootʼihí	ゴジュウカラ科
Atʼaʼ yiltʼąąʼí dah sidáhígíí (chʼosh ntsxaaígíí)	ヤシガニ
Yółeehii	アンコウ目
Tiníléí	アメリカドクトカゲ
Dijádídlǫ́ʼí	ハマヒバリ
Tłʼoh	芝
Dinas	クマコケモモ
Yadiizį́įgo ayání	ジェレヌク
Télii bijáád noodǫ́zí	アフリカノロバ
Bitsʼáá bidaʼhodiʼniil	焦土作戦
Mágíłchííʼ	ゴールデンライオンタマリン
Łóóʼ hashkéhé bitsiiʼ dikʼání	シュモクザメ
Taahilnoodii	カツオドリ科
Kʼíneedlíshii adiłhashígíí	クワガタムシ
Łééh yidi tóʼígíí	帯水層
Naʼashǫ́ʼiitsoh naʼałkǫ́ʼígíí	ウミイグアナ
Yaaʼ bitsʼaʼígíí	カイガラムシ
Daateel	ヒロハシサギ
Tééh łééchąąʼí ditsʼozígíí	カッショクハイエナ
Tsétaʼ łį́į́ʼ	マスタング
Kénézí	レンカク科
Neeshchʼííʼ	松の実
Naalʼeełítsoh yił aheełtʼéhii łizhin dóó łigaiígíí	カササギガン
Mąʼii chʼil	アキノキリンソウ属
Yaadaaʼnézí (tónteel tsídii)	ハサミアジサシ属
Tsídii disxǫsígíí	キリハシ科
Náátsʼózídę́ę́ʼ mósíłchíiʼii ałchinígíí	ボルネオヤマネコ
Shádiʼááhdę́ę́ʼ tsétah mósí ałchinígíí	アンデスネコ
Tsinlátahgi dlǫ́ʼiitsoh	ビントロング
Jeeshóóʼ łizhinígíí	クロコンドル
Naałʼashí	オオツチグモ科
Dééłdą́ą́ʼ	ワラビ
Hashkʼaan yildeełígíí (tsídii)	エボシドリ科
Mąʼiiłtsooí łibáhígíí	ハイイロギツネ
Naʼashǫ́ʼiitsoh dootłʼizhígíí	グリーンイグアナ
Chidí bikéíjį́ʼ adeizʼááhígíí	ピックアップトラック
Wónitłʼizí	ワラジムシ亜目
Díʼdikii (jádí)	ディクディク属
Hakʼaz mąʼiitsoh	ホッキョクオオカミ
Dark Ages	暗黒時代
Łeeyiʼ jááłániichilí	エダヒゲムシ
Aniłtʼánii (bikʼosnézí)	ラクダムシ亜目
Naaʼołí biyaʼ	マメゾウムシ
Ááhooshtʼįįh	降伏
Tséʼédǫ́ʼii dishooí	ハナアブ
Tsáʼásziʼ dóó Noodah	リュウゼツラン科
Tééh tsisteeł	ウミガメ
Bichʼah Dootłʼizhii	国際連合平和維持活動
Dlǫ́ʼii łizhin dóó łitsooígíí	キエリテン
Chʼosh ałchozhii (chéłchaaʼ)	カツオブシムシ
Łeʼesoołii (bitseeʼ naakiígíí)	コムシ目
Dlǫ́ʼátsoh	ウッドチャック
Chʼééh digháhii dóó Tsisteeł	カメ
Tááʼyaʼniiltʼóshii	ショウジョウコウカンチョウ科
Łóóʼ bigaanłánígo bitsʼaʼígíí	オウムガイ
Łeʼesoołii (bitseeʼ tááʼígíí)	シミ目
Tłʼézhii	アブ科
Tániilʼáítsʼóóz	イトトンボ
Aniłtʼániitsʼóóz	ウスバカゲロウ
Tó wónaanídę́ę́ʼ hazéí bíchį́į́hnézí	ツパイ目
Hakʼaz gah	ホッキョクウサギ
Bįįh łikizhígíí (Naakaii Dootłʼizhii Bikéyahdę́ę́ʼígíí)	アクシスジカ
Nahashchʼidí (naaldeehii)	アメリカアナグマ
Bisóodi bideeʼ názhahígíí	バビルサ
Tsídii bichʼahtsooígíí	オオサイチョウ
Shádiʼááhdę́ę́ʼ bisóodi diʼilígíí	ペッカリー
Bilagáana	白人
Tłʼézhiiłbáhí	ヤドリバエ
Shash nátʼoh	ハマビシ
Jádítsoh diłhiłígíí	ニアラ
Jádítsoh bideeʼ shiyishígíí	セーブルアンテロープ
Tsinaʼayąʼii yildeełí	フクロアリクイ
Tsétah tłʼízí	シロイワヤギ
Jááłániichilí bighádzígaiígíí	コムカデ綱
Tsiishgaii	ヒメゴジュウカラ
Dééłgai bitsiiʼ halzhinígíí	クロエリハクチョウ
Chʼosh nahachagii	ヨコバイ
Hóółtseiigi naʼastsʼǫǫsí	アレチネズミ亜科
Gaanłání	ハナギンチャク
Laanaa Yáʼátʼéehgo Késhmish	おめでとうクリスマス
Naʼazǫ́ǫzii	アリバチ
Chį́į́shłigaií (bílaʼashdlaʼii bilį́į́ʼ)	ガチョウ
Naalʼeełí łizhinígíí	クロガモ属
Nahatʼeʼiitsoh Bikéyahdę́ę́ʼ naalʼeełítsoh łibáhígíí	ロウバシガン
Naʼastsʼǫǫsí bitseeʼ dichʼízhí	トゲマウス
Tsétah nahatʼeʼiitsoh	イワワラビー属
Táłkááʼ dilwoʼí	アメンボ類
Akáshtʼóózh biyaʼ	チャタテムシ
Łeʼesoołii (bideeʼ ádinígíí)	カマアシムシ
Ąąʼąʼii	カササギ属
Jádí bideeʼ dį́įʼii	ヨツヅノレイヨウ
Táłtłʼááh chʼosh ntsxaaígíí	タカアシガニ
Mósí ałchiní bitsiiʼtʼąhígíí	マレーヤマネコ
Naakaii Łizhiní Bikéyahdę́ę́ʼ naalʼeełítsoh dibéłchíʼígíí	エジプトガン
Tʼáá łichíʼígo náʼagéédí	ハダカデバネズミ
Tsisteeł łizhinígíí	アカアシガメ
Atʼąąʼ nahalinii	コノハムシ科
Ghą́ą́ʼnoodǫ́ǫzii (tsin yigházhígíí)	パカラナ
Łéʼétsoh beeniʼíhoniitaahígíí	テンジクネズミ
Naʼashǫ́ʼii dichʼízhii	サバクツノトカゲ
Ásaaʼ neiyéhii	ツチハンミョウ
Naʼashǫ́ʼiitsoh łitsooígíí	ガラパゴスリクイグアナ
Shádiʼááhdę́ę́ʼ tiníléí	メキシコドクトカゲ
Sahdii Bisí (Tsé Nástánii)	化石の森国立公園
Tsé Bighánílíní	アンテロープ・キャニオン
Naakaii Dootłʼizhii bimósí ałchinígíí	サビイロネコ
Naʼashǫ́ʼiiłchííʼ dootłʼizhígíí	ムワンザ・アガマトカゲ
Chʼał bikʼos ádinígíí	インドハナガエル
Tsídii naʼałkǫ́ʼígíí	ツノメドリ属
Tsisteeł diyogí	マタマタ
Łóóʼ adishishí ntsxaaígíí	オニイトマキエイ
Tónteel bibąąh hóyáanii	スナメリ
Naakaii Łizhiní Bikéyahdę́ę́ʼ tsétah dibé	バーバリーシープ
Naalʼeełí naashchʼąąʼígíí	アメリカオシ
Tsinlátah nahatʼeʼiitsoh	キノボリカンガルー属
Tsin naaʼeeł łóó beeʼháʼhaalʼééłiʼ	トロール船
Chʼosh biyaʼ	ネジレバネ
Táłtłʼááh chʼosh	ゲンゴロウ類
Gáagii dinéʼiʼ	クロウ族
Shádiʼááhdę́ę́ʼ tábąąstííntsoh	オタリア
Táłtłʼááh álééh	オオアオサギ
Táłtłʼááh naakaii náásééł yił aheełtʼéhii	シャコ目
Náátsʼózídę́ę́ʼ tsiiłtsooí	キンケイ
Bisóodi Danilínígíí	イノシシ亜目
Naʼastsʼǫǫsí bijaaʼntsxaaígíí	ミミナガバンディクート
Tsʼání	マツカケス
Chʼééh digháhii bitsʼaʼ yilzhólí	スッポン科
Chį́į́shghą́ʼiiłgaii	ムナジロゴジュウカラ
Hastiin Diego de Landa	ディエゴ・デ・ランダ
Hastiin Biʼééʼ Łichíiʼii	キット・カーソン
Tábąąstííntsoh (Akééháshį́į́dę́ę́ʼígíí)	カリフォルニアアシカ
Mósí bizaʼazis hólóní	フクロネコ
Tségad	イワヒバ科
Naaʼołí	豆
Hashtłʼishdi chʼééh digháhii	ドロガメ科
Yaaʼ nahachagiígíí	ノミ
Tábąąsdísí áłtsʼíísí	アメリカイソシギ
Náátsʼózídę́ę́ʼ toohjįʼ ndiigaii	カラシラサギ
Hodíłchʼil tłʼízí	スマトラカモシカ
Hakʼaz Dineʼé Bikéyahdę́ę́ʼ tábąąstííntsoh	トド
Naayééʼ tsídiitsoh	モア
Atseełtsoii	アカオノスリ
Tóniłhę́ęshii (dééł)	アメリカシロヅル
Naaltsoos Mormon Wolyéhígíí	モルモン書
Téél halchíʼí	コマツグミ
Dlǫ́ʼátah néʼéshjaaʼ	アナホリフクロウ
Naʼashǫ́ʼii bijáád ádinígíí	ミミズトカゲ
Naʼatłʼoʼii (chʼosh)	シロアリモドキ
Dííłdzid yiyání	ハネカクシ
Yáhashjool yázhí	コヨシゴイ
Tsʼíʼii jáádnézí	ガガンボ
Chʼil ditsʼozíłchííʼ	ランブータン
Mágíłtsooí bináázhiní	コモンリスザル
Taʼneeskʼání	カンタロープ
Tsídiiłtsooí bitʼaʼ łizhinígíí	オウゴンヒワ
Tsʼíʼii noodǫ́zí	ヒトスジシマカ
Bitseeʼ yee adiłhałii yázhí	カイマン亜科
Anaasází	古代プエブロ人
Chʼééh digháhiitsoh	ガラパゴスゾウガメ
Tsineeshbízhii	アメリカキバシリ
Yeenaʼałkǫ́ʼíłániichilí	ムカデエビ綱
Naʼnízhoozhí Bił Hahoodzo	マッキンリー郡 (ニューメキシコ州)
Mąʼii Deeshgiizh Bił Hahoodzo	サンドヴァル郡 (ニューメキシコ州)
Naatoohí Bił Hahoodzo	シボラ郡 (ニューメキシコ州)
Tábąąstííntsoh łikizhígíí	ゴマフアザラシ
Ooljééʼ yiikááʼ nandahí	月面着陸
Tsoodził	テーラー山
Toohjįʼ noołnahii yázhí	アメリカササゴイ
Łóóʼ hashkéhé bíchį́į́hnézí	ミツクリザメ
Tłʼiishtsiiʼí (łóóʼ)	ライギョ
Chéłchaaʼ bideeneezígíí	ヘラクレスオオカブト
Déłí	カナダヅル
Ąąʼąʼiiłbáhí	オナガ
Tsétah chaaʼ	ヤマビーバー
Sighóla	ソコロ
Chéłchaaʼ disxǫsígíí	タマムシ
Naalʼeełí dootłʼizhí	ミカヅキシマアジ
Dlǫ́tsʼósí łichííʼígíí	ワオマングース
Jádídlǫ́ʼii	イエミソサザイ
Yaayááhalzhiin	ノドグロヒメドリ
Tséʼédǫ́ʼii	イエバエ科
Chʼagiitsoh	キガシラムクドリモドキ
Dahsání dah Yikahjí Tsin Deigházhígíí	ヤマアラシ亜目
Gad niʼeełí	コロラドビャクシン
Níyolgi naʼałkǫ́ʼígíí (tónteel tsídii)	モグリウミツバメ科
Tsinaʼayąʼii biyázhí	ジュズヒゲムシ
Tseekʼi nástánii	レイヨウジリス属
Naatooh Sikʼaiʼí	グランツ
Tsooʼtsʼiní (łóóʼ)	アロワナ
Tsinaʼayąʼii	シロアリ
Tsįyaatsiiłchííʼ	ベニタイランチョウ
Beeʼeldííldahsinildi siláołtsooí bichidí naatʼaʼí ńdinibįįhígi	カートランド空軍基地
Neeshchʼíínímazí	ヘーゼルナッツ
Łóóʼ binááʼtsohí	キントキダイ科
Tsisteeł bikʼosneezígíí	ヘビクビガメ科
Nákʼeʼnáʼijiní	ムネアカゴジュウカラ
Ałtaʼneetsʼéhii	オナモミ属
Yáhashjool yił aheełtʼéhii	ジャノメドリ
Tsintah bisóoditsoh	モリイノシシ
Zééjíjinii	カンムリサケビドリ
Łóóʼ hashkéhé bitseeneezígíí	マオナガ
Chį́į́shłigaií dóó Naalʼeełítsoh	ガン亜科
Jádí biniiʼtsʼózí	ハーテビースト
Tábąąh jádí	ウォーターバック
Jádí binááʼ dį́įʼii	ヒロラ
Tó wónaanídę́ę́ʼ dlǫ́ʼáyázhí	ヨーロッパハタリス
Dlǫ́iitsoh bíchį́į́hdzísgaiígíí	ハクビシン
Chʼał mágí nahalinii	ソバージュネコメガエル
Sǫʼ tsisteeł	ホウシャガメ
Nahatʼeʼiitsoh Bikéyahdę́ę́ʼ tązhii	ヤブツカツクリ
Mąʼii dootłʼizhí	カコミスル
Łeʼesoołii (nahachaʼígíí)	イシノミ目
Chéłchaaʼtsoh	カブトムシ亜科
Wódisxǫsí	キンカメムシ
Kʼaalógiitsoh disxǫsígíí	モルフォチョウ属
Tsisteeł hashkéhé	カミツキガメ科
Tsídiidą́ą́ʼ	フロックス属
Tsiikʼánii (tsídii)	シュモクドリ
Náátsʼózídę́ę́ʼ tsiidootłʼizhii	セイラン
Ábishjaaʼ (daadánígíí)	食用キノコ
Kéyah Dańlínídę́ę́ʼ naalʼeełí	アカノドカルガモ
Tiníléítsoh naʼałkǫ́ʼígíí	ミズオオトカゲ
Kézhoozhʼilí (tsin yigházhígíí)	グンディ科
Jádí bideeneezígíí	オリックス属
Dáádílí łikizhígíí	サラサハタ
Nahatʼeʼiitsoh yázhí	ヤブワラビー属
Dééłtsoh	アフリカオオノガン
Kéyahígíí nidineesdzaʼ	ダストボウル
Nahachagii dootłʼizhí	キリギリス科
Tsé Bíyah Aniiʼáhí	チャコ文化国立歴史公園
Nahatʼeʼiitsoh Bikéyahdę́ę́ʼ biyázhí neiyéhé	フクロギツネ
Łóóʼ adiłdoní	テッポウウオ
Naakaii Łizhiní Bikéyahdę́ę́ʼ nahatʼeʼii	トビウサギ
Táłtłʼááh chʼosh chʼééh digháhii bitsʼaʼ ádinígíí	裸鰓類
Tiníléítsoh noodǫ́zígíí	ナイルオオトカゲ
Naʼashǫ́ʼii bideewozhii	トゲオアガマ属
Chʼał ntsxaaígíí	ゴライアスガエル
Naalʼeełí (bílaʼashdlaʼii bilį́į́ʼ)	アヒル
Yáhashjool	アメリカサンカノゴイ
Tsékááʼgóó naagháhii (chʼosh)	マントファスマ
Tłʼohtahilzhahí	アカノガンモドキ
Táłtłʼááh tsxilghááhtsoh	オオサンショウウオ科
Dibé dághaaʼígíí	ニホンカモシカ
Chʼééh digháhii bitsiiʼntsxaaígíí	オオアタマガメ
Tsékʼi naʼałkǫ́ʼii	ピレネーデスマン
Naʼastsʼǫǫsítsoh (chʼosh yildeełígíí)	ハイチソレノドン
Tsídiiłtsooí	キイロアメリカムシクイ
Chʼagii	ハゴロモガラス
Łéʼétsoh diwozhí	ジムヌラ
Tábąąstííntsoh łizhin dóó łigaiígíí	クラカケアザラシ
Naʼazísí	ホリネズミ
Łeeyiʼ chʼał dichʼízhí	メキシコジムグリガエル
Táłtłʼááh naatʼáʼii	セミホウボウ科
Naakaii Dootłʼizhí Dabikéyah	南アジア
Sháńdíín bitsʼą́ą́dę́ę́ʼ atsiniltłʼish álʼį́	ソーラーパネル
Naʼashǫ́ʼii kááʼtsʼinígíí	アルマジロトカゲ
Kinteel (Yootó Hahoodzo)	アズテック
Néʼétsah azeeʼ	ヒメムカシヨモギ
Atsá diłhiłígíí	カザノワシ
Iichʼąhii biyázhí	コナジラミ科
Kin Noodǫ́ǫ́z	ベルナリオ
Mágí biniiłgaígíí	シロガオサキ
Wónaʼałtéhii	ムシヒキアブ
Tłʼoh azihii	マオウ属
Tsídii bizééʼ naashchʼąąʼí	ジュケイ属
Dilzhę́ʼii	ステラーカケス
Chʼosh naʼałkǫ́ʼí	ガムシ
Tééh jádítsoh	イランド属
Łeeyiʼ bitiiní	ハタネズミ亜科
Atsáłbáí	ソウゲンハヤブサ
Dáádílítsoh	タマカイ
Tsʼánídílzhiʼí	アメリカカケス
Kiisʼáanii	プエブロ
Tiníléítsoh dootłʼizhígíí	ミドリホソオオトカゲ
Yáázhłání (naaldlooshii)	テンレック
Tábąąh łéʼétsoh	オオミズネズミ
Lókʼaaʼ yigházhígíí	アフリカアシネズミ
Tsídii bitʼaʼ dah adadootłʼizhígíí	コクジャク属
Dichin	飢餓
Hazéíntsxaaígíí	オオリス属
Chąąneiłmaasii	糞虫
Dzílí	クーパーハイタカ
Dah Naatʼaʼí Bééhoʼdílzin	忠誠の誓い (アメリカ)
Tó bichʼosh (tsiiyaago naʼałkǫ́ʼígíí)	マツモムシ
Tónteel táshchozhii	アジサシ亜科
Tówoł	タオス
Dóliiłchííʼ	チャカタルリツグミ
Łóóʼ binááʼ ádiní	ドウクツギョ科
Naʼashǫ́ʼii dootłʼizhí (naaldeehii)	クビワトカゲ
Naʼashǫ́ʼiiłbáhí	サバクイグアナ
Chʼoshtsoh bíláshgaanʼilí	キワ・ヒルスタ
Anáʼálwoʼ:Bee hadítʼéhígíí	Help:目次
Táłtłʼááh chʼoshtsoh bideeneezí	イセエビ科
Tiníléítsoh łikizhígíí	ペレンティーオオトカゲ
Wóósitsʼílí	トコジラミ
Biizhii	アメリカヨタカ
Kǫʼ naʼałbąąsii hééł bee nágéhéʼ	貨物列車
Jaaʼabaní	ココウモリ
Wóláchííʼ yildeełí	アリクイ
Niłchʼiʼ bee naalkaahiʼ	GOES
Tséʼédǫ́ʼii łibáhígíí	ニクバエ
Aniłtʼánii (naakaii náásééł nahalinígíí)	カマキリモドキ
Kin Łání (Dibé Nitsaa Hahoodzo)	デュランゴ (コロラド州)
Táłtłʼááh chʼoshtsoh bideeteelí	セミエビ科
Tábąąstííntsoh bighaaʼ díłchʼilígíí	オットセイ
Dlǫ́ʼiiłtsooí	テン
Táshchozhii dootłʼizhí	ムラサキツバメ (鳥)
Nihookááʼ tsídii bichʼahígíí	ジサイチョウ属
Azeeʼ hókánii łibáhígíí	オニノゲシ
Táłtłʼááh séigoʼ bitsʼaʼígíí	アメリカカブトガニ
Jáád neishoodítsʼóóz	ヒメバチ
Bitsiichįįshgahí	ハイイロホシガラス
Naʼashǫ́ʼii naatʼaʼí	トビトカゲ属
Iichʼąhii naashchʼąąʼígíí	ニシキオオツバメガ
Wóóseetsʼiniiniłhiní	カマドウマ
Tó bichʼosh (wónikǫsí nahalinígíí)	ミズカマキリ
Tsísʼnátsoh diłhiłígíí	クマバチ
Aniłtʼánii (bideeneezígíí)	ツノトンボ
Zábąąhnteelii (łóóʼ ooshgę́ęzhii)	シノノメサカタザメ
Sílátsoh (chʼil)	オオハンゴンソウ
Naaldlooshii Bikéshgaan Dahólónígíí	有蹄類
Nóódaʼí	ユト
Chʼééh digháhii bitsʼaʼ dah deezʼáhí	チズガメ属
Chʼosh bitsʼaʼ doolghasígíí	イタヤガイ科
Tsídii bidaatsoh naashchʼąąʼí	オオハシ科
Chʼał bikéshgaan hólóní	アフリカツメガエル
Tó bichʼosh (ałchozhígíí)	ミズムシ (昆虫)
Tłʼiish bichóhí	ヨコバイガラガラヘビ
Tsékʼi yaʼiiʼáhii	タバコスズメガ
Tsédááʼii	ササラダニ
Atʼaʼ éljołí nahalinígíí (táłtłʼááh chʼosh)	ケヤリムシ
Tʼááłáhági átʼéego:Bééshbichʼahí	Category:ドイツ
Tʼááłáhági átʼéego:Wááshindoon bikéyah ałhidadiidzooígíí	Category:アメリカ合衆国
Táłtłʼááh kʼaaʼ (łóóʼ)	ヤガラ科
Tʼááłáhági átʼéego:Dibé diníí bikéyah	Category:スペイン
Tʼááłáhági átʼéego:Naakaii Bikéyah	Category:メキシコ
Naalkʼįhí bizaʼazis hólóní	フクロモモンガ属
Naʼashǫ́ʼii diwozhígíí	オオヨロイトカゲ
Tsinlátah mąʼii	オリンゴ属
Chʼóyáázh nahalinígíí (táłtłʼááh chʼosh)	イバラカンザシ
Tʼááłáhági átʼéego:Bidił daazdoígíí dóó daʼałtʼoʼígíí	Category:哺乳類
Tʼááłáhági átʼéego:Naaldlooshii dadichʼízhii	Category:爬虫類
Tʼááłáhági átʼéego:Biyáázh Tsʼǫʼasánígíí	Category:両生類
Tʼááłáhági átʼéego:Tsídii	Category:鳥類
Tʼááłáhági átʼéego:Chʼosh doo yitʼíinii dláádí dóó Ábishjaaʼ	Category:菌類
Tʼááłáhági átʼéego:Chʼil	Category:植物
Tʼááłáhági átʼéego:Nátʼą́ą́ʼ náháneʼ	Category:歴史
Tʼááłáhági átʼéego:Naʼalkaah	Category:科学
Dził Nááyisí	サンディア山脈
Kiisʼáanii Naakáí yikʼéʼ daʼdéísdlį́į́h	プエブロの反乱
Tsin bizęęs	タマチョレイタケ属
Táłtłʼááh chʼosh chʼééh digháhii bikeeʼ nteelígíí	タマガイ科
Dah yiskʼid	塚
Táshchozhii ndiilkʼísii	サンショクツバメ
Aniłtʼánii łibáhígíí	マキバサシガメ
Iichʼąhii	ガ
Roman dinéʼiʼ	古代ローマ
Naabeehó	ナバホ・ネイション
Tábąąh naʼashǫ́ʼii	ウォータードラゴン属
Tséʼnaa Naʼníʼáhí	レインボーブリッジ国定公園
Kégiizhí	パパゴ
Tʼááłáhági átʼéego:Ałtsʼáʼáztiin	Category:曖昧さ回避
Yiikʼiʼdaʼ hiiznáʼ	攻撃 (戦術論)
Juan de Oñate	フアン・デ・オニャーテ
Atsá	鷲
Tsé Bitʼaʼí	シップロック
Ndilnaʼii	ナマケモノ
Chʼałtʼą́hí	ピパ属
Iichʼąhiiłgai bitʼaʼnézí	ナンベイオオヤガ
Tʼááłáhági átʼéego:Stubs	Category:スタブ
Tʼááłáhági átʼéego:Chidí naatʼaʼí	Category:航空機
Bee álnééhí:User uk-2	Template:User uk-2
Kin Łichííʼ (Yootó Hahoodzo)	サンフアン (ニューメキシコ州)
Naadą́ą́ʼ biyaʼ	コクゾウムシ
Tʼááłáhági átʼéego:Wikipedia bots	Category:Wikipedia bots
Tónteel zhį́ʼii	ウ科
Niłtsínii bikétłʼóól dijoolí (daadánígíí)	カブ
Tsídii bitseeʼ naashchʼąąʼí	クジャク属
Bee álnééhí:Tl	Template:Tl
Tʼááłáhági átʼéego:Bee Hazʼáanii	Category:法
Tʼááłáhági átʼéego:Kéyah daʼnaaznilígíí dóó kéyah biłhaʼdaʼhaasdzoígíí	Category:国
Wikiibíídiiya:Dahwéetʼaahígíí	Wikipedia:管理者
Wikiibíídiiya:Botígíí beehazʼą́ąnii	Wikipedia:Bot
Ííjip	エジプト
Bee álnééhí:Bot	Template:Bot
Deeteel Bikéyah	カナダ
Wikiibíídiiya:Baa haneʼ	Wikipedia:ウィキペディアについて
Tʼááłáhági átʼéego:Béésh bichʼahníí bikéyah	Category:ヨーロッパの国
Tʼááłáhági átʼéego:Choyoołʼįįhí Bizaad	Category:言語別の利用者
Anáʼálwoʼ:Wikiibíídiiya beehazʼą́ąnii	Wikipedia:方針とガイドライン
Tséłnííʼjí (chʼil)	ホウライシダ
Annie Dodge Wauneka	アニー・ドッジ・ワウネカ
Bee álnééhí:Softredirect	Template:Softredirect
Chʼosh chʼééh digháhii	腹足綱
Tʼááłáhági átʼéego:Saad	Category:諸言語
Wikiibíídiiya:General disclaimer	Wikipedia:免責事項
Tʼááłáhági átʼéego:Noindexed pages	Category:検索エンジンに収集されないページ
Wikiibíídiiya:Statistics	Wikipedia:統計
Tótsʼózí	コンチョ (アリゾナ州)
Łóóʼ hashkéhéchilí	ギンザメ目
Tʼááłáhági átʼéego:Living people	Category:存命人物
Tʼááłáhági átʼéego:Béésh bee akʼeʼelchíhí tʼáá bí nitsékeesígíí	Category:コンピュータ
Bee álnééhí:!	Template:!
Bee álnééhí:Bots	Template:Bots
Tʼááłáhági átʼéego:Naaltsoos	Category:書物
Bee álnééhí:Wikisource	Template:Wikisource
Bee álnééhí:Babel	Template:Babel
Bee álnééhí:Commons	Template:Commons
Bee álnééhí:Reflist	Template:Reflist
Bee álnééhí:Stub	Template:Stub
Bee álnééhí:User af-1	Template:User af-1
Bee álnééhí:User als-1	Template:User als-1
Bee álnééhí:User ar-1	Template:User ar-1
Bee álnééhí:User az	Template:User az
Bee álnééhí:User eo-1	Template:User eo-1
Bee álnééhí:See also	Template:See also
Bee álnééhí:User da-2	Template:User da-2
Bee álnééhí:User da	Template:User da
Bee álnééhí:User ca-1	Template:User ca-1
Bee álnééhí:User be-2	Template:User be-2
Bee álnééhí:User da-1	Template:User da-1
Bee álnééhí:User cs-1	Template:User cs-1
Bee álnééhí:User bg-1	Template:User bg-1
Bee álnééhí:User eo-3	Template:User eo-3
Bee álnééhí:User de	Template:User de
Bee álnééhí:User de-1	Template:User de-1
Bee álnééhí:User eu-4	Template:User eu-4
Bee álnééhí:User eu	Template:User eu
Bee álnééhí:User et-1	Template:User et-1
Bee álnééhí:User el	Template:User el
Bee álnééhí:User es	Template:User es
Bee álnééhí:User de-3	Template:User de-3
Bee álnééhí:User en-3	Template:User en-3
Bee álnééhí:User el-1	Template:User el-1
Bee álnééhí:User en-1	Template:User en-1
Bee álnééhí:User en-2	Template:User en-2
Bee álnééhí:User fa-1	Template:User fa-1
Bee álnééhí:User eo-2	Template:User eo-2
Bee álnééhí:User en-4	Template:User en-4
Bee álnééhí:User fi	Template:User fi
Bee álnééhí:User en-0	Template:User en-0
Bee álnééhí:User es-4	Template:User es-4
Bee álnééhí:User en	Template:User en
Bee álnééhí:User de-2	Template:User de-2
Bee álnééhí:User es-1	Template:User es-1
Bee álnééhí:User fa	Template:User fa
Bee álnééhí:User fi-1	Template:User fi-1
Bee álnééhí:User fr-1	Template:User fr-1
Bee álnééhí:User ia-2	Template:User ia-2
Bee álnééhí:User hi-1	Template:User hi-1
Bee álnééhí:User hr	Template:User hr
Bee álnééhí:User he-2	Template:User he-2
Bee álnééhí:User he-1	Template:User he-1
Bee álnééhí:User hu	Template:User hu
Bee álnééhí:User id-3	Template:User id-3
Bee álnééhí:User io-3	Template:User io-3
Bee álnééhí:User it-3	Template:User it-3
Bee álnééhí:User ja-4	Template:User ja-4
Bee álnééhí:User sk	Template:User sk
Bee álnééhí:User tr-2	Template:User tr-2
Bee álnééhí:User fr-2	Template:User fr-2
Bee álnééhí:User tr	Template:User tr
Bee álnééhí:User ja	Template:User ja
Bee álnééhí:User ja-1	Template:User ja-1
Bee álnééhí:User it-1	Template:User it-1
Bee álnééhí:User hr-1	Template:User hr-1
Bee álnééhí:User fr	Template:User fr
Bee álnééhí:User he	Template:User he
Tʼááłáhági átʼéego:Chʼosh bijáád hastánígíí	Category:昆虫
Tʼááłáhági átʼéego:Choyoołʼįįhí uk	Category:User uk
Tʼááłáhági átʼéego:Choyoołʼįįhí uk-N	Category:User uk-N
Tʼááłáhági átʼéego:Chʼiyáán	Category:食品
Bee álnééhí:User sv	Template:User sv
Bee álnééhí:SIL	Template:Infobox Language/codelist
Bee álnééhí:User it	Template:User it
Bee álnééhí:User uk	Template:User uk
Bee álnééhí:User es-2	Template:User es-2
Tʼááłáhági átʼéego:Choyoołʼįįhí ms	Category:User ms
Tʼááłáhági átʼéego:Choyoołʼįįhí fr-1	Category:User fr-1
Bee álnééhí:User chr-1	Template:User chr-1
Bee álnééhí:Image label	Template:Image label
Bee álnééhí:User ms	Template:User ms
Tʼááłáhági átʼéego:Atsá dóó Giní Ndahalinígíí	Category:タカ目
Bee álnééhí:User hi-3	Template:User hi-3
Tʼááłáhági átʼéego:Choyoołʼįįhí en-4	Category:User en-4
Tʼááłáhági átʼéego:Choyoołʼįįhí en	Category:User en
Tʼááłáhági átʼéego:Choyoołʼįįhí zh	Category:User zh
Tʼááłáhági átʼéego:Choyoołʼįįhí zh-N	Category:User zh-N
Tʼááłáhági átʼéego:Choyoołʼįįhí en-2	Category:User en-2
Bee álnééhí:User eo	Template:User eo
Bee álnééhí:User zh	Template:User zh
Bee álnééhí:User ru-4	Template:User ru-4
Bee álnééhí:User sr	Template:User sr
Bee álnééhí:GeoTemplate	Template:GeoTemplate
Bee álnééhí:User nl-1	Template:User nl-1
Bee álnééhí:User nl-2	Template:User nl-2
Tʼááłáhági átʼéego:Néʼéshjaaʼ	Category:フクロウ目
Tʼááłáhági átʼéego:Choyoołʼįįhí hi	Category:User hi
Tʼááłáhági átʼéego:Choyoołʼįįhí ms-N	Category:User ms-N
Tʼááłáhági átʼéego:Dził	Category:山
Bee álnééhí:User ru	Template:User ru
Tʼááłáhági átʼéego:Kéyah yádiłhił biiʼ dahólónígíí	Category:太陽系の惑星
Tʼááłáhági átʼéego:Kéyah dah siʼánígíí	Category:アメリカ
Tʼááłáhági átʼéego:Choyoołʼįįhí bizaad-Templates	Category:バベル
Bee álnééhí:Archive	Template:Archive box
Bee álnééhí:User eo-4	Template:User eo-4
Tʼááłáhági átʼéego:Siláołtsooí	Category:軍事
Tʼááłáhági átʼéego:Naʼashǫ́ʼii	Category:トカゲ
Bee álnééhí:User pt-1	Template:User pt-1
Bee álnééhí:Pt elements	Template:元素周期表
Bee álnééhí:User oc-4	Template:User oc-4
Bee álnééhí:User pl	Template:User pl
Bee álnééhí:User nl	Template:User nl
Bee álnééhí:User no-2	Template:User no-2
Bee álnééhí:Image label end	Template:Image label end
Bee álnééhí:Userpage	Template:Userpage
Bee álnééhí:Emergency-bot-shutoff	Template:Emergency-bot-shutoff
Bee álnééhí:User pl-1	Template:User pl-1
Bee álnééhí:Image label small	Template:Image label small
Bee álnééhí:Béésh Bich’ahníí Bikéyah	Template:ヨーロッパ地図
Bee álnééhí:User fr-3	Template:User fr-3
Bee álnééhí:User lt	Template:User lt
Bee álnééhí:User nds-1	Template:User nds-1
Tʼááłáhági átʼéego:Hosh	Category:サボテン科
Díłdánii (Ałtsʼáʼáztiin)	ウズラ類
Bee álnééhí:User is-1	Template:User is-1
Bee álnééhí:User is-2	Template:User is-2
Bee álnééhí:User ar-2	Template:User ar-2
Bee álnééhí:User ar-3	Template:User ar-3
Bee álnééhí:User is	Template:User is
Bee álnééhí:User ar	Template:User ar
Bee álnééhí:User en-5	Template:User en-5
Tʼááłáhági átʼéego:Choyoołʼįįhí ja-N	Category:User ja-N
Bee álnééhí:User als	Template:User als
Tʼááłáhági átʼéego:Tłʼoh	Category:イネ科
Bee álnééhí:Ałtsʼáʼáztiin	Template:Aimai
Bee álnééhí:User no-3	Template:User no-3
Bee álnééhí:User yue-3	Template:User zh-yue-3
Bee álnééhí:User no	Template:User no
Bee álnééhí:User yue-1	Template:User zh-yue-1
Bee álnééhí:Chʼiyáánbiiʼ	Template:栄養価
Bee álnééhí:Naʼalkaah	Template:科学
Bee álnééhí:User sv-2	Template:User sv-2
Bee álnééhí:User it-2	Template:User it-2
Tʼááłáhági átʼéego:Kǫʼ naʼałbąąsii	Category:鉄道
Bee álnééhí:User pt-3	Template:User pt-3
Bee álnééhí:User pt-2	Template:User pt-2
Bee álnééhí:User th-1	Template:User th-1
Bee álnééhí:User lb-1	Template:User lb-1
Bee álnééhí:User ro	Template:User ro
Bee álnééhí:User fr-4	Template:User fr-4
Bee álnééhí:User lv	Template:User lv
Bee álnééhí:User bg	Template:User bg
Tʼááłáhági átʼéego:Choyoołʼįįhí vi-3	Category:User vi-3
Bee álnééhí:User la-1	Template:User la-1
Tʼááłáhági átʼéego:Templates/doc	Category:テンプレート文書
Tʼááłáhági átʼéego:Choyoołʼįįhí yue	Category:User zh-yue
Tʼááłáhági átʼéego:Choyoołʼįįhí mzn	Category:User mzn
Tʼááłáhági átʼéego:Choyoołʼįįhí az	Category:User az
Tʼááłáhági átʼéego:Choyoołʼįįhí be	Category:User be
Tʼááłáhági átʼéego:Choyoołʼįįhí nb-N	Category:User nb-N
Tʼááłáhági átʼéego:Choyoołʼįįhí bs	Category:User bs
Tʼááłáhági átʼéego:Choyoołʼįįhí chr	Category:User chr
Tʼááłáhági átʼéego:Choyoołʼįįhí hr	Category:User hr
Tʼááłáhági átʼéego:Choyoołʼįįhí sk	Category:User sk
Tʼááłáhági átʼéego:Choyoołʼįįhí sl	Category:User sl
Tʼááłáhági átʼéego:Choyoołʼįįhí eo	Category:User eo
Tʼááłáhági átʼéego:Choyoołʼįįhí et	Category:User et
Tʼááłáhági átʼéego:Choyoołʼįįhí fr	Category:User fr
Tʼááłáhági átʼéego:Choyoołʼįįhí gl	Category:User gl
Tʼááłáhági átʼéego:Choyoołʼįįhí cy	Category:User cy
Tʼááłáhági átʼéego:Choyoołʼįįhí gn	Category:User gn
Tʼááłáhági átʼéego:Choyoołʼįįhí hu-N	Category:User hu-N
Tʼááłáhági átʼéego:Choyoołʼįįhí id	Category:User id
Tʼááłáhági átʼéego:Choyoołʼįįhí ia	Category:User ia
Tʼááłáhági átʼéego:Choyoołʼįįhí ga	Category:User ga
Tʼááłáhági átʼéego:Choyoołʼįįhí ja	Category:User ja
Tʼááłáhági átʼéego:Choyoołʼįįhí km	Category:User km
Tʼááłáhági átʼéego:Choyoołʼįįhí rn	Category:User rn
Tʼááłáhági átʼéego:Choyoołʼįįhí la	Category:User la
Tʼááłáhági átʼéego:Choyoołʼįįhí li	Category:User li
Tʼááłáhági átʼéego:Choyoołʼįįhí lt	Category:User lt
Tʼááłáhági átʼéego:Choyoołʼįįhí mk	Category:User mk
Tʼááłáhági átʼéego:Choyoołʼįįhí mg	Category:User mg
Tʼááłáhági átʼéego:Choyoołʼįįhí mwl	Category:User mwl
Tʼááłáhági átʼéego:Choyoołʼįįhí mn	Category:User mn
Tʼááłáhági átʼéego:Choyoołʼįįhí nn	Category:User nn
Tʼááłáhági átʼéego:Choyoołʼįįhí oc	Category:User oc
Tʼááłáhági átʼéego:Choyoołʼįįhí pt	Category:User pt
Tʼááłáhági átʼéego:Choyoołʼįįhí ro	Category:User ro
Tʼááłáhági átʼéego:Choyoołʼįįhí sc	Category:User sc
Tʼááłáhági átʼéego:Choyoołʼįįhí sh	Category:User sh
Tʼááłáhági átʼéego:Choyoołʼįįhí sv	Category:User sv
Tʼááłáhági átʼéego:Choyoołʼįįhí sw	Category:User sw
Tʼááłáhági átʼéego:Choyoołʼįįhí sa	Category:User sa
Tʼááłáhági átʼéego:Choyoołʼįįhí th	Category:User th
Tʼááłáhági átʼéego:Choyoołʼįįhí ta	Category:User ta
Tʼááłáhági átʼéego:Choyoołʼįįhí bar-3	Category:User bar-3
Tʼááłáhági átʼéego:Choyoołʼįįhí az-3	Category:User az-3
Tʼááłáhági átʼéego:Choyoołʼįįhí be-3	Category:User be-3
Tʼááłáhági átʼéego:Choyoołʼįįhí cs-3	Category:User cs-3
Tʼááłáhági átʼéego:Choyoołʼįįhí sl-3	Category:User sl-3
Tʼááłáhági átʼéego:Choyoołʼįįhí et-3	Category:User et-3
Tʼááłáhági átʼéego:Choyoołʼįįhí fr-3	Category:User fr-3
Tʼááłáhági átʼéego:Choyoołʼįįhí cy-3	Category:User cy-3
Tʼááłáhági átʼéego:Choyoołʼįįhí hi-3	Category:User hi-3
Tʼááłáhági átʼéego:Choyoołʼįįhí ia-3	Category:User ia-3
Tʼááłáhági átʼéego:Choyoołʼįįhí it-3	Category:User it-3
Tʼááłáhági átʼéego:Choyoołʼįįhí ja-3	Category:User ja-3
Tʼááłáhági átʼéego:Choyoołʼįįhí li-3	Category:User li-3
Tʼááłáhági átʼéego:Choyoołʼįįhí lt-3	Category:User lt-3
Tʼááłáhági átʼéego:Choyoołʼįįhí mk-3	Category:User mk-3
Tʼááłáhági átʼéego:Choyoołʼįįhí nl-3	Category:User nl-3
Tʼááłáhági átʼéego:Choyoołʼįįhí no-3	Category:User no-3
Tʼááłáhági átʼéego:Choyoołʼįįhí oc-3	Category:User oc-3
Tʼááłáhági átʼéego:Choyoołʼįįhí pl-3	Category:User pl-3
Tʼááłáhági átʼéego:Choyoołʼįįhí sw-3	Category:User sw-3
Tʼááłáhági átʼéego:Choyoołʼįįhí sa-3	Category:User sa-3
Tʼááłáhági átʼéego:Choyoołʼįįhí ta-3	Category:User ta-3
Tʼááłáhági átʼéego:Choyoołʼįįhí tr-3	Category:User tr-3
Tʼááłáhági átʼéego:Choyoołʼįįhí ar-3	Category:User ar-3
Tʼááłáhági átʼéego:Choyoołʼįįhí an-1	Category:User an-1
Tʼááłáhági átʼéego:Choyoołʼįįhí be-1	Category:User be-1
Tʼááłáhági átʼéego:Choyoołʼįįhí cs-1	Category:User cs-1
Tʼááłáhági átʼéego:Choyoołʼįįhí da-1	Category:User da-1
Tʼááłáhági átʼéego:Choyoołʼįįhí sl-1	Category:User sl-1
Tʼááłáhági átʼéego:Choyoołʼįįhí et-1	Category:User et-1
Tʼááłáhági átʼéego:Choyoołʼįįhí fi-1	Category:User fi-1
Tʼááłáhági átʼéego:Choyoołʼįįhí cy-1	Category:User cy-1
Tʼááłáhági átʼéego:Choyoołʼįįhí hi-1	Category:User hi-1
Tʼááłáhági átʼéego:Choyoołʼįįhí ia-1	Category:User ia-1
Tʼááłáhági átʼéego:Choyoołʼįįhí ga-1	Category:User ga-1
Tʼááłáhági átʼéego:Choyoołʼįįhí jv-1	Category:User jv-1
Tʼááłáhági átʼéego:Choyoołʼįįhí ku-1	Category:User ku-1
Tʼááłáhági átʼéego:Choyoołʼįįhí lv-1	Category:User lv-1
Tʼááłáhági átʼéego:Choyoołʼįįhí li-1	Category:User li-1
Tʼááłáhági átʼéego:Choyoołʼįįhí lt-1	Category:User lt-1
Tʼááłáhági átʼéego:Choyoołʼįįhí mk-1	Category:User mk-1
Tʼááłáhági átʼéego:Choyoołʼįįhí nl-1	Category:User nl-1
Tʼááłáhági átʼéego:Choyoołʼįįhí oc-1	Category:User oc-1
Tʼááłáhági átʼéego:Choyoołʼįįhí pl-1	Category:User pl-1
Tʼááłáhági átʼéego:Choyoołʼįįhí ro-1	Category:User ro-1
Tʼááłáhági átʼéego:Choyoołʼįįhí sw-1	Category:User sw-1
Tʼááłáhági átʼéego:Choyoołʼįįhí sa-1	Category:User sa-1
Tʼááłáhági átʼéego:Choyoołʼįįhí tr-1	Category:User tr-1
Tʼááłáhági átʼéego:Choyoołʼįįhí ar-1	Category:User ar-1
Tʼááłáhági átʼéego:Choyoołʼįįhí ko-4	Category:User ko-4
Tʼááłáhági átʼéego:Choyoołʼįįhí fr-4	Category:User fr-4
Tʼááłáhági átʼéego:Choyoołʼįįhí hu-4	Category:User hu-4
Tʼááłáhági átʼéego:Choyoołʼįįhí it-4	Category:User it-4
Tʼááłáhági átʼéego:Choyoołʼįįhí lt-4	Category:User lt-4
Tʼááłáhági átʼéego:Choyoołʼįįhí oc-4	Category:User oc-4
Tʼááłáhági átʼéego:Choyoołʼįįhí pl-4	Category:User pl-4
Tʼááłáhági átʼéego:Choyoołʼįįhí ar-4	Category:User ar-4
Tʼááłáhági átʼéego:Choyoołʼįįhí als-2	Category:User als-2
Tʼááłáhági átʼéego:Choyoołʼįįhí be-2	Category:User be-2
Tʼááłáhági átʼéego:Choyoołʼįįhí bs-2	Category:User bs-2
Tʼááłáhági átʼéego:Choyoołʼįįhí cs-2	Category:User cs-2
Tʼááłáhági átʼéego:Choyoołʼįįhí da-2	Category:User da-2
Tʼááłáhági átʼéego:Choyoołʼįįhí sk-2	Category:User sk-2
Tʼááłáhági átʼéego:Choyoołʼįįhí sl-2	Category:User sl-2
Tʼááłáhági átʼéego:Choyoołʼįįhí et-2	Category:User et-2
Tʼááłáhági átʼéego:Choyoołʼįįhí fr-2	Category:User fr-2
Tʼááłáhági átʼéego:Choyoołʼįįhí cy-2	Category:User cy-2
Tʼááłáhági átʼéego:Choyoołʼįįhí gn-2	Category:User gn-2
Tʼááłáhági átʼéego:Choyoołʼįįhí hi-2	Category:User hi-2
Tʼááłáhági átʼéego:Choyoołʼįįhí hu-2	Category:User hu-2
Tʼááłáhági átʼéego:Choyoołʼįįhí ia-2	Category:User ia-2
Tʼááłáhági átʼéego:Choyoołʼįįhí it-2	Category:User it-2
Tʼááłáhági átʼéego:Choyoołʼįįhí ja-2	Category:User ja-2
Tʼááłáhági átʼéego:Choyoołʼįįhí la-2	Category:User la-2
Tʼááłáhági átʼéego:Choyoołʼįįhí li-2	Category:User li-2
Tʼááłáhági átʼéego:Choyoołʼįįhí lt-2	Category:User lt-2
Tʼááłáhági átʼéego:Choyoołʼįįhí mk-2	Category:User mk-2
Tʼááłáhági átʼéego:Choyoołʼįįhí mwl-2	Category:User mwl-2
Tʼááłáhági átʼéego:Choyoołʼįįhí nl-2	Category:User nl-2
Tʼááłáhági átʼéego:Choyoołʼįįhí oc-2	Category:User oc-2
Tʼááłáhági átʼéego:Choyoołʼįįhí pl-2	Category:User pl-2
Tʼááłáhági átʼéego:Choyoołʼįįhí sh-2	Category:User sh-2
Tʼááłáhági átʼéego:Choyoołʼįįhí sv-2	Category:User sv-2
Tʼááłáhági átʼéego:Choyoołʼįįhí sw-2	Category:User sw-2
Tʼááłáhági átʼéego:Choyoołʼįįhí sa-2	Category:User sa-2
Tʼááłáhági átʼéego:Choyoołʼįįhí tr-2	Category:User tr-2
Tʼááłáhági átʼéego:Choyoołʼįįhí ar-2	Category:User ar-2
Tʼááłáhági átʼéego:Choyoołʼįįhí an-N	Category:User an-N
Tʼááłáhági átʼéego:Choyoołʼįįhí hy-N	Category:User hy-N
Tʼááłáhági átʼéego:Choyoołʼįįhí ast-N	Category:User ast-N
Tʼááłáhági átʼéego:Choyoołʼįįhí be-N	Category:User be-N
Tʼááłáhági átʼéego:Choyoołʼįįhí cs-N	Category:User cs-N
Tʼááłáhági átʼéego:Choyoołʼįįhí chr-N	Category:User chr-N
Tʼááłáhági átʼéego:Choyoołʼįįhí ko-N	Category:User ko-N
Tʼááłáhági átʼéego:Choyoołʼįįhí hr-N	Category:User hr-N
Tʼááłáhági átʼéego:Choyoołʼįįhí sl-N	Category:User sl-N
Tʼááłáhági átʼéego:Choyoołʼįįhí et-N	Category:User et-N
Tʼááłáhági átʼéego:Choyoołʼįįhí fr-N	Category:User fr-N
Tʼááłáhági átʼéego:Choyoołʼįįhí fy-N	Category:User fy-N
Tʼááłáhági átʼéego:Choyoołʼįįhí gl-N	Category:User gl-N
Tʼááłáhági átʼéego:Choyoołʼįįhí cy-N	Category:User cy-N
Tʼááłáhági átʼéego:Choyoołʼįįhí hi-N	Category:User hi-N
Tʼááłáhági átʼéego:Choyoołʼįįhí id-N	Category:User id-N
Tʼááłáhági átʼéego:Choyoołʼįįhí ia-N	Category:User ia-N
Tʼááłáhági átʼéego:Choyoołʼįįhí is-N	Category:User is-N
Tʼááłáhági átʼéego:Choyoołʼįįhí it-N	Category:User it-N
Tʼááłáhági átʼéego:Choyoołʼįįhí jv-N	Category:User jv-N
Tʼááłáhági átʼéego:Choyoołʼįįhí ku-N	Category:User ku-N
Tʼááłáhági átʼéego:Choyoołʼįįhí lv-N	Category:User lv-N
Tʼááłáhági átʼéego:Choyoołʼįįhí li-N	Category:User li-N
Tʼááłáhági átʼéego:Choyoołʼįįhí lt-N	Category:User lt-N
Tʼááłáhági átʼéego:Choyoołʼįįhí lb-N	Category:User lb-N
Tʼááłáhági átʼéego:Choyoołʼįįhí mk-N	Category:User mk-N
Tʼááłáhági átʼéego:Choyoołʼįįhí mg-N	Category:User mg-N
Tʼááłáhági átʼéego:Choyoołʼįįhí nl-N	Category:User nl-N
Tʼááłáhági átʼéego:Choyoołʼįįhí no-N	Category:User no-N
Tʼááłáhági átʼéego:Choyoołʼįįhí nn-N	Category:User nn-N
Tʼááłáhági átʼéego:Choyoołʼįįhí oc-N	Category:User oc-N
Tʼááłáhági átʼéego:Choyoołʼįįhí or-N	Category:User or-N
Tʼááłáhági átʼéego:Choyoołʼįįhí ru-N	Category:User ru-N
Tʼááłáhági átʼéego:Choyoołʼįįhí sw-N	Category:User sw-N
Tʼááłáhági átʼéego:Choyoołʼįįhí sa-N	Category:User sa-N
Tʼááłáhági átʼéego:Choyoołʼįįhí ta-N	Category:User ta-N
Tʼááłáhági átʼéego:Choyoołʼįįhí ar-N	Category:User ar-N
Bee álnééhí:User yue	Template:User zh-yue
Tʼááłáhági átʼéego:Choyoołʼįįhí eu-3	Category:User eu-3
Tʼááłáhági átʼéego:Choyoołʼįįhí eu-N	Category:User eu-N
Tʼááłáhági átʼéego:Choyoołʼįįhí af	Category:User af
Tʼááłáhági átʼéego:Choyoołʼįįhí af-1	Category:User af-1
Tʼááłáhági átʼéego:Choyoołʼįįhí af-2	Category:User af-2
Tʼááłáhági átʼéego:Choyoołʼįįhí af-3	Category:User af-3
Tʼááłáhági átʼéego:Choyoołʼįįhí af-4	Category:User af-4
Tʼááłáhági átʼéego:Choyoołʼįįhí af-N	Category:User af-N
Tʼááłáhági átʼéego:Choyoołʼįįhí als	Category:User als
Tʼááłáhági átʼéego:Choyoołʼįįhí als-1	Category:User als-1
Tʼááłáhági átʼéego:Choyoołʼįįhí an	Category:User an
Tʼááłáhági átʼéego:Choyoołʼįįhí ar	Category:User ar
Tʼááłáhági átʼéego:Choyoołʼįįhí as	Category:User as
Tʼááłáhági átʼéego:Choyoołʼįįhí as-N	Category:User as-N
Tʼááłáhági átʼéego:Choyoołʼįįhí ast	Category:User ast
Tʼááłáhági átʼéego:Choyoołʼįįhí ay	Category:User ay
Tʼááłáhági átʼéego:Choyoołʼįįhí ay-1	Category:User ay-1
Tʼááłáhági átʼéego:Choyoołʼįįhí ay-4	Category:User ay-4
Tʼááłáhági átʼéego:Choyoołʼįįhí az-1	Category:User az-1
Tʼááłáhági átʼéego:Choyoołʼįįhí az-2	Category:User az-2
Tʼááłáhági átʼéego:Choyoołʼįįhí az-4	Category:User az-4
Tʼááłáhági átʼéego:Choyoołʼįįhí az-N	Category:User az-N
Tʼááłáhági átʼéego:Choyoołʼįįhí ba	Category:User ba
Tʼááłáhági átʼéego:Choyoołʼįįhí ba-1	Category:User ba-1
Tʼááłáhági átʼéego:Choyoołʼįįhí ba-2	Category:User ba-2
Tʼááłáhági átʼéego:Choyoołʼįįhí bar	Category:User bar
Tʼááłáhági átʼéego:Choyoołʼįįhí bar-1	Category:User bar-1
Tʼááłáhági átʼéego:Choyoołʼįįhí bar-2	Category:User bar-2
Tʼááłáhági átʼéego:Choyoołʼįįhí bar-4	Category:User bar-4
Tʼááłáhági átʼéego:Choyoołʼįįhí bar-N	Category:User bar-N
Tʼááłáhági átʼéego:Choyoołʼįįhí bg	Category:User bg
Tʼááłáhági átʼéego:Choyoołʼįįhí bg-1	Category:User bg-1
Tʼááłáhági átʼéego:Choyoołʼįįhí bg-2	Category:User bg-2
Tʼááłáhági átʼéego:Choyoołʼįįhí bg-3	Category:User bg-3
Tʼááłáhági átʼéego:Choyoołʼįįhí bg-N	Category:User bg-N
Tʼááłáhági átʼéego:Choyoołʼįįhí bn	Category:User bn
Tʼááłáhági átʼéego:Choyoołʼįįhí bn-2	Category:User bn-2
Tʼááłáhági átʼéego:Choyoołʼįįhí bn-N	Category:User bn-N
Tʼááłáhági átʼéego:Choyoołʼįįhí ca	Category:User ca
Tʼááłáhági átʼéego:Choyoołʼįįhí ca-1	Category:User ca-1
Tʼááłáhági átʼéego:Choyoołʼįįhí ca-2	Category:User ca-2
Tʼááłáhági átʼéego:Tádídíín deiyání	Category:ハムシ
Tʼááłáhági átʼéego:Choyoołʼįįhí ca-3	Category:User ca-3
Tʼááłáhági átʼéego:Choyoołʼįįhí ca-N	Category:User ca-N
Tʼááłáhági átʼéego:Choyoołʼįįhí chr-1	Category:User chr-1
Tʼááłáhági átʼéego:Choyoołʼįįhí chr-2	Category:User chr-2
Tʼááłáhági átʼéego:Choyoołʼįįhí cs	Category:User cs
Tʼááłáhági átʼéego:Choyoołʼįįhí csb	Category:User csb
Tʼááłáhági átʼéego:Choyoołʼįįhí csb-1	Category:User csb-1
Tʼááłáhági átʼéego:Choyoołʼįįhí da	Category:User da
Tʼááłáhági átʼéego:Choyoołʼįįhí sk-N	Category:User sk-N
Tʼááłáhági átʼéego:Choyoołʼįįhí da-3	Category:User da-3
Tʼááłáhági átʼéego:Choyoołʼįįhí de	Category:User de
Tʼááłáhági átʼéego:Choyoołʼįįhí de-2	Category:User de-2
Tʼááłáhági átʼéego:Choyoołʼįįhí de-3	Category:User de-3
Tʼááłáhági átʼéego:Choyoołʼįįhí de-4	Category:User de-4
Tʼááłáhági átʼéego:Choyoołʼįįhí de-N	Category:User de-N
Tʼááłáhági átʼéego:Choyoołʼįįhí dsb	Category:User dsb
Tʼááłáhági átʼéego:Choyoołʼįįhí dsb-1	Category:User dsb-1
Tʼááłáhági átʼéego:Choyoołʼįįhí el	Category:User el
Tʼááłáhági átʼéego:Choyoołʼįįhí el-1	Category:User el-1
Tʼááłáhági átʼéego:Choyoołʼįįhí el-2	Category:User el-2
Tʼááłáhági átʼéego:Choyoołʼįįhí el-3	Category:User el-3
Tʼááłáhági átʼéego:Choyoołʼįįhí el-N	Category:User el-N
Tʼááłáhági átʼéego:Choyoołʼįįhí en-3	Category:User en-3
Tʼááłáhági átʼéego:Choyoołʼįįhí en-5	Category:User en-5
Tʼááłáhági átʼéego:Choyoołʼįįhí en-N	Category:User en-N
Tʼááłáhági átʼéego:Choyoołʼįįhí eo-1	Category:User eo-1
Tʼááłáhági átʼéego:Choyoołʼįįhí eo-2	Category:User eo-2
Tʼááłáhági átʼéego:Choyoołʼįįhí eo-3	Category:User eo-3
Tʼááłáhági átʼéego:Choyoołʼįįhí eo-4	Category:User eo-4
Tʼááłáhági átʼéego:Choyoołʼįįhí eo-N	Category:User eo-N
Tʼááłáhági átʼéego:Choyoołʼįįhí es	Category:User es
Tʼááłáhági átʼéego:Choyoołʼįįhí es-1	Category:User es-1
Tʼááłáhági átʼéego:Choyoołʼįįhí es-2	Category:User es-2
Tʼááłáhági átʼéego:Choyoołʼįįhí es-3	Category:User es-3
Tʼááłáhági átʼéego:Choyoołʼįįhí es-4	Category:User es-4
Tʼááłáhági átʼéego:Choyoołʼįįhí es-N	Category:User es-N
Tʼááłáhági átʼéego:Choyoołʼįįhí eu	Category:User eu
Tʼááłáhági átʼéego:Choyoołʼįįhí eu-1	Category:User eu-1
Tʼááłáhági átʼéego:Choyoołʼįįhí eu-2	Category:User eu-2
Tʼááłáhági átʼéego:Choyoołʼįįhí eu-4	Category:User eu-4
Tʼááłáhági átʼéego:Choyoołʼįįhí fa	Category:User fa
Tʼááłáhági átʼéego:Choyoołʼįįhí fa-1	Category:User fa-1
Tʼááłáhági átʼéego:Choyoołʼįįhí fa-2	Category:User fa-2
Tʼááłáhági átʼéego:Choyoołʼįįhí fa-3	Category:User fa-3
Tʼááłáhági átʼéego:Choyoołʼįįhí fa-N	Category:User fa-N
Tʼááłáhági átʼéego:Choyoołʼįįhí fi	Category:User fi
Tʼááłáhági átʼéego:Choyoołʼįįhí fi-2	Category:User fi-2
Tʼááłáhági átʼéego:Choyoołʼįįhí fi-3	Category:User fi-3
Tʼááłáhági átʼéego:Choyoołʼįįhí fi-4	Category:User fi-4
Tʼááłáhági átʼéego:Choyoołʼįįhí fi-N	Category:User fi-N
Tʼááłáhági átʼéego:Choyoołʼįįhí fy	Category:User fy
Tʼááłáhági átʼéego:Choyoołʼįįhí fy-1	Category:User fy-1
Tʼááłáhági átʼéego:Choyoołʼįįhí ga-2	Category:User ga-2
Tʼááłáhági átʼéego:Choyoołʼįįhí ga-3	Category:User ga-3
Tʼááłáhági átʼéego:Choyoołʼįįhí ga-N	Category:User ga-N
Tʼááłáhági átʼéego:Choyoołʼįįhí grc	Category:User grc
Tʼááłáhági átʼéego:Choyoołʼįįhí grc-3	Category:User grc-3
Tʼááłáhági átʼéego:Choyoołʼįįhí he	Category:User he
Tʼááłáhági átʼéego:Choyoołʼįįhí he-1	Category:User he-1
Tʼááłáhági átʼéego:Choyoołʼįįhí he-2	Category:User he-2
Tʼááłáhági átʼéego:Choyoołʼįįhí he-3	Category:User he-3
Tʼááłáhági átʼéego:Choyoołʼįįhí he-4	Category:User he-4
Tʼááłáhági átʼéego:Choyoołʼįįhí he-N	Category:User he-N
Tʼááłáhági átʼéego:Choyoołʼįįhí hr-1	Category:User hr-1
Tʼááłáhági átʼéego:Choyoołʼįįhí hr-2	Category:User hr-2
Tʼááłáhági átʼéego:Choyoołʼįįhí hr-3	Category:User hr-3
Tʼááłáhági átʼéego:Choyoołʼįįhí hr-4	Category:User hr-4
Tʼááłáhági átʼéego:Choyoołʼįįhí hsb	Category:User hsb
Tʼááłáhági átʼéego:Choyoołʼįįhí hsb-1	Category:User hsb-1
Tʼááłáhági átʼéego:Choyoołʼįįhí hu	Category:User hu
Tʼááłáhági átʼéego:Choyoołʼįįhí hu-1	Category:User hu-1
Tʼááłáhági átʼéego:Choyoołʼįįhí hu-3	Category:User hu-3
Tʼááłáhági átʼéego:Choyoołʼįįhí hy	Category:User hy
Tʼááłáhági átʼéego:Choyoołʼįįhí hy-1	Category:User hy-1
Tʼááłáhági átʼéego:Choyoołʼįįhí hy-2	Category:User hy-2
Tʼááłáhági átʼéego:Choyoołʼįįhí hy-3	Category:User hy-3
Tʼááłáhági átʼéego:Choyoołʼįįhí hy-4	Category:User hy-4
Tʼááłáhági átʼéego:Choyoołʼįįhí id-1	Category:User id-1
Tʼááłáhági átʼéego:Choyoołʼįįhí id-2	Category:User id-2
Tʼááłáhági átʼéego:Choyoołʼįįhí id-3	Category:User id-3
Tʼááłáhági átʼéego:Choyoołʼįįhí io	Category:User io
Tʼááłáhági átʼéego:Choyoołʼįįhí io-1	Category:User io-1
Tʼááłáhági átʼéego:Choyoołʼįįhí io-2	Category:User io-2
Tʼááłáhági átʼéego:Choyoołʼįįhí io-3	Category:User io-3
Tʼááłáhági átʼéego:Choyoołʼįįhí is	Category:User is
Tʼááłáhági átʼéego:Choyoołʼįįhí is-1	Category:User is-1
Tʼááłáhági átʼéego:Choyoołʼįįhí is-2	Category:User is-2
Tʼááłáhági átʼéego:Choyoołʼįįhí is-3	Category:User is-3
Tʼááłáhági átʼéego:Choyoołʼįįhí als-N	Category:User als-N
Bee álnééhí:User la-3	Template:User la-3
Tʼááłáhági átʼéego:Choyoołʼįįhí pt-3	Category:User pt-3
Tʼááłáhági átʼéego:Choyoołʼįįhí pl-N	Category:User pl-N
Tʼááłáhági átʼéego:Choyoołʼįįhí pt-1	Category:User pt-1
Tʼááłáhági átʼéego:Choyoołʼįįhí ka-1	Category:User ka-1
Bee álnééhí:Hooʼááłígíí	Template:User wikipedia/Administrator
Tʼááłáhági átʼéego:Choyoołʼįįhí it	Category:User it
Tʼááłáhági átʼéego:Choyoołʼįįhí it-1	Category:User it-1
Tʼááłáhági átʼéego:Choyoołʼįįhí ja-1	Category:User ja-1
Tʼááłáhági átʼéego:Choyoołʼįįhí jv	Category:User jv
Tʼááłáhági átʼéego:Choyoołʼįįhí jv-2	Category:User jv-2
Tʼááłáhági átʼéego:Choyoołʼįįhí jv-3	Category:User jv-3
Tʼááłáhági átʼéego:Choyoołʼįįhí ka	Category:User ka
Tʼááłáhági átʼéego:Choyoołʼįįhí ka-2	Category:User ka-2
Tʼááłáhági átʼéego:Choyoołʼįįhí ka-3	Category:User ka-3
Tʼááłáhági átʼéego:Choyoołʼįįhí ka-N	Category:User ka-N
Tʼááłáhági átʼéego:Choyoołʼįįhí kg	Category:User kg
Tʼááłáhági átʼéego:Choyoołʼįįhí km-1	Category:User km-1
Tʼááłáhági átʼéego:Choyoołʼįįhí km-2	Category:User km-2
Tʼááłáhági átʼéego:Choyoołʼįįhí km-3	Category:User km-3
Tʼááłáhági átʼéego:Choyoołʼįįhí km-N	Category:User km-N
Tʼááłáhági átʼéego:Choyoołʼįįhí kn	Category:User kn
Tʼááłáhági átʼéego:Choyoołʼįįhí kn-1	Category:User kn-1
Tʼááłáhági átʼéego:Choyoołʼįįhí ko	Category:User ko
Tʼááłáhági átʼéego:Wááshindoon bikéyah bił haʼdaʼhaasdzoígíí	Category:アメリカ合衆国の州
Tʼááłáhági átʼéego:Choyoołʼįįhí ko-1	Category:User ko-1
Tʼááłáhági átʼéego:Choyoołʼįįhí ko-2	Category:User ko-2
Tʼááłáhági átʼéego:Choyoołʼįįhí ko-3	Category:User ko-3
Tʼááłáhági átʼéego:Choyoołʼįįhí ksh	Category:User ksh
Tʼááłáhági átʼéego:Choyoołʼįįhí ku	Category:User ku
Tʼááłáhági átʼéego:Choyoołʼįįhí ku-2	Category:User ku-2
Tʼááłáhági átʼéego:Choyoołʼįįhí ku-3	Category:User ku-3
Tʼááłáhági átʼéego:Choyoołʼįįhí la-1	Category:User la-1
Tʼááłáhági átʼéego:Choyoołʼįįhí la-3	Category:User la-3
Tʼááłáhági átʼéego:Choyoołʼįįhí la-N	Category:User la-N
Tʼááłáhági átʼéego:Choyoołʼįįhí lb	Category:User lb
Tʼááłáhági átʼéego:Choyoołʼįįhí lb-1	Category:User lb-1
Tʼááłáhági átʼéego:Choyoołʼįįhí lb-2	Category:User lb-2
Tʼááłáhági átʼéego:Choyoołʼįįhí lb-3	Category:User lb-3
Tʼááłáhági átʼéego:Dibé Nitsaa Hahoodzodi kin naaznilígíí	Category:コロラド州の都市
Tʼááłáhági átʼéego:Choyoołʼįįhí nn-2	Category:User nn-2
Bee álnééhí:User gl	Template:User gl
Tʼááłáhági átʼéego:Choyoołʼįįhí ru-1	Category:User ru-1
Bee álnééhí:User ta	Template:User ta
Bee álnééhí:User sv-1	Template:User sv-1
Tʼááłáhági átʼéego:Chʼil bikétłʼóól daadánígíí	Category:根菜
Tʼááłáhági átʼéego:Choyoołʼįįhí lv	Category:User lv
Tʼááłáhági átʼéego:Choyoołʼįįhí mn-1	Category:User mn-1
Tʼááłáhági átʼéego:Choyoołʼįįhí mn-2	Category:User mn-2
Tʼááłáhági átʼéego:Choyoołʼįįhí mn-3	Category:User mn-3
Tʼááłáhági átʼéego:Choyoołʼįįhí mn-N	Category:User mn-N
Tʼááłáhági átʼéego:Choyoołʼįįhí ms-1	Category:User ms-1
Tʼááłáhági átʼéego:Choyoołʼįįhí my	Category:User my
Nahasdzáán bimagnetic field	地磁気
Tsiiʼyiishbizhí dinéʼiʼ	中国人
Tʼááłáhági átʼéego:Choyoołʼįįhí als-3	Category:User als-3
Bee álnééhí:User jv	Template:User jv
Bee álnééhí:User id	Template:User id
Tʼááłáhági átʼéego:Choyoołʼįįhí nds	Category:User nds
Tʼááłáhági átʼéego:Choyoołʼįįhí nds-1	Category:User nds-1
Tʼááłáhági átʼéego:Choyoołʼįįhí nds-2	Category:User nds-2
Tʼááłáhági átʼéego:Choyoołʼįįhí nds-3	Category:User nds-3
Tʼááłáhági átʼéego:Choyoołʼįįhí nds-N	Category:User nds-N
Bee álnééhí:User oc-1	Template:User oc-1
Tʼááłáhági átʼéego:Kéyah Ałhidadiidzooígíí dóó Ahiih Yikaígíí	Category:国際組織
Tʼááłáhági átʼéego:Chʼosh bijáád dahólónígíí	Category:節足動物
Tʼááłáhági átʼéego:Tó	Category:水
Tʼááłáhági átʼéego:Tsáʼásziʼ dóó Noodah	Category:リュウゼツラン科
Tʼááłáhági átʼéego:Bidił daazdoígíí dóó daʼalghałígíí	Category:食肉目
Tʼááłáhági átʼéego:Choyoołʼįįhí tt-N	Category:User tt-N
Tʼááłáhági átʼéego:Choyoołʼįįhí nn-1	Category:User nn-1
Tʼááłáhági átʼéego:Choyoołʼįįhí nb	Category:User nb
Bee álnééhí:User sw-1	Template:User sw-1
Bee álnééhí:User ka-1	Template:User ka-1
Bee álnééhí:User af	Template:User af
Tʼááłáhági átʼéego:Naakaii Łizhiní Bikéyah	Category:アフリカの国
Bee álnééhí:User da-3	Template:User da-3
Bee álnééhí:User sl-3	Template:User sl-3
Bee álnééhí:User ja-2	Template:User ja-2
Bee álnééhí:User ko-2	Template:User ko-2
Bee álnééhí:User ko-1	Template:User ko-1
Bee álnééhí:User cs	Template:User cs
Bee álnééhí:User ru-2	Template:User ru-2
Bee álnééhí:User es-3	Template:User es-3
Bee álnééhí:User ja-3	Template:User ja-3
Bee álnééhí:User eu-1	Template:User eu-1
Bee álnééhí:User ko-3	Template:User ko-3
Tʼááłáhági átʼéego:Tsin bineestʼąʼ dadíkʼǫ́zhígíí	Category:ミカン属
Tʼááłáhági átʼéego:Choyoołʼįįhí pt-2	Category:User pt-2
Tʼááłáhági átʼéego:Choyoołʼįįhí pt-4	Category:User pt-4
Tʼááłáhági átʼéego:Choyoołʼįįhí pt-N	Category:User pt-N
Tʼááłáhági átʼéego:Choyoołʼįįhí qu	Category:User qu
Tʼááłáhági átʼéego:Choyoołʼįįhí qu-1	Category:User qu-1
Tʼááłáhági átʼéego:Choyoołʼįįhí qu-2	Category:User qu-2
Tʼááłáhági átʼéego:Choyoołʼįįhí qu-3	Category:User qu-3
Tʼááłáhági átʼéego:Choyoołʼįįhí qu-N	Category:User qu-N
Tʼááłáhági átʼéego:Choyoołʼįįhí ro-2	Category:User ro-2
Tʼááłáhági átʼéego:Choyoołʼįįhí ro-3	Category:User ro-3
Tʼááłáhági átʼéego:Choyoołʼįįhí ro-4	Category:User ro-4
Tʼááłáhági átʼéego:Choyoołʼįįhí ro-N	Category:User ro-N
Tʼááłáhági átʼéego:Choyoołʼįįhí ru	Category:User ru
Tʼááłáhági átʼéego:Choyoołʼįįhí ru-2	Category:User ru-2
Tʼááłáhági átʼéego:Choyoołʼįįhí ru-3	Category:User ru-3
Tʼááłáhági átʼéego:Choyoołʼįįhí ru-4	Category:User ru-4
Tʼááłáhági átʼéego:Choyoołʼįįhí sk-1	Category:User sk-1
Tʼááłáhági átʼéego:Choyoołʼįįhí sk-3	Category:User sk-3
Tʼááłáhági átʼéego:Choyoołʼįįhí sr	Category:User sr
Tʼááłáhági átʼéego:Choyoołʼįįhí sr-1	Category:User sr-1
Tʼááłáhági átʼéego:Choyoołʼįįhí sr-2	Category:User sr-2
Tʼááłáhági átʼéego:Choyoołʼįįhí sr-3	Category:User sr-3
Tʼááłáhági átʼéego:Choyoołʼįįhí sr-N	Category:User sr-N
Tʼááłáhági átʼéego:Choyoołʼįįhí sv-1	Category:User sv-1
Tʼááłáhági átʼéego:Choyoołʼįįhí sv-3	Category:User sv-3
Tʼááłáhági átʼéego:Choyoołʼįįhí sv-N	Category:User sv-N
Tʼááłáhági átʼéego:Choyoołʼįįhí ta-1	Category:User ta-1
Tʼááłáhági átʼéego:Choyoołʼįįhí ta-2	Category:User ta-2
Tʼááłáhági átʼéego:Choyoołʼįįhí th-1	Category:User th-1
Tʼááłáhági átʼéego:Choyoołʼįįhí th-2	Category:User th-2
Tʼááłáhági átʼéego:Choyoołʼįįhí th-3	Category:User th-3
Tʼááłáhági átʼéego:Choyoołʼįįhí th-N	Category:User th-N
Tʼááłáhági átʼéego:Choyoołʼįįhí tr	Category:User tr
Tʼááłáhági átʼéego:Choyoołʼįįhí tr-N	Category:User tr-N
Tʼááłáhági átʼéego:Choyoołʼįįhí tt	Category:User tt
Tʼááłáhági átʼéego:Choyoołʼįįhí tt-1	Category:User tt-1
Tʼááłáhági átʼéego:Choyoołʼįįhí tt-2	Category:User tt-2
Tʼááłáhági átʼéego:Choyoołʼįįhí tt-3	Category:User tt-3
Tʼááłáhági átʼéego:Choyoołʼįįhí uk-1	Category:User uk-1
Tʼááłáhági átʼéego:Choyoołʼįįhí uk-2	Category:User uk-2
Tʼááłáhági átʼéego:Choyoołʼįįhí uk-3	Category:User uk-3
Tʼááłáhági átʼéego:Choyoołʼįįhí uk-4	Category:User uk-4
Tʼááłáhági átʼéego:Choyoołʼįįhí vi	Category:User vi
Tʼááłáhági átʼéego:Choyoołʼįįhí vi-1	Category:User vi-1
Tʼááłáhági átʼéego:Choyoołʼįįhí vi-2	Category:User vi-2
Tʼááłáhági átʼéego:Choyoołʼįįhí vi-N	Category:User vi-N
Tʼááłáhági átʼéego:Choyoołʼįįhí yue-1	Category:User zh-yue-1
Tʼááłáhági átʼéego:Choyoołʼįįhí yue-2	Category:User zh-yue-2
Tʼááłáhági átʼéego:Choyoołʼįįhí yue-3	Category:User zh-yue-3
Tʼááłáhági átʼéego:Choyoołʼįįhí yue-4	Category:User zh-yue-4
Tʼááłáhági átʼéego:Choyoołʼįįhí yue-N	Category:User zh-yue-N
Bee álnééhí:User ro-1	Template:User ro-1
Tʼááłáhági átʼéego:Tsin ííʼáhígíí	Category:木
Bee álnééhí:User th	Template:User th
Bee álnééhí:User nds-2	Template:User nds-2
Bee álnééhí:User ca	Template:User ca
Tʼááłáhági átʼéego:Mágí: Diné Ndahalinígíí	Category:ヒト上科
Tʼááłáhági átʼéego:Mágí	Category:サル目
Bee álnééhí:LivingP	Template:Blp
Bee álnééhí:Tsídii	Template:鳥類
Bee álnééhí:User sv-3	Template:User sv-3
Bee álnééhí:User hy-1	Template:User hy-1
Bee álnééhí:User hsb-1	Template:User hsb-1
Tʼááłáhági átʼéego:Naʼiiniʼ	Category:商業
Bee álnééhí:User af-3	Template:User af-3
Tʼááłáhági átʼéego:Naaki góneʼ yéigo daʼahijoogą́ą́ʼ	Category:第二次世界大戦
Bee álnééhí:User ms-1	Template:User ms-1
Tʼááłáhági átʼéego:Mósí dóó Náshdóí	Category:ネコ科
Bee álnééhí:User nds	Template:User nds
Tʼááłáhági átʼéego:Tó Kéyah Bináhaazyínígíí	Category:島国
Bee álnééhí:User be	Template:User be
Bee álnééhí:User ca-2	Template:User ca-2
Bee álnééhí:User ca-3	Template:User ca-3
Bee álnééhí:User cs-3	Template:User cs-3
Bee álnééhí:User el-2	Template:User el-2
Bee álnééhí:User et-3	Template:User et-3
Bee álnééhí:User fa-2	Template:User fa-2
Bee álnééhí:User fa-3	Template:User fa-3
Bee álnééhí:User fa-4	Template:User fa-4
Bee álnééhí:User fi-2	Template:User fi-2
Bee álnééhí:User fi-3	Template:User fi-3
Bee álnééhí:User ga-2	Template:User ga-2
Bee álnééhí:User he-3	Template:User he-3
Bee álnééhí:User hu-1	Template:User hu-1
Bee álnééhí:User jv-1	Template:User jv-1
Bee álnééhí:User ko	Template:User ko
Bee álnééhí:User la-2	Template:User la-2
Bee álnééhí:User lb-2	Template:User lb-2
Bee álnééhí:User li-1	Template:User li-1
Bee álnééhí:User li-3	Template:User li-3
Bee álnééhí:User mk-1	Template:User mk-1
Bee álnééhí:User nn-2	Template:User nn-2
Bee álnééhí:User no-1	Template:User no-1
Bee álnééhí:User pl-2	Template:User pl-2
Bee álnééhí:User pt	Template:User pt
Bee álnééhí:User ro-2	Template:User ro-2
Bee álnééhí:User ru-1	Template:User ru-1
Bee álnééhí:User sa-1	Template:User sa-1
Bee álnééhí:User sk-1	Template:User sk-1
Bee álnééhí:User sk-2	Template:User sk-2
Bee álnééhí:User sk-3	Template:User sk-3
Bee álnééhí:User sr-1	Template:User sr-1
Bee álnééhí:User tr-1	Template:User tr-1
Bee álnééhí:User tr-3	Template:User tr-3
Bee álnééhí:User uk-1	Template:User uk-1
Bee álnééhí:User uk-4	Template:User uk-4
Bee álnééhí:User zh-1	Template:User zh-1
Bee álnééhí:User zh-2	Template:User zh-2
Bee álnééhí:User zh-3	Template:User zh-3
Bee álnééhí:User zh-4	Template:User zh-4
Tʼááłáhági átʼéego:Choyoołʼįįhí nl	Category:User nl
Tʼááłáhági átʼéego:Choyoołʼįįhí nn-3	Category:User nn-3
Tʼááłáhági átʼéego:Choyoołʼįįhí no-1	Category:User no-1
Tʼááłáhági átʼéego:Choyoołʼįįhí no-2	Category:User no-2
Tʼááłáhági átʼéego:Choyoołʼįįhí no	Category:User no
Tʼááłáhági átʼéego:Choyoołʼįįhí zh-1	Category:User zh-1
Tʼááłáhági átʼéego:Choyoołʼįįhí zh-4	Category:User zh-4
Tʼááłáhági átʼéego:Choyoołʼįįhí zh-3	Category:User zh-3
Tʼááłáhági átʼéego:Choyoołʼįįhí zh-2	Category:User zh-2
Tʼááłáhági átʼéego:Chʼał	Category:カエル
Tʼááłáhági átʼéego:Mąʼii yił Ałhidanoolinígíí Yázhí	Category:アライグマ科
Tʼááłáhági átʼéego:Dlǫ́ʼiitsoh Danilínígíí	Category:ジャコウネコ科
Tʼááłáhági átʼéego:Chéłchaaʼ	Category:甲虫
Tʼááłáhági átʼéego:Naakáí dootłʼizhí dóó Bééshbichʼahii dabizaad ndahalinígíí	Category:インド・ヨーロッパ語族
Tʼááłáhági átʼéego:Hazéí	Category:リス科
Tʼááłáhági átʼéego:Chidí naatʼaʼí ńdinibįįhígi	Category:空港
Tʼááłáhági átʼéego:Áʼádaatʼéhígíí	Category:元素
Bee álnééhí:User als-2	Template:User als-2
Bee álnééhí:User de-4	Template:User de-4
Tʼááłáhági átʼéego:Biwooʼ Ádaałtsʼíísígíí dóó Kááʼtsʼiní	Category:異節目
Tʼááłáhági átʼéego:Abeʼ bitsʼą́ą́dóó ádaalyaaígíí	Category:乳製品
Tʼááłáhági átʼéego:Tsin dóó chʼil bineestʼąʼ	Category:果物
Tʼááłáhági átʼéego:Kʼaalógii dóó Iichʼąhii	Category:チョウ
Tʼááłáhági átʼéego:Chʼosh bijáád ádaadinígíí	Category:軟体動物
Tʼááłáhági átʼéego:Deeteel Bikéyah bił haʼdaʼhaasdzoígíí	Category:カナダの州
Tʼááłáhági átʼéego:Gáagii dóó Joogii Ndahalinígíí	Category:カラス科
Tʼááłáhági átʼéego:Mąʼii dóó Łééchąąʼí	Category:イヌ科
Tʼááłáhági átʼéego:Tó Wónaanídę́ę́ʼ Mágí	Category:オナガザル科
Tʼááłáhági átʼéego:Naayízí dóó taʼneeskʼání	Category:ウリ科
Tʼááłáhági átʼéego:Dlǫ́ʼii Ndahalinígíí	Category:イタチ科
Tʼááłáhági átʼéego:Łóóʼtsoh biwooʼ dantłʼizígíí	Category:ハクジラ亜目
Tʼááłáhági átʼéego:Łóóʼtsoh biwooʼ daditsʼózígíí	Category:ヒゲクジラ亜目
Tʼááłáhági átʼéego:Naaldeehii	Category:動物
Tʼááłáhági átʼéego:Bizaʼazis Dahólónígíí	Category:有袋類
Tʼááłáhági átʼéego:Chʼosh chʼééh diikáhii	Category:腹足綱
Tʼááłáhági átʼéego:Chʼosh bitsʼaʼígíí	Category:二枚貝
Tʼááłáhági átʼéego:Gah	Category:ウサギ目
Tʼááłáhági átʼéego:Łóóʼtsoh dóó Tééh hóyáanii	Category:クジラ目
Bee álnééhí:User jv-2	Template:User jv-2
Bee álnééhí:User fy-1	Template:User fy-1
Bee álnééhí:User uk-3	Template:User uk-3
Tʼááłáhági átʼéego:Eʼeʼaahjí Tónteel bikáaʼgi Kéyah dah Ndaaʼeełígíí	Category:太平洋の島
Tʼááłáhági átʼéego:Łóóʼ Bigaan Dahólónígíí	Category:頭足綱
Tʼááłáhági átʼéego:Chʼééh digháhii dóó Tsisteeł	Category:カメ
Tʼááłáhági átʼéego:Béésh	Category:金属
Tʼááłáhági átʼéego:Naayééʼ	Category:恐竜
Tʼááłáhági átʼéego:Choyoołʼįįhí pi	Category:User pi
Tʼááłáhági átʼéego:Choyoołʼįįhí pl	Category:User pl
Tʼááłáhági átʼéego:Choyoołʼįįhí th-4	Category:User th-4
Tʼááłáhági átʼéego:Chʼosh bikágí dantłʼizí	Category:甲殻類
Tʼááłáhági átʼéego:Jaaʼabaní	Category:翼手目
Tʼááłáhági átʼéego:Tłʼiish	Category:ヘビ
Tʼááłáhági átʼéego:Shádiʼááhjí kéyah yistinígíí	Category:南極
Tʼááłáhági átʼéego:Beʼekʼid	Category:湖
Bee álnééhí:User sl	Template:User sl
Tʼááłáhági átʼéego:Bįįh	Category:シカ科
Bee álnééhí:User sw-3	Template:User sw-3
Tʼááłáhági átʼéego:Łóóʼ hashkéhé	Category:サメ
Tʼááłáhági átʼéego:Łóóʼ ooshgę́ęzhii	Category:軟骨魚類
Tʼááłáhági átʼéego:Chidí	Category:自動車
Bee álnééhí:User ga-1	Template:User ga-1
Bee álnééhí:User lb	Template:User lb
Bee álnééhí:User af-2	Template:User af-2
Chąąshtʼezhiitsoh	ニンジン
Tʼááłáhági átʼéego:Kéyah bił haʼdaʼhaasdzoígíí	Category:地方区分
Tʼááłáhági átʼéego:Łį́į́ʼ Ndahalinígíí	Category:ウマ科
Tʼááłáhági átʼéego:Naabeehó	Category:ナバホ
Tʼááłáhági átʼéego:Wóʼatsʼǫǫsii Ádaatʼéhígíí	Category:カメムシ目
Tʼááłáhági átʼéego:Tsin Deigházhígíí	Category:齧歯目
Bee álnééhí:User hr-2	Template:User hr-2
Bee álnééhí:User sl-1	Template:User sl-1
Tʼááłáhági átʼéego:Choyoołʼįįhí ab	Category:User ab
Tʼááłáhági átʼéego:Choyoołʼįįhí ab-3	Category:User ab-3
Tʼááłáhági átʼéego:Choyoołʼįįhí ab-N	Category:User ab-N
Tʼááłáhági átʼéego:Choyoołʼįįhí ka-4	Category:User ka-4
Bee álnééhí:User pl-3	Template:User pl-3
Bee álnééhí:User pl-4	Template:User pl-4
Bee álnééhí:User yue-4	Template:User zh-yue-4
Bee álnééhí:User yue-2	Template:User zh-yue-2
Bee álnééhí:User vi-2	Template:User vi-2
Bee álnééhí:User vi-1	Template:User vi-1
Bee álnééhí:User ta-3	Template:User ta-3
Bee álnééhí:User ta-1	Template:User ta-1
Bee álnééhí:User sw	Template:User sw
Bee álnééhí:User sr-3	Template:User sr-3
Bee álnééhí:User sr-2	Template:User sr-2
Bee álnééhí:User sl-2	Template:User sl-2
Bee álnééhí:User qu-3	Template:User qu-3
Bee álnééhí:User qu-2	Template:User qu-2
Bee álnééhí:User qu-1	Template:User qu-1
Bee álnééhí:User oc-3	Template:User oc-3
Bee álnééhí:User oc-2	Template:User oc-2
Bee álnééhí:User oc	Template:User oc
Bee álnééhí:User nv-0	Template:User nv-0
Bee álnééhí:User nds-3	Template:User nds-3
Bee álnééhí:User mn-4	Template:User mn-4
Bee álnééhí:User mn-3	Template:User mn-3
Bee álnééhí:User mn-2	Template:User mn-2
Bee álnééhí:User mn-1	Template:User mn-1
Bee álnééhí:User mn	Template:User mn
Bee álnééhí:User mk-3	Template:User mk-3
Bee álnééhí:User mk-2	Template:User mk-2
Bee álnééhí:User mk	Template:User mk
Bee álnééhí:User mg	Template:User mg
Bee álnééhí:User lzh	Template:User zh-classical
Bee álnééhí:User lv-1	Template:User lv-1
Bee álnééhí:User lt-4	Template:User lt-4
Bee álnééhí:User lt-3	Template:User lt-3
Bee álnééhí:User lt-1	Template:User lt-1
Bee álnééhí:User li-2	Template:User li-2
Bee álnééhí:User lb-3	Template:User lb-3
Bee álnééhí:User la	Template:User la
Bee álnééhí:User jv-3	Template:User jv-3
Bee álnééhí:User it-4	Template:User it-4
Bee álnééhí:User is-3	Template:User is-3
Bee álnééhí:User io-2	Template:User io-2
Bee álnééhí:User io-1	Template:User io-1
Bee álnééhí:User id-2	Template:User id-2
Bee álnééhí:User ia-3	Template:User ia-3
Bee álnééhí:User ia-1	Template:User ia-1
Bee álnééhí:User ia	Template:User ia
Bee álnééhí:User hr-3	Template:User hr-3
Bee álnééhí:User hi-2	Template:User hi-2
Bee álnééhí:User grc-3	Template:User grc-3
Bee álnééhí:User gn-2	Template:User gn-2
Bee álnééhí:User ga	Template:User ga
Bee álnééhí:User et-2	Template:User et-2
Bee álnééhí:User et	Template:User et
Bee álnééhí:User el-3	Template:User el-3
Bee álnééhí:User cy-3	Template:User cy-3
Bee álnééhí:User cy-2	Template:User cy-2
Bee álnééhí:User cy-1	Template:User cy-1
Bee álnééhí:User cy	Template:User cy
Bee álnééhí:User bs-2	Template:User bs-2
Bee álnééhí:User bg-3	Template:User bg-3
Bee álnééhí:User bg-2	Template:User bg-2
Bee álnééhí:User be-3	Template:User be-3
Bee álnééhí:User be-1	Template:User be-1
Bee álnééhí:User mg-4	Template:User mg-4
Bee álnééhí:User gl-2	Template:User gl-2
Bee álnééhí:User eu-3	Template:User eu-3
Bee álnééhí:User ast	Template:User ast
Bee álnééhí:User ro-3	Template:User ro-3
Tʼááłáhági átʼéego:Dlǫ́ʼii yił Aheedaałtʼéhígíí	Category:マングース科
Bee álnééhí:User or	Template:User or
Bee álnééhí:User lzh-2	Template:User zh-classical-2
Bee álnééhí:User eu-2	Template:User eu-2
Tʼááłáhági átʼéego:Hoozdo Hahoodzodi chidí naatʼaʼí ńdinibįįhígi	Category:アリゾナ州の空港
Tʼááłáhági átʼéego:Yootó Hahoodzodi chidí naatʼaʼí ńdinibįįhígi	Category:ニューメキシコ州の空港
Tʼááłáhági átʼéego:Chʼosh Deildeełii	Category:食虫目
Tʼááłáhági átʼéego:Tábąąstííntsoh	Category:アシカ亜目
Tʼááłáhági átʼéego:Táłkáaʼgi Tsídii	Category:カモ目
Tʼááłáhági átʼéego:Chʼosh bijáád tseebíhígíí	Category:クモ形類
Tʼááłáhági átʼéego:Yágháhonikáánji biłnaaztʼiʼígíí	Category:宇宙探査
Tʼááłáhági átʼéego:Shash	Category:クマ
Tʼááłáhági átʼéego:Tsin deiłkaałii	Category:キツツキ科
Tʼááłáhági átʼéego:Chʼosh bijáád neeznánígíí	Category:十脚目
Tʼááłáhági átʼéego:Bílaʼashdlaʼii bilį́į́ʼ danilínígíí	Category:家畜
Tʼááłáhági átʼéego:Dziil / Atsiniltłʼish álʼį́	Category:エネルギー
Tʼááłáhági átʼéego:Tsʼíʼii dóó Tséʼédǫ́ʼii	Category:ハエ目
Bee álnééhí:User ko-4	Template:User ko-4
Tʼááłáhági átʼéego:Tązhii dóó Naaʼahóóhai Ndahalinígíí	Category:キジ目
Tʼááłáhági átʼéego:Wónitłʼizí	Category:等脚類
Tʼááłáhági átʼéego:Kǫʼ naʼałbąąsii ninádaaltłiʼígi	Category:鉄道駅
Tʼááłáhági átʼéego:Daʼałtʼoʼígíí biyęęzhii deiłchíhígíí	Category:単孔目
Tʼááłáhági átʼéego:Nahachagii dóó Nahakʼízii	Category:バッタ目
Tʼááłáhági átʼéego:Chéłchaaʼ bigaantéłígíí	Category:コガネムシ
Tʼááłáhági átʼéego:Tábąąsdísí	Category:シギ科
Tʼááłáhági átʼéego:Táłtłʼááhdę́ę́ʼ dóó tónteel biyiʼdę́ę́ʼ chʼiyáán	Category:水産物
Tʼááłáhági átʼéego:Tsin naaʼeeł	Category:船
Tʼááłáhági átʼéego:Naʼashjéʼii	Category:クモ
Tʼááłáhági átʼéego:Jááłánii	Category:多足類
Tʼááłáhági átʼéego:Bisóodi	Category:豚
Tʼááłáhági átʼéego:Choyoołʼįįhí ba-3	Category:User ba-3
Tʼááłáhági átʼéego:Choyoołʼįįhí ba-4	Category:User ba-4
Tʼááłáhági átʼéego:Choyoołʼįįhí ba-N	Category:User ba-N
Tʼááłáhági átʼéego:Choyoołʼįįhí my-N	Category:User my-N
Tʼááłáhági átʼéego:Azeeʼ	Category:薬用植物
Tʼááłáhági átʼéego:Naʼastsʼǫǫsí dóó Łéʼétsoh	Category:ネズミ
Bee álnééhí:User cs-2	Template:User cs-2
Bee álnééhí:Image label begin	Template:Image label begin
Tʼááłáhági átʼéego:Yootó Hahoodzodi kin naaznilígíí	Category:ニューメキシコ州の都市
Tʼááłáhági átʼéego:Choyoołʼįįhí ay-2	Category:User ay-2
Tʼááłáhági átʼéego:Choyoołʼįįhí ay-3	Category:User ay-3
Tʼááłáhági átʼéego:Choyoołʼįįhí ay-N	Category:User ay-N
Tʼááłáhági átʼéego:Choyoołʼįįhí mn-4	Category:User mn-4
Tʼááłáhági átʼéego:Dibé dóó Tłʼízí Ndahalinígíí	Category:ヤギ亜科
Tʼááłáhági átʼéego:Choyoołʼįįhí fa-4	Category:User fa-4
Tʼááłáhági átʼéego:Choyoołʼįįhí chr-3	Category:User chr-3
Tʼááłáhági átʼéego:Choyoołʼįįhí mg-1	Category:User mg-1
Tʼááłáhági átʼéego:Choyoołʼįįhí mg-2	Category:User mg-2
Tʼááłáhági átʼéego:Choyoołʼįįhí mg-3	Category:User mg-3
Tʼááłáhági átʼéego:Choyoołʼįįhí mg-4	Category:User mg-4
Tʼááłáhági átʼéego:Biishchʼid Dahólónígíí	Category:有胎盤類
Bee álnééhí:User nn-3	Template:User nn-3
Bee álnééhí:User vi	Template:User vi
Tʼááłáhági átʼéego:Choyoołʼįįhí en-1	Category:User en-1
Tʼááłáhági átʼéego:Choyoołʼįįhí de-1	Category:User de-1
Tʼááłáhági átʼéego:Choyoołʼįįhí da-N	Category:User da-N
Tʼááłáhági átʼéego:Choyoołʼįįhí gl-2	Category:User gl-2
Tʼááłáhági átʼéego:Choyoołʼįįhí or	Category:User or
Yaaʼ bijáád tseebíhígíí	マダニ
Bee álnééhí:User ay-4	Template:User ay-4
Tsiiyázhí (dééł)	ラッパチョウ属
Bee álnééhí:User nn-1	Template:User nn-1
Bee álnééhí:User lt-2	Template:User lt-2
Bee álnééhí:User ru-3	Template:User ru-3
Bee álnééhí:User nl-3	Template:User nl-3
Bee álnééhí:User nn	Template:User nn
Bee álnééhí:User dsb-1	Template:User dsb-1
Bee álnééhí:User km-1	Template:User km-1
Bee álnééhí:User li	Template:User li
Bee álnééhí:User fy	Template:User fy
Bee álnééhí:User my	Template:User my
Bee álnééhí:User hi	Template:User hi
Bee álnééhí:User hu-2	Template:User hu-2
Bee álnééhí:User hr-4	Template:User hr-4
Bee álnééhí:User sw-2	Template:User sw-2
Bee álnééhí:User als-3	Template:User als-3
Bee álnééhí:User th-2	Template:User th-2
Bee álnééhí:User sh-2	Template:User sh-2
Bee álnééhí:User hu-3	Template:User hu-3
Bee álnééhí:User mg-3	Template:User mg-3
Bee álnééhí:User ga-3	Template:User ga-3
Bee álnééhí:User qu	Template:User qu
Bee álnééhí:User kn-1	Template:User kn-1
Bee álnééhí:User vi-3	Template:User vi-3
Bee álnééhí:User th-3	Template:User th-3
Bee álnééhí:User ta-2	Template:User ta-2
Bee álnééhí:User id-1	Template:User id-1
Bee álnééhí:Bidił daazdoígíí dóó da'ałt'o'ígíí	Template:哺乳類
Kʼaalógii	チョウ
Tʼááłáhági átʼéego:Choyoołʼįįhí als-4	Category:User als-4
Special:RecentChanges	特別:最近の更新
Tʼááłáhági átʼéego:Choyoołʼįįhí ja-4	Category:User ja-4
Yáʼąąsh Yeiyíʼaah Jooł	ヘヴン・セント・ゲーミング
Atseełtsʼózí (tónteel tsídii)	ネッタイチョウ属
Kʼaalógii ntsxaaígíí	トリバネチョウ
