افريقا	アフリカ
جاپان	日本
سوېلي امريکا	南アメリカ
ناروې	ノルウェー
د آيرلېنډ جمهوريت	アイルランド
هنگري	ハンガリー
اسپانیا	スペイン
د امریکا متحده ایالتونه	アメリカ合衆国
بلجیم	ベルギー
لوگزامبورگ	ルクセンブルク
ځمکه	地球
ژوند	生命
انسان	ヒト
فېنلانډ	フィンランド
سويډن	スウェーデン
ډېنمارک	デンマーク
پولنډ	ポーランド
لېتوانيا	リトアニア
اېټاليا	イタリア
سويس	スイス
اتريش	オーストリア
يونان	ギリシャ
تورکيه	トルコ
بير	ビール
پرتگال	ポルトガル
اروپا	ヨーロッパ
آسيا	アジア
شمالي امريکا	北アメリカ
انټارکټيکا	南極大陸
ويکيپېډيا	ウィキペディア
هالنډ	オランダ
نيويارک (ښار)	ニューヨーク
واشنگټن ډي سي	ワシントンD.C.
برلين	ベルリン
سولگر	コンピュータ
څوریخ	チューリッヒ
انټرنټ	インターネット
باراک حسين اوباما	バラク・オバマ
لندن	ロンドン
قاهره	カイロ
مڼه	リンゴ
پاريس	パリ
گووگل	Google
اتلانتيک سمندر	大西洋
غلی سمندر	太平洋
کالېفورنیا	カリフォルニア州
دونۍ	月曜日
جنوري	1月
فبروري	2月
مارچ	3月
مريخ	火星
کېنيا	ケニア
اېتوپیا	エチオピア
گانا	ガーナ
اپرېل	4月
مې	5月
جون	6月
جولای	7月
اگسټ	8月
سپټمبر	9月
اکتوبر	10月
نومبر	11月
ډيسمبر	12月
درې نۍ	火曜日
شورو	水曜日
زيارت	木曜日
جمعه	金曜日
خالي	土曜日
يونۍ	日曜日
زمری	ライオン
فرانسه	フランス
سپی	イヌ
بريتانيا	イギリス
پيشو	ネコ
چين د خلکو جمهوريت	中華人民共和国
فرانسوي ژبه	フランス語
اېتنول	エタノール
برازیل	ブラジル
روسیه	ロシア
نهنگ	クジラ目
څلوريځ (مېچپوهنه)	正方形
بوینگ ۷۴۷	ボーイング747
ويکيمېډيا بنسټ	ウィキメディア財団
آلمان	ドイツ
بېلاروس	ベラルーシ
آلماني ژبه	ドイツ語
آيسلېنډ	アイスランド
الله	神
اېسټونيا	エストニア
زحل	土星
الوتکه	飛行機
جگړه	戦争
جورج واکر بوش	ジョージ・W・ブッシュ
اوکراین	ウクライナ
چېک جمهوريت	チェコ
سلواکيا	スロバキア
سلووانیا	スロベニア
مولدوا	モルドバ
رومانیا	ルーマニア
بلغاریا	ブルガリア
د مقدونيې ولسمشريزه	マケドニア共和国
البانیا	アルバニア
کروواسيا	クロアチア
آزربايجان	アゼルバイジャン
اندورا	アンドラ
گرجستان	グルジア
قزاقستان	カザフスタン
مالټا	マルタ
مانتېنېگرو	モンテネグロ
واټيکان ښار	バチカン
سان مارینو	サンマリノ
بروکسل	ブリュッセル
بېلیز	ベリーズ
باربادوس	バルバドス
اندونيزيا	インドネシア
ولفگانگ امادیوس موزارت	ヴォルフガング・アマデウス・モーツァルト
لیودویگ وان بیتهووین	ルートヴィヒ・ヴァン・ベートーヴェン
تورکي ژبه	トルコ語
سویلي افریقا	南アフリカ共和国
الجزاير	アルジェリア
اوزبکستان	ウズベキスタン
تاشکند	タシュケント
اوبه	水
تلويزون	テレビ
چېلي	チリ
عيسی	イエス・キリスト
گاليليو گاليلی	ガリレオ・ガリレイ
عطارد	水星
پېښليک	歴史
ژبه	言語
زورواکي	独裁政治
مشتري	木星
میشل باشله	ミシェル・バチェレ
ستورپوهنه	天文学
سينگاپور	シンガポール
پوهنه	科学
تکړښت	スポーツ
اډولف هټلر	アドルフ・ヒトラー
فېس بوک	Facebook
ويکيلېکس	ウィキリークス
لومړنۍ نړېواله جگړه	第一次世界大戦
دويمه نړېواله جگړه	第二次世界大戦
گړيال	時計
شچېچېن	シュチェチン
شمېرپوهنه	数学
لاتين ژبه	ラテン語
بحرین	バーレーン
ارمنستان	アルメニア
مېخي ليکدود	楔形文字
هیگزبوسون	ヒッグス粒子
سربيا	セルビア
سپوږمۍ	月
استنبول	イスタンブル
آسټراليا	オーストラリア
پنځپوهنه	物理学
ارجنټاین	アルゼンチン
مخابرات	電気通信
پيرو	ペルー
ژونپوهنه	生物学
شمالي کوريا	朝鮮民主主義人民共和国
کمبودیا	カンボジア
قرآن	クルアーン
ډانگسر	恐竜
ژوپوهنه	動物学
اسلام	イスラム教
ناک	ナシ属
بوټپوهنه	植物学
لېخ والېسا	レフ・ヴァウェンサ
اروپايي اتحاديه	欧州連合
WWW	World Wide Web
شعر	詩
کمپيوټري ويروس	コンピュータウイルス
ليمو	レモン
گل	花
ناپليون بوناپارت	ナポレオン・ボナパルト
لمر	太陽
آسمان	空
وېکټور هوگو	ヴィクトル・ユーゴー
اقيانوسيه	オセアニア
لمريز غونډال	太陽系
هايډروجن	水素
انگېلا مېرکل	アンゲラ・メルケル
لوړغږی	スピーカー
ورځ	日
شپه	夜
کال	年
پېړۍ	世紀
اوسلو	オスロ
دوبۍ	ドバイ
آکسيجن	酸素
سياره	惑星
سندارا	音楽
مسکو	モスクワ
چاډ	チャド
الومېنيم	アルミニウム
هند	インド
اوسپنه	鉄
لوېديځ	西
گوگړ	硫黄
ساموا	サモア
ختيځ	東
وېليم شېکسپيير	ウィリアム・シェイクスピア
نكل	寓話
مارشال ټاپووان	マーシャル諸島
مغولستان	モンゴル国
سترنج	チェス
چنگېز خان	チンギス・カン
آس	ウマ
امسټرډام	アムステルダム
وسله	武器
ژوي	動物
سورينام	スリナム
گويانا	ガイアナ
اېکوادور	エクアドル
ځمکني توتان	オランダイチゴ属
بوديزم	仏教
بولېویا	ボリビア
تامبه	銅
بوټی	植物
سېنټ لوسیا	セントルシア
ليونارډو ډاوېنچي	レオナルド・ダ・ヴィンチ
چڼاس	菌類
جمايکا	ジャマイカ
گرېنادا	グレナダ
گواتمالا	グアテマラ
هندوراس	ホンジュラス
ډومنيکان جمهوريت	ドミニカ共和国
اهلي خوگ	ブタ
شمالي قطبي سمندر	北極海
هایتي	ハイチ
اېلسلوادور	エルサルバドル
ايران	イラン
عراق	イラク
کوسټاریکا	コスタリカ
اسرائيل	イスラエル
پاناما	パナマ
يمن	イエメン
اردن	ヨルダン
نیکاراگوا	ニカラグア
قرغزستان	キルギス
کوېټ	クウェート
لاووس	ラオス
لېبنان	レバノン
مالديپ	モルディブ
امريکا لويه وچه	アメリカ州
ميانمار	ミャンマー
نيپال	ネパール
عمان	オマーン
پاکستان	パキスタン
قطر	カタール
سعودي عربستان	サウジアラビア
سریلانکا	スリランカ
جوزف سټالين	ヨシフ・スターリン
سوريه	シリア
اپلاتون	プラトン
تاجيکستان	タジキスタン
د چين جمهوريت	中華民国
يوټيوب	YouTube
ارستو	アリストテレス
تايلنډ	タイ王国
اورگاډی	列車
آرسېنيک	ヒ素
راډيو	ラジオ
تورکمنستان	トルクメニスタン
عربي متحده امارات	アラブ首長国連邦
چارلس چاپلين	チャールズ・チャップリン
سوېلي کوريا	大韓民国
سمپسنز	ザ・シンプソンズ
افغانستان	アフガニスタン
بنگله دېش	バングラデシュ
فرانتس کافکا	フランツ・カフカ
مالي	マリ共和国
سوقرات	ソクラテス
آنگولا	アンゴラ
بوتان	ブータン
ټويټر	Twitter
برونای	ブルネイ
تانزانیه	タンザニア
پاره	水銀
فلېپين	フィリピン
د منځنی افريقا ولسمشريزه	中央アフリカ共和国
آيزاک نيوټن	アイザック・ニュートン
آلبرټ آينشټاين	アルベルト・アインシュタイン
تونس	チュニジア
زېمبيا	ザンビア
زېمبابوې	ジンバブエ
بېجنگ	北京市
سوېلي سوډان	南スーダン
بېنين	ベナン
بوتسوانا	ボツワナ
بورکینا فاسو	ブルキナファソ
بروندي	ブルンジ
کانگو جمهوريت	コンゴ共和国
جېبوتي	ジブチ
پولونيم	ポロニウム
باډن ورټمبرگ	バーデン＝ヴュルテンベルク州
اریتره	エリトリア
فيودور ميخايلوويچ داستاېفسکي	フョードル・ドストエフスキー
گابن	ガボン
مهاتما گاندي	マハトマ・ガンディー
گامبيا	ガンビア
عاج ساحل	コートジボワール
کامرون	カメルーン
لايبېريا	リベリア
لېبيا	リビア
مادغاسکر	マダガスカル
مالاوي	マラウイ
موریتانيا	モーリタニア
ماوریتوس	モーリシャス
مراکش	モロッコ
موزمبيق	モザンビーク
نېمبیا	ナミビア
نایجېر	ニジェール
نايجېريا	ナイジェリア
راونډا	ルワンダ
سېنېگال	セネガル
سیشل	セーシェル
سېرالیون	シエラレオネ
سومالیا	ソマリア
سوډان	スーダン
سوازيلانډ	スワジランド
شنه زرغونه	虹
استقلاب	代謝
ملگري ملتونه	国際連合
دانتې الیگيري	ダンテ・アリギエーリ
ځمکپېژندنه	地質学
ځمکپوهنه	地理学
زړه	心臓
ماغزه	脳
پراگ	プラハ
شين	青
سپين زر	銀
يورانيم	ウラン
پلوتونيم	プルトニウム
ممبای	ムンバイ
گوا	ゴア州
مهاراشترا	マハーラーシュトラ州
زارلاند	ザールラント州
براندنبورگ	ブランデンブルク州
برېمن (ايالت)	ブレーメン州
بيت المقدس	エルサレム
هندي سمندر	インド洋
کلراډو	コロラド州
ژمی	冬
پسرلی	春
دوبی	夏
منی	秋
اسامه بن لادن	ウサーマ・ビン・ラーディン
اوپرا	オペラ
کلکته	コルカタ
ډېلي	デリー
بند پایان	節足動物
اسلام آباد	イスラマバード
پيسې	貨幣
خوځندکې	昆虫
ولادمير ايليچ لېنين	ウラジーミル・レーニン
نېكولو مكياوېلې	ニッコロ・マキャヴェッリ
مايکروسافټ وېنډوز	Microsoft Windows
مانيلا	マニラ
توکيو	東京都
استانه	アスタナ
بغداد	バグダード
هندي ژبه	ヒンディー語
اوردو ژبه	ウルドゥー語
واليبال	バレーボール
وين	ウィーン
ډبلن	ダブリン
بوډاپسټ	ブダペスト
د مسيح حقيقي کليسا	真イエス教会
انگرېزي ژبه	英語
بانگکوک	バンコク
کوالالامپور	クアラルンプール
ديپلوماسي	外交
کيېف	キエフ
كونسكوولا	コィンスコヴォラ
2012	2012年
2013	2013年
خواړه	食品
اېلېکټرون	電子
رغاويز اوښتون	産業革命
د روم ټولواکمني	ローマ帝国
مايکروسافټ	マイクロソフト
پروټون	陽子
کوروف	クルフ
کيميا	化学
نيوټرون	中性子
صنعا	サナア
آرنولد شوارزنېگر	アーノルド・シュワルツェネッガー
فوټبال	サッカー
آيفون	IPhone
مايکل جېکسن	マイケル・ジャクソン
انتوان دي سينت اکسيوپيري	アントワーヌ・ド・サン＝テグジュペリ
سور	赤
هوا	地球の大気
پېرى	ジン (アラブ)
ربات	ラバト
الجزيره	アルジェ
ترابلس	トリポリ
تهران	テヘラン
جکارتا	ジャカルタ
انقره	アンカラ
رياض	リヤド
فوټ	フィート
وېشنيزه:د ويکيپېډيا کينډۍ	Category:ウィキペディアのテンプレート
د مشق	ダマスカス
لوم	ロメ
دوها	ドーハ
دودوما	ドドマ
ښوونځی	学校
پوهنتون	大学
د پوهنغونډ په اړه	Wikipedia:ウィキペディアへようこそ
آسټراليا (لويه وچه)	オーストラリア大陸
ورونپاسی	ノートパソコン
الجبر	代数学
دونگ هوی هوايي ډگر	ドンホイ空港
آر دړه	マザーボード
كوريتيبا	クリチバ
پنجاب (پاکستان)	パンジャーブ州 (パキスタン)
وېشنيزه:د افغانستان پېښليک	Category:アフガニスタンの歴史
توماس شېن کانېري	ショーン・コネリー
كنفيوشيوس	孔子
کوربن بليو	コービン・ブルー
وېشنيزه:شمېرپوهنه	Category:数学
کينډۍ:د هېواد مالومات ایران	Template:Country data Iran
وېشنيزه:د ایران تاریخ	Category:イランの歴史
امريکايي ډالر	アメリカ合衆国ドル
عيسويت	キリスト教
لويه وچه	大陸
مرغه	鳥類
پلازمېنه	首都
کينډۍ:اسلام	Template:Islam
مياشت (موده)	月 (暦)
مصطفی کمال اتاتورک	ムスタファ・ケマル・アタテュルク
کينډۍ:تانبه	Template:ウィキポータルリンク
هوانگ شيان فان	黄現ハン
بقراط	ヒポクラテス
الماس	ダイヤモンド
پوهنغونډ	百科事典
RAM	Random Access Memory
لومړی مخ	メインページ
کانډنسر	コンデンサ
باسکټبال	バスケットボール
کرېکټ	クリケット
اوراسيا	ユーラシア大陸
د هېتیانو واکمنۍ	ヒッタイト
وينه لږی	貧血
کېپ ټاون	ケープタウン
قراقرم	カラコルム山脈
هندوکش	ヒンドゥークシュ山脈
ميترو	地下鉄
کنځری	コトネアスター
پيکاسو	パブロ・ピカソ
بس	バス (交通機関)
ټرام	路面電車
بابل	バビロン
آنتون پاولوف چيخوف	アントン・チェーホフ
چارلېز ډيکېنز	チャールズ・ディケンズ
سپارتا	スパルタ
موينجو دېړو	モヘンジョダロ
سمرقند	サマルカンド
بخارا	ブハラ
چې گوارا	チェ・ゲバラ
کابل	カーブル
گوېټه	ヨハン・ヴォルフガング・フォン・ゲーテ
مهبل	膣
فلسفه	哲学
د مقدس ویټوس کليسا	聖ヴィート大聖堂
چای	茶
کمونيزم	共産主義
انارشيزم	アナキズム
پانگولي	資本主義
لېبراليزم	自由主義
فاشېزم	ファシズム
ولسپالنه	ナショナリズム
حافظ شېرازي	ハーフェズ
هېوادپالنه	愛国心
هیواد	国
ولس	国民
هيلري کلنټن	ヒラリー・クリントン
د برتانيې موزيم	大英博物館
ژان ژاک روسو	ジャン＝ジャック・ルソー
هومر	ホメーロス
الكساندر هومبولدت	アレクサンダー・フォン・フンボルト
کوارک	クォーク
اېډوارډ ټېللر	エドワード・テラー
تور زېړی	B型肝炎
اتيزم	無神論
نيلز بوهر	ニールス・ボーア
ژونکيميا	生化学
ژونپنځپوهنه	生物物理学
چاپېريالپوهنه	生態学
بارسلونا فوټبال کلب	FCバルセロナ
واگ	政治
ووبپوهنه	組織学
عربي ټولنه	アラブ連盟
ولسواکي	民主主義
نجيب محفوظ	ナギーブ・マフフーズ
د سره صليب او سرې مياشتې نړيوال غورځنگ	赤十字社
نړيوالتوب	グローバリゼーション
ناټو	北大西洋条約機構
جين	遺伝子
حکومت	政府
نوبل جايزه	ノーベル賞
چېن شي هوانگ	始皇帝
منځنی ختيځ	中東
رنځپوهنه	病理学
رابندرانات ټاگور	ラビンドラナート・タゴール
لېو نيكولايوويچ تولستوى	レフ・トルストイ
مارک ټوېن	マーク・トウェイン
ايډيالوژي	イデオロギー
ادا لولېس	エイダ・ラブレス
مارکسيزم	マルクス主義
ولسمشريزه	共和制
دولت	国家
گوند	政党
بډمنټن	バドミントン
يوري الکسويچ گاگارين	ユーリイ・ガガーリン
ابن بطوطه	イブン・バットゥータ
اباسين (سيند)	インダス川
فرانز جوزیف هایدن	フランツ・ヨーゼフ・ハイドン
غوږ	耳
سترگه	目
سندره	歌
اوښ	ラクダ
تی لرونکی ځناوران	哺乳類
مېږی	アリ
مارگريت تاچر	マーガレット・サッチャー
ډي آکسي رايبونيوکليک اسيد	デオキシリボ核酸
ژباړه	翻訳
ښامار	ドラゴン
مور	母親
پلار	父親
لېږدچارې	交通
روسي ژبه	ロシア語
ولادمير پوتين	ウラジーミル・プーチン
حقوق	法 (法学)
اساسي قانون	コンスティチューション (法学)
د بشري حقونو نړېواله اعلاميه	世界人権宣言
د روغتيا نړيوال سازمان	世界保健機関
د سوداگرۍ نړيوال سازمان	世界貿易機関
پرېولنځی	便器
طبيعت	自然
سادرملنه	精神医学
ژونکه	細胞
وينه	血液
هډوانه	骨格
سږي	肺
ساييز غونډال	呼吸器
رومانيايي ژبه	ルーマニア語
بلغاريايي ژبه	ブルガリア語
ښوونپوهنه	教授学
روزنپوهنه	教育学
يمال	雪崩
رېږدله	地震
طبيعي پوهنې	自然科学
ابن سينا بلخي	イブン・スィーナー
وېنسټون چرچل	ウィンストン・チャーチル
نېلسن مانډېلا	ネルソン・マンデラ
انزايم	酵素
امينو اسيد	アミノ酸
ورېځ	雲
سولپوهنه	論理学
مېچپوهنه	幾何学
وټپوهنه	経済学
پانگه (وټپوهنه)	資本
ارز	通貨
رغاوه	産業
ورکړېنه	租税
ژبپوهنه	言語学
يوناني ابېڅې	ギリシア文字
ادبپوهنه	文学
وېشنيزه:فرانسه	Category:フランス
ناول	長編小説
سره گيدړه	アカギツネ
اوستراوا	オストラヴァ
کوروش ۲	キュロス2世
ټولنه	社会
تمدن	文明
زده کړه	教育
هوگو چاوېز	ウゴ・チャベス
واده	結婚
وگړنيز حقوق	人権
توکمپالنه	人種差別
گوډ تېمور	ティムール
عمر بن خطاب	ウマル・イブン・ハッターブ
پوځ	軍事
سلیمان ۱	スレイマン1世
قهوه	コーヒー
د آمو سيند	アムダリヤ川
شيدې	乳
غر	山
هلمند رود	ヘルマンド川
توكبنسټ	データベース
صلاح الدين ايوبي	サラーフッディーン
اشوک	アショーカ王
جلال الدين محمد اکبر	アクバル
هانگ کانگ	香港
کراچۍ	カラチ
د ريال مادريد فوټبال کلب	レアル・マドリード
سيول	ソウル特別市
شانگهای	上海市
اقليدس	エウクレイデス
بايټ	バイト (情報)
محمد بن موسی خوارزمي	フワーリズミー
ناروېژي ژبه	ノルウェー語
نوم چومسكي	ノーム・チョムスキー
چيکی ژبه	チェコ語
کارل مارکس	カール・マルクス
موسی	モーセ
پوهه	知識
هندويزم	ヒンドゥー教
اټوم	原子
يوناني ژبه	ギリシア語
چليز غونډال	オペレーティングシステム
تاج محل	タージ・マハル
بنسټپالنه	原理主義
برېښليک	電子メール
پاړسي ژبه	ペルシア語
مذهب	宗教
اېمپاير سټېټ ودانۍ	エンパイア・ステート・ビルディング
سېگمونډ فرايډ	ジークムント・フロイト
جاينيزم	ジャイナ教
گيورگ ويلهېلم فرېدرېش هېگل	ゲオルク・ヴィルヘルム・フリードリヒ・ヘーゲル
باکو	バクー
تاجکي ژبه	タジク語
اوزبکي ژبه	ウズベク語
تورکمني ژبه	トルクメン語
يهوديت	ユダヤ教
آزربايجاني ژبه	アゼルバイジャン語
ابن خلدون	イブン・ハルドゥーン
امانوېل کانت	イマヌエル・カント
سکيزم	シク教
فرېدرېک وېلهېلم نېتشي	フリードリヒ・ニーチェ
بشکیک	ビシュケク
دوشنبه	ドゥシャンベ
اينه	肝臓
پښتورگی	腎臓
ادم سمېت	アダム・スミス
احساس	感情
ساپوهنه	心理学
آند	思考
مهاوېرا	マハーヴィーラ
سمندر	大洋
ملکه وېکټوريا	ヴィクトリア (イギリス女王)
محمد	ムハンマド・イブン＝アブドゥッラーフ
اخلاق	倫理学
پوهنپوهنه	認識論
سچين رمېش ټنډولکر	サチン・テンドルカール
عبدالکلام	アブドゥル・カラーム
بي بي سي	英国放送協会
شاهرخ خان	シャー・ルク・カーン
سلمان خان	サルマン・カーン
محمد الغزالي	ガザーリー
عامر خان	アーミル・カーン
اميتاببچن	アミターブ・バッチャン
شيعه	シーア派
گېډه	腹
زرتشتيت	ゾロアスター教
تصوف	スーフィズム
ژبه (اناتومي)	舌
پانکراس	膵臓
غاړه	首
کمزوره شوي یورانیم	劣化ウラン
هولي	ホーリー祭
زړه پوهنه	循環器学
ډېوېډ بکهم	デビッド・ベッカム
کيم جونگ ايل	金正日
وېشنيزه:وېنزوېلا	Category:ベネズエラ
روبېرت موگابي	ロバート・ムガベ
خاپوړن	爬虫類
کوتره	ハト科
باکټريا	真正細菌
ونه	木
دوه ژوندوي	両生類
اوښتون	革命
انگور	ブドウ
گبين	蜂蜜
کچالو	ジャガイモ
سابه	野菜
ټکنالوجي	テクノロジー
انجينري	工学
خبريالي	報道
ورځپاڼه	新聞
غږلېږدی	電話機
هڅوب	文化
سانسکریت ژبه	サンスクリット
د زړه او رگونو غونډال	循環器
د پارکېنسون ناروغي	パーキンソン病
گارډيان	ガーディアン
انډيپېنډنټ	インデペンデント
درملگري	医学
مقننه قوه	立法府
مالگه	塩
مايکروسافټ آفېس	Microsoft Office
وېشنيزه:رومانیا	Category:ルーマニア
کيمياوي توکی	元素
ابن باجه	イブン・バーッジャ
هورمون	ホルモン
اپارتايد	アパルトヘイト
لوبه	ゲーム
جودو	柔道
مقناطيس	磁石
فلم	映画
ساهيالي	アニメーション
کرنه	農業
غږ	音
نانو تکنالوژي	ナノテクノロジー
ښيښه	ガラス
وخت	時間
ليکپاڼه	紙
کازمېکي وړانگې	宇宙線
جوار	トウモロコシ
انځورکښنه	絵画
تشیالیونی	宇宙飛行士
انځوراخيستنه	写真
برېښنايي ټېکنالوژي	電子機器
فريکونسي	周波数
خوړنځی	レストラン
د لودیانو ټولواکمني	ローディー朝
لاهور	ラホール
د خپلواکو هېوادونو لړليک	国の一覧
ابوريحان بيروني	アブー・ライハーン・ビールーニー
څېړۍ	オーク
سرطان	悪性腫瘍
کولرا	コレラ
غنم	コムギ
ناروغي	病気
گرېگوري کليز	グレゴリオ暦
نیکوتین	ニコチン
روغتيا	健康
ملاريا	マラリア
انټيبايوټيک	抗生物質
پنسلين	ペニシリン
نېمونيا	肺炎
گوزڼ	急性灰白髄炎
اېډز	後天性免疫不全症候群
نری رنځ	結核
ډايبېټېز مېلېټوز	糖尿病
صليبي جگړې	十字軍
منځنۍ پېړۍ	中世
عثماني پېر	オスマン帝国
د کورنيو توليداتو ټوليز ارزښت	国内総生産
برېښنا	電気
یان آموس کمېنسکي	コメニウス
اټومي برېښناکوټ	原子力
د بړاس ماشين	蒸気機関
توره (وسله)	剣
هستوي وسلې	核兵器
شوبله	戦車
هرمان ون رومپوې	ヘルマン・ファン・ロンパウ
غرني توت	ブルーベリー
تورتوت	ブラックベリー
ناريال	ココナッツ
انار	ザクロ
مالټه	オレンジ
A New Etymological Vocabulary of Pashto	キウイフルーツ
گراڅ	グラーツ
ډېبټ کارډ	デビットカード
انجلينا جولي	アンジェリーナ・ジョリー
عربي ژبه	アラビア語
کانډوم	コンドーム
تيرانوسور	ティラノサウルス
تریسراتوپس	トリケラトプス
ستگوسور	ステゴサウルス
کارکارودونتوسور	カルカロドントサウルス
وچکښ	鉛筆
برنو	ブルノ
هوجينتاو	胡錦濤
د شوروي سوسياليستي جمهوريتونو اتحاد	ソビエト連邦
انځورۍ	カメラ
اېچ آی وي	ヒト免疫不全ウイルス
يومکی	肩甲骨
ځاني سولگر	パーソナルコンピュータ
بروس لي	ブルース・リー
هايپوتايرايډيزم	甲状腺機能低下症
نړۍ	世界
د روم جمهوريت	共和政ローマ
ټریلوبیټ	三葉虫
گردکه	円 (数学)
گرځنده غږلېږدی	携帯電話
اوښمرغه	ダチョウ
ويټامين اې	ビタミンA
بغ	サギ科
پيونگيانگ	平壌
د لور موندنې نړيوال غونډال	グローバル・ポジショニング・システム
د هېوادونو لړليک د کورنيو توليداتو د ټوليز ارزښت له مخې	国の国内総生産順リスト (為替レート)
جگتورن	大尉
سمندري غڼې	ウミグモ目
لړم	サソリ
ما اينگ جيو	馬英九
سمندري لړمان	ウミサソリ
انټرنټ لټوونکی ماشين	検索エンジン
بخارست	ブカレスト
لوور	ルーヴル美術館
تیرانا	ティラナ
ويکټوريا بېکهم	ヴィクトリア・ベッカム
درېڅنډی	三角形
سټيف جوبز	スティーブ・ジョブズ
معمر القذافي	ムアンマル・アル＝カッザーフィー
پړانگ	トラ
لومړی خوان کارلوس	フアン・カルロス1世 (スペイン王)
مېچې	ヴェルミチェッリ
لمسنالۍ	タッチパッド
سامسونگ	サムスングループ
سولگرپوهنه	計算機科学
ټولنپوهنه	社会学
گاگره	コンクリート
جغرافي کوراډينېټونو سيستم	地理座標系
پڼې	靴
بهايي	バハーイー教
بانک	銀行
د وينا ازادي	表現の自由
اډېل	アデル (歌手)
د نش ميزان	ナッシュ均衡
هوږه	ニンニク
وگړپوهنه	人類学
بادرنگ	キュウリ
ارنېست مېلر هېمېنگوې	アーネスト・ヘミングウェイ
عشق آباد	アシガバート
ټاپو	島
تور (رنگ)	黒
پياز	タマネギ
رسمي ژبه	公用語
لرغونپوهنه	考古学
بالکان	バルカン半島
سلاوي ژبې	スラヴ語派
سر	頭
ولسي لاره	国歌
تماسي عدسيه	コンタクトレンズ
الفرېډ نوبل	アルフレッド・ノーベル
ږمنځ	櫛
لیلا داونز	リラ・ダウンズ
موسم	季節
ډبرين سکاره	石炭
نينورشک	ニーノシュク
بوکمول	ブークモール
کونگ	フクロウ目
شمزۍ لرونکي ژوي	脊椎動物
نړېوال تشيال تمځای	国際宇宙ステーション
ISO 3166-1	ISO 3166-1
کجوره	ナツメヤシ
څټک	槌
اروپايي کاغۍ	カササギ
چابکۍ	ゴキブリ
كوچنى شاهزاده	星の王子さま
شمالي باز	オオタカ
غضروفی کبان	軟骨魚綱
ځنگلي سار	ヨーロッパノスリ
سيلاني کارغه	ミヤマガラス
لويديځي کاغۍ	ニシコクマルガラス
شودپۍ	タイリクハクセキレイ
اېشېريکيا کولي	大腸菌
توتکۍ	ツバメ
گنگو	サフラン
ترکاڼک	キツツキ科
شامتوره	ホシムクドリ
کوشانيان	クシャーナ朝
کومکۍ	モリバト
آتروپين	アトロピン
شين شارک	ヨシキリザメ
اورني سمندر	ファイアサラマンダー
سپوږمکۍ	人工衛星
شينغاړی	オガワコマドリ
تورياڼۍ	アマツバメ科
لونگ	クローブ
زيره	キャラウェイ
وژونکی نهنگ	シャチ
سپېرکونده	カンムリヒバリ
منځنۍ آسيا	中央アジア
شمالي افريقا	北アフリカ
مرکزي افريقا	中部アフリカ
ختيځه اروپا	東ヨーロッパ
لوېديځه اروپا	西ヨーロッパ
افريقايي اوراسيا	アフロ・ユーラシア大陸
د فلسفې تاريخ	哲学史
زي نړیواله جگړه (فلم)	ワールド・ウォーZ
مړز	ヨーロッパウズラ
مروری	カモミール
کمول (مارغه)	コウノトリ科
اوبدانه	織物
توکي	財
سپوږميز ليږديز کليز	ヒジュラ暦
ميلوش زېمان	ミロシュ・ゼマン
اېف-۱۵	F-15 (戦闘機)
ليوکېمي	白血病
ديموکراتيک گوند ( د امريکا متحده ایالتونه)	民主党 (アメリカ)
ټيکاله	ヒバリ科
شاتو مچی	セイヨウミツバチ
ولسمشر	大統領
باشه	ハヤブサ
رودولف کلاوزيوس	ルドルフ・クラウジウス
تورغوږی	カラカル
ډېل	デル
شمېرنی	計算機
امير عبدالرحمان خان	アブドゥッラフマーン・ハーン
د عربستان ټاپووزمه	アラビア半島
امير دوست محمد خان	ドースト・ムハンマド・ハーン
بېریف بې-۲۰۰	Be-200 (航空機)
پهلوي ژبه	パフラヴィー語
وری	白羊宮
بردسکن ولسوالۍ	バルダスキャン郡
ملاله يوسفزۍ	マララ・ユスフザイ
جومات	モスク
بلوڅی ژبه	バローチー語
د کتاب نړيواله کره شمېره	ISBN
د کندهار نړيوال هوايي ډگر	カンダハール国際空港
د مغولو پاچايي	ムガル帝国
گړدود	方言
ایرانی ژبی	イラン語群
لاس	手
خلکو شمېر	人口
پاڼه	葉腋
لوبگر	俳優
هاليووډ	ハリウッド
محمد حسنی مبارک	ホスニー・ムバーラク
دينپوهنه	神学
پابلو نرودا	パブロ・ネルーダ
زیوس	ゼウス
موساد	イスラエル諜報特務庁
انجيل	福音書
الېکسانډر گراهام بېل	アレクサンダー・グラハム・ベル
ستورپېژندنه	占星術
ساز	楽器
ويټني هيوسټن	ホイットニー・ヒューストン
سابون	石鹸
موشوفتسی	モショヴツェ
شکيرا	シャキーラ
محمود احمدي نژاد	マフムード・アフマディーネジャード
كېښكلى ټيكلى (CD)	コンパクトディスク
چورلکه	ヘリコプター
القاعده	アルカーイダ
محمد فاتح	メフメト2世
اناستاسيا	アナスタシア (歌手)
فرات	ユーフラテス川
البېرټ کامو	アルベール・カミュ
د فارس خليج	ペルシア湾
قطب نما	方位磁針
ټولنيزې پوهنې	社会科学
ټاپووزمه	半島
نوی کال	新年
اېف-۱۴	F-14 (戦闘機)
ويټامين	ビタミン
تورات	トーラー
كرم	キャベツ
متل	ことわざ
هينداره	鏡
لرغونې پاړسي	古代ペルシア語
عربان	アラブ人
براډ پېت	ブラッド・ピット
کړکۍ	窓
اکدي ژبه	アッカド語
څارندوی	警察
ولسي جرگه	議会
اوساکا	大阪市
د کېمبرېج پوهنتون	ケンブリッジ大学
اجرايي قوه	行政
تعمید غسل	洗礼
ډډون	インフレーション
سابندي	気管支喘息
عمر خيام	ウマル・ハイヤーム
وله	ヤナギ
محمد علي کلي	モハメド・アリ
خاوره	土壌
اينځر	イチジク
ليکوال	著作家
د توهوکو سونامي او رېږدله ۲۰۱۱	東北地方太平洋沖地震
واتسلاف هاول	ヴァーツラフ・ハヴェル
د ورېښم لار	シルクロード
جېن آسټن	ジェーン・オースティン
کوردي ژبه	クルド語
زرۍ	ミレニアム
علمی نوم	学名
هنرېک ايبسن	ヘンリック・イプセン
ماموت	マンモス
څلورڅنډی	四角形
د سرکوزي والگی	豚インフルエンザ
اوزون	オゾン
جذام	ハンセン病
مخ (اناتومي)	顔
خپلواکي	独立
ښوون	オリーブ
سليمان	ソロモン
یاهو!	Yahoo!
کرښه (مېچپوهنه)	直線
فرعون	ファラオ
کلاشېنکوف اې کې ۴۷	AK-47
څپه	波動
د وینې سره کرویات	赤血球
سند	シンド州
فرانسېس بیکن	フランシス・ベーコン (哲学者)
معمولي مندته	アンズ
نيکول کېډمېن	ニコール・キッドマン
هايکو	俳句
عثمان بن عفان	ウスマーン・イブン・アッファーン
وگړشمېرنه	人口統計学
ځمکواکي	封建制
اوبړۍ	藻類
نتالي پورټمېن	ナタリー・ポートマン
هېرټا مولر	ヘルタ・ミュラー
مکډونالډز	マクドナルド
يوکوهوما	横浜市
گړپوهنه	形態論
ويليم فاکنر	ウィリアム・フォークナー
هندواڼه	スイカ
پخلی	料理
بادي ژرنده	風車
د حماس اسلامي غورځنگ	ハマース
آيت الله روح الله خميني	ルーホッラー・ホメイニー
ليزر	レーザー
تبه	発熱
تيد	テイデ山
کوچنی وټه	ミクロ経済学
رجب طيب اردوغان	レジェップ・タイイップ・エルドアン
خزدکپوهنه	昆虫学
تبر	斧
علي بن ابي طالب	アリー・イブン・アビー・ターリブ
گورجی سپی	セッター (猟犬)
لویه وټه	マクロ経済学
انسولين	インスリン
بازارموندنه	マーケティング
سرشمېرنه	国勢調査
ابن رشد	イブン・ルシュド
لسيزه	10年紀
بادام	アーモンド
څښاک	飲料
نيانډرټال	ネアンデルタール人
الهي کمېډي	神曲
ووب	組織 (生物学)
امير شېر علي خان	シール・アリー・ハーン
پروېز مشرف	パルヴェーズ・ムシャラフ
لوط	ロト (聖書)
دهاډرونو ستر تعجیل کوونکي ماشین	大型ハドロン衝突型加速器
يحيی	洗礼者ヨハネ
دیلما روسف	ジルマ・ルセフ
ساندرا بللاک	サンドラ・ブロック
جراحي	外科学
بياتي	はさみ
نفرتيتي	ネフェルティティ
لمونځ	祈り
سکايپ	Skype
غږپوهنه	音韻論
هارولډ پينټر	ハロルド・ピンター
د حزب الله اسلامی غورځنگ	ヒズボラ
باو	梅毒
د آشور واکمني	アッシリア
ودانۍ	建築物
سوني	ソニー
باريس ولاديميروويچ پاسترناک	ボリス・パステルナーク
کونستانتين اېدواردوويچ تسيولکوفسکي	コンスタンチン・ツィオルコフスキー
سينما	映画館
بودجه	予算
څپواټن	波長
داوود	ダビデ
کنگل هاکي	アイスホッケー
کوردستان	クルディスタン
د موس مقياس	モース硬度
بواسيرونه	痔
هېنريک سېنکېويچ	ヘンリク・シェンキェヴィチ
كوكايين	コカイン
فینیکیان	フェニキア
شهادت	シャハーダ
د بابل ځوړند بڼ	バビロンの空中庭園
حاکميت	主権
خديجه بنت خويلد	ハディージャ・ビント・フワイリド
نیلي نهنگ	シロナガスクジラ
څېړنه	研究
سولي پرودممه	シュリ・プリュドム
اوبپوهنه	水文学
بوکر	円錐
د مورنۍ ژبې نړيواله ورځ	国際母語デー
سهيونېزم	シオニズム
د طالبانو اسلامي غورځنگ	ターリバーン
اناکزیمېنډر	アナクシマンドロス
کورکمن	ウコン
ځنگلي پيشو	ジャングルキャット
عبدالله گل	アブドゥラー・ギュル
ختيځپوهنه	オリエンタリズム
کرېشنا	クリシュナ
ساباوري	アニミズム
ليکچه	ノートブック
مالیه	金融
وچکالي	旱魃
تور مرچ	コショウ
ياقوت	ルビー
کشمير	カシミール
ټولپوښتنه	住民投票
كپېړ	クロコダイル科
مولانا جلال الدين محمد بلخي	ジャラール・ウッディーン・ルーミー
کارغه	カラス属
پلزن	プルゼニ
توکمپوهنه	民族学
مټ	腕
زمرد	エメラルド
وحشي پيشو	ヤマネコ (種)
شکرخوره	ハチドリ
فدراسيون	連邦
شونډکيز چرگ	シチメンチョウ属
انسلم	アンセルムス
حامد کرزی	ハーミド・カルザイ
یان هوس	ヤン・フス
کورني آلو	セイヨウスモモ
اندرس بېرينگ برېويک	アンネシュ・ベーリング・ブレイビク
شينټاغی	ブッポウソウ科
احمد سلمان رشدي	サルマン・ラシュディ
افسانه	伝説
داریوش ۱	ダレイオス1世
توت	クワ
اېنټروپي	エントロピー
هرات	ヘラート
کودتا	クーデター
کندهار	カンダハール
تړمه ييزه پراختیا	熱膨張率
غشی	矢
غږتاندی	マイクロフォン
ابن عربي	イブン・アラビー
توراڼه	オウチュウ
اپيم	アヘン
اوسيريس	オシリス
ازاد بازار	自由市場
احمد شاه دراني	アフマド・シャー・ドゥッラーニー
اسراييل لرغونتون	イスラエル博物館
جي اس ام	GSM
اېشواريه رای	アイシュワリヤー・ラーイ
نوغپوهنه	系譜学
مېلټون فرايډمېن	ミルトン・フリードマン
بانکنوټ	紙幣
نړيواله جنايي محکمه	国際刑事裁判所
رادار	レーダー
د اسلامي همکاريو سازمان	イスラム協力機構
سياسي وټه	政治経済学
د بابل واکمني	バビロニア
جبران خليل جبران	ハリール・ジブラーン
خټکی	ハネデューメロン
روبي وېليمز	ロビー・ウィリアムズ
د سږو سرطان	肺癌
مهايانا	大乗仏教
امريتسر	アムリトサル
اس ـ ۳۰۰	S-300 (ミサイル)
مير تشيال تمځی	ミール
لنډه کيسه	短編小説
د لبنان جگړه ۲۰۰۶	レバノン侵攻 (2006年)
گرځندويي	観光
شاعر	詩人
بادي توربین	風力原動機
يو گونديز حکومت	一党制
مصري ژبه	エジプト語
هارون	アロン
ایبولا ناروغۍ	エボラ出血熱
ژونځمکپوهنه	生物地理学
غونډ	連隊
سور كانگرو	アカカンガルー
هارپي	オウギワシ
ابسيډين	黒曜石
وېشنيزه:حکومت	Category:政府
د کيلو کلاس اوبتل	キロ型潜水艦
سپايس گرلز	スパイス・ガールズ
مېزپاسی سولگر	デスクトップパソコン
پاراستامول	アセトアミノフェン
عبدالله بن عبدالعزیز آل سعود	アブドゥッラー・ビン・アブドゥルアズィーズ
سيد على خامنه‌اى	アリー・ハーメネイー
امام علي رحمانوف	エモマリ・ラフモン
اودو فوګت	ウド・フォークト
اسلام کريموف	イスラム・カリモフ
گيودو ويسترويلي	ギド・ヴェスターヴェレ
پښتو ژبه	パシュトー語
عرب سمندرگی	アラビア海
گرمټ	電気ドリル
دیو جانس کلبی	ディオゲネス (犬儒学派)
هېرويين	ヘロイン
کوفین	カフェイン
اندروجن	アンドロゲン
سيمټيکس	セムテックス
راوړنې	輸入
ببرک کارمل	バブラク・カールマル
حفيظ الله امين	ハフィーズッラー・アミーン
يوسف عبدالله القرضاوي	ユースフ・アル＝カラダーウィー
تريخی	胆嚢
انتوني هوپکينز	アンソニー・ホプキンス
مرکزي بانک	中央銀行
جيپور	ジャイプル
سيبري پړانگ	アムールトラ
القلويد	アルカロイド
آدم	アダム
ترور	おば
یوسيف ۲	ヨーゼフ2世
تره	おじ
کریستوف والڅ	クリストフ・ヴァルツ
رنگين دادفر سپنتا	ランギーン・ダードファル・スパンター
عبدالاحد مومند	アブドゥルアフド・ムハンマド
ښاري انجنيري	土木工学
وړانگپوهنه	放射線医学
اليگارشي	寡頭制
زړه گراف	心電図
د افغانستان رپی	アフガニスタンの国旗
ايسيس	イシス
ځوانکې	ニキビ
اېترنټ	イーサネット
چکوتره	ブンタン
بشري پوهنې	人文科学
ټپوس	トビ
نهنگی شارک	ジンベエザメ
بېنډۍ	オクラ
د سلطان احمد جومات	スルタンアフメト・モスク
اټومي بټۍ	原子炉
مايکروسافټ اوټلوک	Microsoft Outlook
مالداري	畜産
معمولي کپر (کب)	コイ
اولوموڅ	オロモウツ
مورفين	モルヒネ
د صرافی ماشین	現金自動預け払い機
نخود	ヒヨコマメ
نوح	ノア (聖書)
والټ وايټمېن	ウォルト・ホイットマン
غاښۍ	フォーク (食器)
چوپسټېک	箸
د خوړو او کرهڼې سازمان	国際連合食糧農業機関
براشوف	ブラショヴ
زنه	おとがい
قطبي گيدړ	ホッキョクギツネ
سياستوال	政治家
شپږڅنډی	六角形
د افغانستان جگړه (۱۹۷۹-۱۹۸۹)	アフガニスタン紛争 (1978年-1989年)
ختيځ هند کمپنۍ	イギリス東インド会社
الكساندر نيكولاېويچ رومانوف	アレクサンドル2世
اسکلېپيوس	アスクレーピオス
ژان اېف کوستو	ジャック＝イヴ・クストー
وزير (حکومت)	大臣
گرو نانک	グル・ナーナク
کانپوهنه	鉱物学
شېنگن تړون	シェンゲン協定
سابه خوړونکي	ベジタリアニズム
امپيدوکلېس	エンペドクレス
اوېستا	アヴェスター
شاه جهان	シャー・ジャハーン
شېر شاه سوري	シェール・シャー
د الله نومونه	アッラーフの99の美名
د ساسانيانو واکمني	サーサーン朝
هوروس	ホルス
پولنډبال	ポーランドボール
راټکو مېلادېچ	ラトコ・ムラディッチ
انځورگري	素描
پرېژه	離婚
باليووډ	ボリウッド
اېف – ۱۶	F-16 (戦闘機)
کلوژ-ناپوکا	クルジュ＝ナポカ
مرزا حسين علي بهاالله	バハーウッラー
نېغ انسان	ホモ・エレクトス
ماهر انسان	ホモ・ハビリス
هاډرون	ハドロン
سوسن	スズラン
اينو	アイヌ
تسپود	炎症
بايوم	生物群系
لروين	双眼鏡
گبين مچۍ	ミツバチ
آوسټرالوپیتهېکوس	アウストラロピテクス
نړېواله جگړه	世界大戦
روي شنکر	ラヴィ・シャンカル
چندرۍ	ホップ
کرښی	定規
قضايي قوه	司法
ماگنوس کارلسن	マグヌス・カールセン
خاښۍ	ピッチフォーク
کندوز	クンドゥーズ
د افغانستان د ښارونو لړليک	アフガニスタンの都市の一覧
انجه	アサフェティダ
مارشال	元帥
انټيکولينرجيک	抗コリン薬
مالي کړکېچ	金融危機
هزاره گان	ハザーラ人
کريم خليلي	カリーム・ハリーリー
سليكان ډای اکسايډ	二酸化ケイ素
کورکورکه	カノコバト
د وېلسن ناروغي	肝レンズ核変性症
د پاني پت جگړه	パーニーパットの戦い
الكساندر الكساندروويچ رومانوف	アレクサンドル3世
بلخ ولايت	バルフ州
مشهد	マシュハド
رنځورپالنه	看護
ټولنیزه ولسواکي	社会民主主義
د ستنې طب	鍼
سفارت	大使
کجير	ハゲワシ
عقيق	メノウ
اپلاتون او دولت	国家 (対話篇)
ارستوکراسي	貴族制
زکات	ザカート
گيورگې ژوکوف	ゲオルギー・ジューコフ
د اوبو چينه	湧水
بڼ پالنه	ガーデニング
وېليم جېمز	ウィリアム・ジェームズ
غوڅندۍ	鋸
سورلنډی	ジャッカル
د موسم بدلون	気候変動
واټن	距離
کوباني	アイン・アル＝アラブ
پراگماتيزم	プラグマティズム
وړکتون	幼稚園
ابن ميمون	モーシェ・ベン＝マイモーン
شين یاقوت	サファイア
پينځڅنډی	五角形
ټوټالېټر	全体主義
کوچيان	遊牧民
درملپوهنه	薬理学
د زیات شوي ارزښت ورکړېنه	消費税
خټنه	粘度
لوي سپين شارک	ホホジロザメ
د جمشید پلاز	ペルセポリス
انتراکس	炭疽症
خشايارشا	クセルクセス1世
مزار شريف	マザーリシャリーフ
مېگ ۲۹	MiG-29 (航空機)
د ذرو تعجيل کوونکي ماشين	加速器
ډیمېټروډون	ディメトロドン
سپاینوسور	スピノサウルス
بېیپیاوساوروس	ベイピアオサウルス
خلافت	イスラム帝国
معمولي آلوبالو	スミミザクラ
زغوپرواژی	農薬
ډومنيک ډي وېلپين	ドミニク・ド・ビルパン
د قم ولايت	ゴム州
گڼرسنۍ	マルチメディア
کوروند	コランダム
سریښ	接着剤
والي	知事
توکمکښنه	民族誌
کرما په هندويزم کې	業
آيورويدا	アーユルヴェーダ
د جال تړونونه	通信プロトコル
جوليوس روبرټ اوپنهايمر	ロバート・オッペンハイマー
باختر	バクトリア
هېروگليف	ヒエログリフ
ولاديمير ولاديميروويچ ماياکوفسکي	ウラジーミル・マヤコフスキー
د هند پېښليک	インドの歴史
مستعمره	植民地
ملخوزه	フェヌグリーク
اخوان المسلمون	ムスリム同胞団
تومور	腫瘍
الياس	エリヤ
طاعون	ペスト
د سېټريک اسيد څرخ	クエン酸回路
ټاسماني شيطان	タスマニアデビル
توپاز	トパーズ
۹×۱۹ مرمی	9x19mmパラベラム弾
قادريه	カーディリー教団
د ايران ولسوالۍ	イランの郡の一覧
سردار محمد هاشم خان	ムハンマド・ハーシム・ハーン
ابد	永遠
عبدالعلي مزاري	アブドゥルアリー・マザーリー
زابل ولايت	ザーブル州
زکريا	ザカリア
مسراشمیت مې-۲۶۲	メッサーシュミット Me262
ازاد شعر	自由詩
شگموښی	紙やすり
ايليوشين-۷۶	Il-76 (航空機)
هربرټ سپېنسر	ハーバート・スペンサー
زلمی رسول	ザルマイ・ラスール
زلمی خليلزاد	ザルメイ・ハリルザド
سارک	南アジア地域協力連合
يوسف	ヨセフ (ヤコブの子)
د لويديځ سلاوي ژبې	西スラヴ語群
اروپايي صنوبر	オウシュウトウヒ
چمبل	スミレ属
پولي ونيل کلورايډ	ポリ塩化ビニル
نانگه	フサスグリ
قبطيان	コプト
نارنج	ダイダイ
اناناس	アナナス属
کاجول	カジョール
ايگلا	9K38 イグラ
مېگ ۳۱	MiG-31 (航空機)
پښيميسل اوتاکار ۲	オタカル2世
رودلف ۲ هابسبورگ	ルドルフ2世 (神聖ローマ皇帝)
عبد العزيز بن عبدالرحمن بن فيصل آل سعود	アブドゥルアズィーズ・イブン・サウード
دېوالي	倒産
بوغمه	浮腫
محمد ظاهر شاه	ザーヒル・シャー
ډگر جنرال	中将
بريد جنرال	准将
البرخت فون والدشتاین	アルブレヒト・フォン・ヴァレンシュタイン
امير امان الله خان	アマーヌッラー・ハーン
محمود طرزي	マフムード・タルズィー
عمران خان	イムラン・カーン
یان لوگزامبورگ	ヨハン・フォン・ルクセンブルク
روهتاس	ロータス・フォート
جيارډيا لامبليا	ランブル鞭毛虫
ميل می ۸	Mi-8 (航空機)
مېسرشمېت بي اف ۱۰۹	メッサーシュミット Bf109
مسراشمیت بي اف ۱۱۰	メッサーシュミット Bf110
یوزي	UZI (SMG)
ريچارډ هولبروک	リチャード・ホルブルック
ميل می ۲۴	Mi-24 (航空機)
ايساف	国際治安支援部隊
ټې-۷۲	T-72
یونکرس یو ۸۸	Ju 88 (航空機)
کارل ۴	カール4世 (神聖ローマ皇帝)
مېگ ۲۳	MiG-23 (航空機)
ارهنډه	トウゴマ
اېرو ال-۳۹ الباتروس	L-39 (航空機)
ټېنوفووير	テノホビル
د آلمان ملي دموکراتیک گوند	ドイツ国家民主党
رشقه	ムラサキウマゴヤシ
ادميرال پتنگ	ヨーロッパアカタテハ
فيض آباد (بدخشان)	ファイザーバード (バダフシャーン州)
ځريځه	ベニバナ
تورن جنرال	少将
گزک بوټي	ヘラオオバコ
ال – ۴۱۰	L-410 (航空機)
تبو	タッブー
غوماشی	ハマダラカ
د افغانستان ولايتونه	アフガニスタンの州
تاووس پتنگ	クジャクチョウ
جوهي چاولا	ジューヒー・チャーウラー
پريانکا چوپړا	プリヤンカー・チョープラー
لاکهيډ مارتين آر کيو ۱۷۰ سېنټينل	RQ-170 (航空機)
ناصر الدين شاه قاجار	ナーセロッディーン・シャー
سپما گڼون	預金
د اس وې ډې دراگونوف ټوپک	ドラグノフ狙撃銃
یرژي پوديېبراد	イジー・ス・ポジェブラト
وټه	経済
د ځمکې گړۍ	アース・アワー
رام	ラーマ
محمد علی جناح	ムハンマド・アリー・ジンナー
وچکۍ تبه (محرقه)	チフス
اتره	胴体
توت خوره	アトリ科
سنځله	グミ (植物)
ښاريتوب	都市化
غونجېدنه (وټپوهنه)	デフレーション
خپلپالنه	縁故主義
باور کارټ	クレジットカード
پامير	パミール高原
سرطانپوهنه	腫瘍学
گلايکوليسېز	解糖系
شکودا فابيا	シュコダ・ファビア
گایوس واليریوس کاتولوس	ガイウス・ウァレリウス・カトゥルス
بلوچستان (پاکستان)	バローチスターン州
غالۍ	絨毯
موزيکپوهنه	音楽学
ليندۍ	磨羯宮
ابسه	膿瘍
گانډۍ	養蜂箱
کدو	カボチャ
د کرمان ولايت	ケルマーン州
بدخشان ولايت	バダフシャーン州
لیکاڼۍ	ペン
اتڅنډی	八角形
مچ	イエバエ
وړانديز (وټپوهنه)	需要と供給
پارلماني حکومت	議院内閣制
برغټ	マヌルネコ
عبدالقدير	ハジ・アブドゥル・カディール
محمد محقق	ムハンマド・モハッケク
نگوس	ステレオタイプ
نورستان ولايت	ヌーリスターン州
محمد قسيم فهيم	ムハンマド・ファヒーム
ډولومیت	ドロマイト
جابر بن حیان	ジャービル・イブン＝ハイヤーン
بورقه	ブルカ
کرايووا	クラヨーヴァ
کورکوری	コキジバト
روحانيت	スピリチュアリティ
انافلاکسي	アナフィラキシー
د اسلام انبیاء	イスラム教の預言者
لاسپېله	手袋
محمد زکريا رازي	アル・ラーズィー
مېترونيدازول	メトロニダゾール
گرافېن	グラフェン
رنځېږن	病原体
ليکپاکټ	封筒
کانفدراسيون	国家連合
ټي اېن ټي	トリニトロトルエン
چېکيان	チェコ人
بغلان ولايت	バグラーン州
ابټ آباد	アボッターバード
بدن	体
يزد ولايت	ヤズド州
قم	ゴム (イラン)
توماس اېډورډ لارېنس	トーマス・エドワード・ロレンス
بيولوژيکي وسلې	生物兵器
ټېغکه	モズ科
عباس ۱	アッバース1世
باميان ولايت	バーミヤーン州
ای اچ ۶۴ آباچی	AH-64 アパッチ
لمرگلی	ヒマワリ
د سهېلي خراسان ولايت	南ホラーサーン州
پېښه	事故
کرمان	ケルマーン
احمديت	アフマディーヤ
د اگرې کلا	アーグラ城塞
د مذهب خپلواكي	信教の自由
تيتر	ホロホロチョウ科
ځانگړواله	個人主義
بادغيس ولايت	バードギース州
قبة الصخرة جومات	岩のドーム
اشرف غني احمدزی	アシュラフ・ガニー
رېبز	箒
ټوپولف ټو-۱۵۴	Tu-154 (航空機)
نړیواله پېغله	ミス・ワールド
آټوکراسي	専制政治
خواړه ساتنه	保存食
مارگريت ميتچېل	マーガレット・ミッチェル
آرگېنين	アルギニン
سوخوی سو ٢٧	Su-27 (航空機)
ام۱ آبرامس	M1エイブラムス
غزني	ガズニー
وختتېری	エンターテインメント
کندهار ولايت	カンダハール州
کاپيسا ولايت	カーピーサー州
هلمند ولايت	ヘルマンド州
فارياب ولايت	ファーリヤーブ州
محراب	ミフラーブ
د الازهر پوهنتون	アル＝アズハル大学
بوتل پزی څوڅ	ハンドウイルカ
اوسېلوسکوپ	オシロスコープ
توحيد	タウヒード
بي-٥٢ سټراټوفورټرېس	B-52 (航空機)
کوډيين	コデイン
قبله	キブラ
فتح علي شاه قاجار	ファトフ・アリー・シャー
بېديانۍ پيشو	スナネコ
تانبه:تاریخ	Portal:歴史
واتسلاف ۱	ヴァーツラフ1世 (ボヘミア王)
د اسلام پنځه بنسټونه	五行 (イスラム教)
زوی	息子
سکاره	木炭
شنقار	シロハヤブサ
د ژونکې تيوري	細胞説
فولېرېن	フラーレン
نېکروسېز	壊死
د واشنگټن څلی	ワシントン記念塔
آنتونوف-۲۲۵	An-225 (航空機)
وييپوهنه	語彙論
ننگرهار ولايت	ナンガルハール州
درونکښ	クレーン
کاني اوبه	ミネラルウォーター
نولۍ	フェレット
لگښت ساتنې تگلاره	保護貿易
آنتیستنس	アンティステネス
مرکزي حکومت	単一国家
د پاکستان په شمال لویدیځ کې جگړه	ワジリスタン紛争
اسماني کتابونه او صحيفې	聖典
ژبساپوهنه	心理言語学
اوبزمکپوهنه	水文地質学
د مزلو د اړتیاوو د مرتبو سلسله	自己実現理論
د بازار وټه	市場経済
اپیکوریزم	エピクロス主義
اورمازده	アフラ・マズダー
درملنه	治療
اريايان	アーリア人
يعقوب کندي	キンディー
گورجېس	ゴルギアス
سياسي فلسفه	政治哲学
جوهر دوداییف	ジョハル・ドゥダエフ
ايوب	ヨブ
ستورمزلي	宇宙開発
اېکونومېسټ	エコノミスト
تورگوت اوزال	トゥルグト・オザル
نورتورپ گرومان بي ۲ سپېريټ	B-2 (航空機)
لمريز لېږديز کليز	イラン暦
فراه ولايت	ファラー州
غزني ولايت	ガズニー州
راشدين خليفه گان	正統カリフ
وړانگدرملنه	放射線療法
کوټه	部屋
شاپ	坐剤
پوهنځی	学部
نکوټي يانا ټیبېکم	タバコ
بلوچستان	バルーチスターン
سيد حسن نصرالله	ハサン・ナスルッラーフ
دايکندي ولايت	ダーイクンディー州
پنجشېر ولايت	パンジシール州
زړه نابری	心不全
ټوپولف ټو-۹۵	Tu-95 (航空機)
د جانسي راني	ラクシュミー・バーイー
بلخ	バルフ
امونيم نايټرېټ	硝酸アンモニウム
آسيايي زمري	インドライオン
کامبوجيه ۲	カンビュセス2世
سرپل ولايت	サーレポル州
پکتيا ولايت	パクティヤー州
خوارزم	ホラズム
بهرونه	輸出
ايټا جېمز	エタ・ジェイムズ
كنسرټ	演奏会
هرات ولايت	ヘラート州
سمنگان ولايت	サマンガーン州
نيمروز ولايت	ニームルーズ州
روزگان ولايت	ウルーズガーン州
جوزجان ولايت	ジョウズジャーン州
ميدان وردگ ولايت	ヴァルダク州
کورکوړۍ	ハチクイ科
شننيزه فلسفه	分析哲学
سېموېل کولټ	サミュエル・コルト
جلالکوټ	ジャラーラーバード
خيبر پښتونخوا	カイバル・パクトゥンクワ州
سينوسايټس	副鼻腔炎
موکشا	解脱
اسماعيل	イシュマエル
نسخوږی	腹痛
لسڅنډی	十角形
چينايي فلسفه	中国哲学
بوينگ بي ۲۹	B-29 (航空機)
بوينگ بي ۱۷ فلاينگ فورټرېس	B-17 (航空機)
اسيډوسېز	アシドーシスとアルカローシス
واسلين	ワセリン
اوبي ژرنده	水車小屋
فلېپيني عقاب	フィリピンワシ
لغمان ولايت	ラグマーン州
مولتان	ムルターン
کوټه (ښار)	クエッタ
پکتيکا ولايت	パクティーカー州
خوست ولايت	ホースト州
کيفيت	品質
بريدمن	中尉
علي اکبر هاشمي رفسنجاني	ハーシェミー・ラフサンジャーニー
ايمن الظواهري	アイマン・ザワーヒリー
رنځورپاله	看護師
غور ولايت	ゴール州
تخار ولايت	タハール州
کندوز ولايت	クンドゥーズ州
د پاکستان د خلکو گوند	パキスタン人民党
د اتریش د خلک ګوند	オーストリア国民党
ايبوپروفېن	イブプロフェン
ابهيشېک بچچن	アビシェーク・バッチャン
سالنډي	呼吸困難
کونړ ولايت	クナル州
پروان ولايت	パルヴァーン州
قول اردو	軍団
ايمفيسېما	肺気腫
احمد ياسين	アフマド・ヤースィーン
برهان الدين رباني	ブルハーヌッディーン・ラッバーニー
پريټي زېنتا	プリーティ・ズィンタ
صحابه	サハーバ
سمایلوډون	スミロドン
اوڅنډی	七角形
د افغانستان پېښليک	アフガニスタンの歴史
کابل ولايت	カーブル州
ټېډ	TED (カンファレンス)
سلطان محمود غزنوي	マフムード (ガズナ朝)
د زړه ارېتميا	不整脈
پینټریټ	ペンスリット
اسلامي هنر	イスラム美術
اسلامپالنه	イスラム主義
پوښتنه	疑問文
هیکسوجن	トリメチレントリニトロアミン
ميناتو	港区 (東京都)
وزيرستان	ワズィーリスターン
اوښلن لوگی	催涙剤
کوستا کونکورديا	コスタ・コンコルディア
د زړه ناروغۍ	心臓病
مرکاوا شوبله	メルカバ (戦車)
جوهر	本質
ټوپولف ټو-۱۶۰	Tu-160 (航空機)
شيطاني آيات	悪魔の詩
خيبر دره	カイバル峠
شاپور ۱	シャープール1世
سيلدينافيل	シルデナフィル
مالي کال	会計年度
سوخوی سو-۲۵	Su-25 (航空機)
پرولاکټين	プロラクチン
ټانگتوره	チョウセンアサガオ属
تیسفون	クテシフォン
ډېلي ټيليگراف	デイリー・テレグラフ
سټرېپټومايسين	ストレプトマイシン
هندي څمڅه منگور	インドコブラ
ټې-۹۰	T-90
نادر شاه افشار	ナーディル・シャー
د بوټي هورمون	植物ホルモン
ټېټراسايکلين	テトラサイクリン
اسلامي فلسفه	イスラーム哲学
سبسيډي	補助金
د پراگ کلا	プラハ城
آنتونوف-۱۲۴	An-124 (航空機)
ملا محمد عمر	ムハンマド・オマル
فريد الدين عطار	ファリードゥッディーン・アッタール
کړنی سېک	活動電位
امام احمد بن حنبل	イブン・ハンバル
سوخوی پک فا	PAK FA (航空機)
علي احمد جلالي	アリー・アフマド・ジャラーリー
شاهرخ افشار	シャー・ルフ (アフシャール朝)
ام کيو-۱ پرېډاټور	RQ-1 プレデター
کوږوږ	ジグザグ
زيډووډين	ジドブジン
محمد يونس خالص	ムハンマド・ユーヌス・ハーリス
گلروزنه	花卉園芸
افغانۍ	アフガニ
مېگ ۲۵	MiG-25 (航空機)
د سږو اوندنه خنډيزه ناروغي	慢性閉塞性肺疾患
احمد شاه مسعود	アフマド・シャー・マスード
داسو میراژ- ۲۰۰۰	ミラージュ2000 (戦闘機)
نهڅنډی	九角形
آزاد کشمير	アザド・カシミール
اوبسپی	カワウソ
چينايي دوديزه درملگري	中国医学
گېلگېت بالتستان	ギルギット・バルティスタン州
کېټ وېنسلېټ	ケイト・ウィンスレット
نيوموتوراکس	気胸
اورو لانکاسټر	アブロ ランカスター
لرغونې فلسفه	古代哲学
زين العابدين بن علي	ザイン・アル＝アービディーン・ベン・アリー
غرزي	ギルザイ部族連合
يوني ماشين	イオンエンジン
نېټه	日付
ایزو ۹۰۰۰	ISO 9000
اليسع	エリシャ
ترچ مير	ティリチミール
مطبوعاتي اعلاميه	プレスリリース
محمد نجيب الله	ムハンマド・ナジーブッラー
قونسلگري	領事
زنځيري غوڅندۍ	チェーンソー
فدرالي قبايلي سيمې	連邦直轄部族地域
د مذهب فلسفه	宗教哲学
ډايازيپم	ジアゼパム
سوخوی سو-۲۴	Su-24 (航空機)
کورټيکوسټېرويډ	副腎皮質ホルモン
غوږور ښاپېرک	ウサギコウモリ
چندړ	ビャクダン
سيد قطب	サイイド・クトゥブ
بوکو حرام	ボコ・ハラム
السلام عليکم	アッサラーム
اېنډوسکوپي	内視鏡
طبله	タブラ
غونډل	オオツチグモ科
گندهارا	ガンダーラ
کوډېکس	コデックス
يان ژيژکا	ヤン・ジシュカ
يوم	鋤
ستره لوبه	グレート・ゲーム
لاجورد	ラピスラズリ
مقتدی الصدر	ムクタダー・アッ＝サドル
چت	床
يزيد بن معاويه	ヤズィード1世
آلانين	アラニン
احمد ضيا مسعود	アフマド・ズィヤ・マスード
ښکلي هنرونه	ファインアート
افدرين	エフェドリン
ای اچ ۱ کبرا	AH-1 コブラ
سورة الفاتحة	開端 (クルアーン)
سورة البقرة	雌牛 (クルアーン)
سورة آل عمران	イムラーン家 (クルアーン)
سورة النساء	婦人 (クルアーン)
سورة المائدة	食卓 (クルアーン)
سورة الأنعام	家畜 (クルアーン)
سورة الأعراف	高壁 (クルアーン)
سورة الأنفال	戦利品 (クルアーン)
سورة التوبة	悔悟 (クルアーン)
سورة يونس	ユーヌス (クルアーン)
سورة هود	フード (クルアーン)
سورة يوسف	ユースフ (クルアーン)
سورة الرعد	雷電 (クルアーン)
سورة إبراهيم	イブラーヒーム (クルアーン)
سورة الحجر	アル・ヒジュル (クルアーン)
جنگسالار	ウォーロード
سورة النحل	蜜蜂 (クルアーン)
ښي لاسی او کيڼ لاسی ترافيک	対面交通
سورة الاسراء	夜の旅 (クルアーン)
سورة الكهف	洞窟 (クルアーン)
سورة مريم	マルヤム (クルアーン)
سورة طه	ター・ハー (クルアーン)
سورة الأنبياء	預言者 (クルアーン)
سورة الحج	巡礼 (クルアーン)
سورة المؤمنون	信者たち (クルアーン)
سورة النور	御光 (クルアーン)
برات	シャアバーン
سورة الفرقان	識別 (クルアーン)
سورة الشعراء	詩人たち (クルアーン)
سورة النمل	蟻 (クルアーン)
سورة القصص	物語 (クルアーン)
سورة العنکبوت	蜘蛛 (クルアーン)
سورة الروم	ビザンチン (クルアーン)
De Havilland Mosquito	デ・ハビランド モスキート
کيشپ	カメ
شکودا اوکټاويا	シュコダ・オクタビア
سټېنگر FIM-92	スティンガーミサイル
سورة لقمان	ルクマーン (クルアーン)
دماغي مړينه	脳死
مخ (چاپي رسنۍ)	ページ
د وټيزو همکاريو سازمان	経済協力機構
هېوادپال	パトリオット
شوننېزم	排外主義
امريکا غږ	ボイス・オブ・アメリカ
درې بعدي چاپگر	3Dプリンター
سورة السجدة	アッ・サジダ (クルアーン)
سورة الاحزاب	部族連合 (クルアーン)
سورة سبأ	サバア (クルアーン)
سورة فاطر	創造者 (クルアーン)
سورة يس	ヤー・スィーン (クルアーン)
مامولکه	セキレイ
سورة الصافات	整列者 (クルアーン)
سورة ص	サード (クルアーン)
سورة الزمر	集団 (クルアーン)
سورة غافر	ガーフィル (クルアーン)
حسن البنا	ハサン・アル＝バンナー
سورة فصلت	フッスィラ (クルアーン)
سورة الشورى	相談 (クルアーン)
سورة الزخرف	金の装飾 (クルアーン)
سورة الدخان	煙霧 (クルアーン)
سورة الجاثية	跪く時 (クルアーン)
سورة الأحقاف	砂丘 (クルアーン)
سورة محمد	ムハンマド (クルアーン)
سورة الفتح	勝利 (クルアーン)
سورة الحجرات	部屋 (クルアーン)
سورة ق	カーフ (クルアーン)
سورة الذاريات	撒き散らすもの (クルアーン)
ډېل کارنېگي	デール・カーネギー
سورة الطور	山 (クルアーン)
سورة النجم	星 (クルアーン)
روح الله نېکپا	ロフラ・ニクパイ
سورة القمر	月 (クルアーン)
سورة الرحمن	慈悲あまねく御方 (クルアーン)
سورة الواقعة	出来事 (クルアーン)
سورة الحديد	鉄 (クルアーン)
سورة المجادلة	抗弁する女 (クルアーン)
سورة الحشر	集合 (クルアーン)
سورة الممتحنة	試問される女 (クルアーン)
سورة الجمعة	合同礼拝 (クルアーン)
سورة المنافقون	偽信者たち (クルアーン)
سورة التغابن	騙し合い (クルアーン)
سورة الطلاق	離婚 (クルアーン)
سورة الملک	大権 (クルアーン)
سورة القلم	筆 (クルアーン)
سورة الحاقة	真実 (クルアーン)
سورة المعارج	階段 (クルアーン)
مېتی	つるはし
سورة نوح	ヌーフ (クルアーン)
سورة الجن	幽精 (クルアーン)
سورة المزمل	衣を纏う者 (クルアーン)
سورة المدثر	包る者 (クルアーン)
سورة القيامة	復活 (クルアーン)
سورة الإنسان	人間 (クルアーン)
سورة المرسلات	送られるもの (クルアーン)
سورة النبأ	消息 (クルアーン)
سورة النازعات	引き離すもの (クルアーン)
سورة عبس	眉をひそめて (クルアーン)
سورة التكوير	包み隠す (クルアーン)
سورة الانفطار	裂ける (クルアーン)
سورة المطففين	量を減らす者 (クルアーン)
سورة الانشقاق	割れる (クルアーン)
سورة البروج	星座 (クルアーン)
سورة الطارق	夜訪れるもの (クルアーン)
سورة الأعلى	至高者 (クルアーン)
سورة الغاشية	圧倒的事態 (クルアーン)
سورة الفجر	暁 (クルアーン)
سورة البلد	町 (クルアーン)
سورة الشمس	太陽 (クルアーン)
سورة الليل	夜 (クルアーン)
سورة الضحى	朝 (クルアーン)
سورة الشرح	胸を広げる (クルアーン)
د ماغزو تومور	脳腫瘍
سورة التين	無花果 (クルアーン)
د پاني پت دوهمه جگړه	第二次パーニーパットの戦い
سورة العلق	凝血 (クルアーン)
سورة القدر	みいつ (クルアーン)
سورة البينة	明証 (クルアーン)
سورة الزلزلة	地震 (クルアーン)
سورة العاديات	進撃する馬 (クルアーン)
سار	ニシオオノスリ
سورة القارعة	恐れ戦く (クルアーン)
سورة التکاثر	蓄積 (クルアーン)
سورة العصر	時間 (クルアーン)
سورة الهمزة	中傷者 (クルアーン)
سورة الفيل	象 (クルアーン)
سورة قريش	クライシュ族 (クルアーン)
سورة الماعون	慈善 (クルアーン)
سورة الکوثر	潤沢 (クルアーン)
سورة الکافرون	不信者たち (クルアーン)
سورة النصر	援助 (クルアーン)
مکه معظمه	マッカ州
سورة المسد	棕櫚 (クルアーン)
سورة الإخلاص	純正 (クルアーン)
سورة الفلق	黎明 (クルアーン)
سپين توت	ヤエヤマアオキ
سورة الناس	人々 (クルアーン)
سورت	スーラ (クルアーン)
د هند کمونیست گوند (مارکسیست)	インド共産党マルクス主義派
مکي سورتونه	マッカ啓示
حديث	ハディース
شاپور ۲	シャープール2世
حج	ハッジ
سورة الصف	戦列 (クルアーン)
سورة التحريم	禁止 (クルアーン)
ټې-۸۰	T-80
امام بخاري	ムハンマド・アル＝ブハーリー
ميل مي - ۲۸	Mi-28 (航空機)
مخطت	ハイライト
ديکلوفيناک	ジクロフェナク
سوخوی سو ۳۵	Su-35 (航空機・初代)
پيچکاري	注射
د غزنويانو ټولواکمني	ガズナ朝
ابن طفيل	イブン・トファイル
فيفا	国際サッカー連盟
ليلا علي	レイラ・アリ
بېنزيل پېنيسيلين	ベンジルペニシリン
۳۹×۷،۶۲ مرمی	7.62x39mm弾
ږدن	雑穀
حاد مايلوييد ليوکېمي	急性骨髄性白血病
حاد کرونري ساينډروم	急性冠症候群
د کارلشتین کلا	カルルシュテイン城
پلسيوسور	首長竜
کاموف کا ٥٠	Ka-50 (航空機)
گڼ پوهيال	博学者
د سپاه پاسداران انقلاب اسلامی ځواک	イスラム革命防衛隊
آنتونوف-۱۲	An-12 (航空機)
نوشاخ	ノシャック
خبري غونډه	記者会見
ايليوشين-۹۶	Il-96 (航空機)
خټگري	組積造
کلورامفينيکول	クロラムフェニコール
انټر سرويس انټېلېجنس (ISI)	軍統合情報局
د چېک پوځ	チェコ共和国の軍事
اېسټروجن	エストロゲン
HACCP	HACCP
مچواژی	蠅叩き
غزل	ガザル
مېگانېورا	メガネウラ
محمد اسماعيل خان	イスマーイール・ハーン
د پاکستان د انصاف غورځنگ	パキスタン正義運動
شهنواز تڼی	シャフナワーズ・タナイ
د ډيورنډ کرښه	デュアランド・ライン
يعقوب	ヤコブ (旧約聖書)
لارا دتا	ララ・ダッタ
الجاحظ	ジャーヒズ
سيد جمال الدين افغاني	ジャマールッディーン・アフガーニー
نصرت فتح علي خان	ヌスラト・ファテー・アリー・ハーン
نور محمد ترکی	ヌール・ムハンマド・タラキー
سادات	サイイド
د راديوايزوټوپونو ترموبريښنایی جنريټر	放射性同位体熱電気転換器
آلانين ټرانس امينېز	アラニンアミノ基転移酵素
ختيځه فلسفه	東洋哲学
عبدالقادر گيلاني	アブド・アルカーディル・アルジーラーニー
عبدالله عزام	アブドゥッラー・アッザーム
لور	娘
الشباب	アル・シャバブ (ソマリア)
سردار محمد داود خان	ムハンマド・ダーウード
عبدالقدير خان	アブドゥル・カディール・カーン
سلطان قطب الدين ايبک	クトゥブッディーン・アイバク
بيټالکټمېز	Β-ラクタマーゼ
نورالدين عبدالرحمن جامي هروي	ジャーミー
رودکي	ルーダキー
عبدالرحيم وردگ	アブドゥッラヒム・ワルダク
عبدالله عبدالله	アブドラ・アブドラ
عبدالله يکتا	アブドゥッラー・ヤフタリ
جرمېن جېکسن	ジャーメイン・ジャクソン
ابن حزم اندلسي	イブン・ハズム
والېري ولاديميروويچ پولياکوف	ワレリー・ポリャコフ
گلبدين حکمتيار	グルブッディーン・ヘクマティヤール
احمد شاه قاجار	アフマド・シャー (ガージャール朝)
مېلبورن پوهنتون	メルボルン大学
داسو میراژ اف‌۱	ミラージュF1 (戦闘機)
آر پي جي-۷	RPG-7
آغا محمد خان قاجار	アーガー・モハンマド・シャー
گڼونکی	会計士
د ۲ کا ۱۲ کوب راکټی سیستم	2K12
کنکه لېږندويه انسېفلايټس	ダニ媒介性脳炎
د افغانستان جگړه (۲۰۰۱)	不朽の自由作戦
قانوني لاسوندونه	法律行為
ويي جوړښت	造語法
تايروکسين	トリヨードサイロニン
د سولې نړيواله ورځ	国際平和デー
روماتولوجي	リウマチ学
ناصر خسرو	ナースィル・ホスロー
شپې ليد سترگۍ	暗視装置
عبدالرشيد دوستم	ラシッド・ドスタム
کريم خان زند	カリーム・ハーン
رنجيت سېنگ	ランジート・シング
اپورتونېزم	日和見主義
امير حبيب الله خان	ハビーブッラー・ハーン
کمال الدين بهزاد	ビフザード
بيت الله محسود	バイトゥッラー・マフスード
ابوبکر	アブー・バクル
ابو مسلم خراساني	アブー・ムスリム
جيورج ايډېن	ジョージ・イーデン (初代オークランド伯爵)
سلطان علاوالدين غلجی	アラー・ウッディーン・ハルジー
کاشي	釉薬
گوگل	縦隔
راجپوت	ラージプート
آیت الله سيستاني	アリー・スィースターニー
محمد علي شاه قاجار	モハンマド・アリー・シャー
فرانسېس يسېدرو اېجورت	フランシス・イシドロ・エッジワース
محمد نادر شاه	ムハンマド・ナーディル・シャー
آنتونوف-۱۴۰	An-140 (航空機)
سلمان ابن عبدالعزیز آل سعود	サルマーン・ビン・アブドゥルアズィーズ
سليووويټز	スリヴォヴィッツ
اردشیر پاپاکان	アルダシール1世
هېماټويوريا	血尿
د سوریانو ټولواکمني	スール朝
جده	ジッダ
د چين نړيواله راډيو	中国国際放送
الېکسانډر برنېس	アレクサンダー・バーンズ
هندي فلسفه	インド哲学
د ايران هوايي ځواک	イラン空軍
لوييس سلوتين	ルイス・スローティン
صبغت الله مجددي	シブガトゥッラー・ムジャッディディー
آر کیو - ۱۱ ړاوېن	RQ-11 レイヴン
ولاديمير الېکساندروويچ کريوچکوف	ウラジーミル・クリュチコフ
لمن لگښت	限界費用
د افغانستان د فوټبال فدراسيون	アフガニスタンサッカー連盟
کارلوی واری	カルロヴィ・ヴァリ
د هخامنشیانو ټولواکمني	アケメネス朝
شکودا سوپرب	シュコダ・スペルブ
معیاري ژبه	標準語
احمد شاه احمدزی	アフマド・シャー・アフマドザイ
سايکلوفوسفمايډ	シクロホスファミド
ایندومټاسین	インドメタシン
هېکزامېتيلين ټرايپرآکسيډايامين	ヘキサメチレントリペルオキシドジアミン
ټي اېي ټي بي	トリアミノトリニトロベンゼン
اېنالاپريل	エナラプリル
سپيرونولکټون	スピロノラクトン
مېبېندازول	メベンダゾール
هېموسېدرين	ヘモジデリン
اوکټوجن	シクロテトラメチレンテトラニトラミン
اوميپرازول	オメプラゾール
بودېسونايد	ブデソニド
ديجوکسين	ジゴキシン
ډيلټيازيم	ジルチアゼム
مېټوټرکسات	メトトレキサート
دوكسيسايكلين	ドキシサイクリン
جنټامايسين	ゲンタマイシン
لاميووډين	ラミブジン
رانيتيدين	ラニチジン
وانکومايسين	バンコマイシン
سالمېټېرول	サルメテロール
یوریا نايټريټ	硝酸尿素
الاقصی جومات	アル＝アクサー・モスク
انډيناوير	インジナビル
مسجد الحرام	マスジド・ハラーム
الخالد شوبله	90-II式戦車
منبر	ミンバル
ولادېمير افاناسېويچ لياخوف	ウラジーミル・リャホフ
اسلامي بانکوالی	イスラム銀行
شاه شجاع	シュジャー・シャー
سوخوی سو ٣٧	Su-37 (航空機)
ملکه رضيه	ラズィーヤ
شبانه اعظمي	シャバーナー・アーズミー
ديا مرزا	ディア・ミルザ
آلماني چابکۍ	チャバネゴキブリ
غياث الدين کيخسرو بن کيقباد	カイホスロー2世
مظفر الدين شاه قاجار	モザッファロッディーン・シャー
جهان آرا بېگم	ジャハーナーラー・ベーグム
د درانيانو ټولواکمني	ドゥッラーニー朝
ملټيپل ميولوما	多発性骨髄腫
بوينگ بي ۴۷ سټراټوجېټ	B-47 (航空機)
امير عنايت الله خان	イナーヤトゥッラー・シャー
لښکرگاه	ラシュカルガー
دوشکا (د الوتکو ويشتونکي ماشيندار)	DShK38重機関銃
شريعت	シャリーア
اوزبکان	ウズベク
ازمېښتون	研究室
جيروسكوپ	ジャイロスコープ
تاجکيان	タジク人
سني اسلام	スンナ派
آزربايجاني منات	アゼルバイジャン・マナト
بې پيلوټه الوتکه	無人航空機
محمد اقبال	ムハンマド・イクバール
فقه	イスラム法学
چنگېز ايتمانوف	チンギス・アイトマートフ
مۍ	リョクトウ
د باميانو بودايي پژۍ	バーミヤン渓谷の文化的景観と古代遺跡群
تورکمنان	トルクメン人
نړیوال سازمان	国際機関
د ژبې فلسفه	言語哲学
شانگهای د همکاريو سازمان	上海協力機構
کلبيان	キュニコス派
د آزادۍ راډيو	ラジオ・フリー・ヨーロッパ
اورنگزیب عالمگیر	アウラングゼーブ
راني موکېرجي	ラーニー・ムカルジー
مسجد نبوي	預言者のモスク
اسلاموفوبيا	イスラム恐怖症
ازبکستاني سوم	スム
صفره	サファル
ابن تيميه	イブン・タイミーヤ
د سجیل توغندی	セッジール
ماتريديه	マートゥリーディー派
بولندوی	中佐
مېټامتريال	メタマテリアル
الوتکه (فلم)	フライング・ハイ
د شاه فیصل جومات	ファイサル・モスク
نېفروټېک ساينډروم	ネフローゼ症候群
انځور خبريالي	報道写真
د افغانستان د لارښودانو لړليک	アフガニスタンの国家元首の一覧
نخاعي شريان	椎骨動脈
تومانچه مادل ۵۲	Cz52
د الماني ژبې گرامر	ドイツ語の文法
ISO 22000	ISO 22000
ټريپانوسوما	トリパノソーマ
عبدالرب رسول سياف	アブドゥル・ラスル・サイヤフ
څاڅکي	目薬
محمد شاه قاجار	モハンマド・シャー
محمد عالم خان	アーリム・ハーン
شاه اشرف هوتک	アシュラーフ (サファヴィー朝)
پروټينيوريا	タンパク尿
ماگيون	マギオン
رضوي خراسان ولايت	ラザヴィー・ホラーサーン州
بفر سټېټ	緩衝国
کونډه	カラビナ
تومانچه مادل ٧٥	Cz75
سپين بولدک	スピンボルダック
څارنوال	検察官
ټرانس امينېشن	アミノ基転移
گلومېرولونېفرايټس	糸球体腎炎
د پاني پت لومړۍ جگړه	第一次パーニーパットの戦い
بوکان	ブーカーン
آنتونوف-۱۴۸	An-148 (航空機)
ابهيدا	阿毘達磨
ټوپولف ټو-۳۳۴	Tu-334 (航空機)
ډئيزم	理神論
دگماتېزم	教義
برېښنامېچ	電力量計
ښځه په اسلام کې	イスラームと女性
ملي گټې	国益
عبدالحق	アブドル・ハク
د تودوخې د لېږد وړتیا	熱伝達率
کتيتر	カテーテル
آريانا افغان هوايي شرکت	アリアナ・アフガン航空
شهاب ۳	シャハブ3 (ミサイル)
اسحاق	イサク
زو – ۲۳ – ۲	ZU-23-2
د بون تړون	ボン合意
اېف ۱ لاسي بم	F1手榴弾
د اسيايي هېوادونو لړليک	アジアの主権国家及び属領の一覧
اسد الله سروري	アサドゥッラー・サルワリ
درملپېژندنه	薬力学
ريگويدا	リグ・ヴェーダ
طيبه لښکر	ラシュカレトイバ
نورستانيان	ヌーリスターン人
د غشی زهر آبي چونگښه	コバルトヤドクガエル
جي اېف ۱۷ تهنډر	FC-1 (航空機)
حامد کرزی نړيوال هوايي ډگر	カーブル国際空港
وزلوبه	ブズカシ
تپندۍ	金ごて
هېلېنيستي فلسفه	ヘレニズム哲学
تور-ام۱	9K330
عطا محمد نور	アタ・モハマド・ヌール
بوټځمکپوهنه	植生地理学
لېیوروس قوینقوېستریاتوس	オブトサソリ
ملتون	会社
اسلامي ساينس	イスラム科学
ظهير الدين محمد بابر	バーブル
پاکستان مسلم لیگ ن	パキスタン・ムスリム連盟ナワーズ・シャリーフ派
درېيځ (مېچپوهنه)	正六面体
آتريال فېبرېلېشن	心房細動
هډپوهنه	骨学
مسلکونه	作業
ارواپالنه	心霊主義
ماشيندار مادل ٦١	Vz 61
جنت	天国 (イスラーム)
فيزيکي کتنه	診察
يهودي فلسفه	ユダヤ哲学
اومان	マオウ属
ټاټرا ټې – ۳	タトラT3
لوېديځه فلسفه	西洋哲学
لويه جرگه	ロヤ・ジルガ
رقم جوړؤنکي وسایل	デジタイズ
2G	第2世代移動通信システム
آئیسو 639-3	ISO 639-3
د زړه عضلاتي اعتلال	心筋症
نيوروفېبروماټوسېز	神経線維腫症
ټوپک مادل ٥٨	Vz 58
کومييز سرطان	喉頭癌
پېرودونکی	顧客
د استخباراتو امنيتي اداره	チェコ保安・情報庁
عيسوي فلسفه	キリスト教哲学
دوه څنډی	二角形
د سږو بوغمه	肺水腫
آی خانم	アイ・ハヌム
معاصره فلسفه	近世哲学
د ناروغيو لړليک	病気の別名の一覧
يوناني درمل	本草学
د مهدي پوځ	マフディー軍
پاکستان مسلم لیگ ق	パキスタン・ムスリム連盟カーイデ・アーザム派
بسم الله خان محمدي	ビスミッラー・ハーン・モハンマディ
ليکتوکي	文房具
د اکولا اوبتل	アクラ型原子力潜水艦
د بازار جوړښت	市場構造
سمونتيا	革新
ډانا مادل ۷۷ لیري ویشتونکي توپ	ダナ 152mm自走榴弾砲
د رېږدلې انجنيري	耐震
ماليکولي ننوونی	分子篩
سجده	サジダ
اسلامي وييپانگه	イスラーム用語一覧
د سيستان او بلوچستان ولايت	スィースターン・バルーチェスターン州
محمد اسلم وطنجار	モハマッド・アスラム・ワタンジャル
سلطان علي کشتمند	スルタン・アリー・ケシュトマンド
سردار نصرالله خان	ナスルッラー・ハーン
ډانا ټايرون روهراباکر	ダナ・ローラバッカー
لرغونې يوناني فلسفه	ギリシア哲学
بودايي فلسفه	仏教哲学
يشناټکی	沸点
د فارس ولايت	ファールス州
د نړۍ برحاله هېوادمشران	世界各国の指導者一覧
هالي بېري	ハル・ベリー
غبرگه ښیښه	複層ガラス
1G	第1世代移動通信システム
د روسيې دولتي کتابتون	ロシア国立図書館 (モスクワ)
د بوټي ژونکه	植物細胞
د استخباراتو پرانيستى سرچينه	オープン・ソース・インテリジェンス
اږبکه	ムラサキツバメ (鳥)
چوهان	チャーハマーナ朝
اسيا پېسفيک	アジア太平洋
يوڅنډی	一角形
د لوگر ولايت د بيارغونې ډله	地方復興チーム
لادا اوبتل	ラーダ型潜水艦
پېښور	ペシャーワル
آر پي جي – ۲۹	RPG-29
څېړنيزه خبريالي	調査報道
زهوب	滲出
حدود	ハッド刑
خروشتي	カローシュティー文字
خدايگوټی	ヤザタ
اپولینارېزم	アポリナリオス主義
د بابر توغندی	バーブル (ミサイル)
دوتنه	ファイル
لافايټ جنگي بېړۍ	ラファイエット級フリゲート
بانکي کارټ	キャッシュカード
گڼيه	住宅ローン
ناپروکسين	ナプロキセン
شکوڼ	ヤマアラシ
نوی اتلانتېس	ニュー・アトランティス
تعبیه شوی چاودیدونکی وسیله	即席爆発装置
د پاني پت دريمه جگړه	第三次パーニーパットの戦い
سولگریز جال	コンピュータネットワーク
د حکومت بڼې	政治体制
پر اسلام نيوکه	反イスラーム主義
اسلامي هڅوب	イスラーム文化
اسلامي وټه	イスラム経済
کابل پوهنتون	カーブル大学
موسکيټ	P-270 (ミサイル)
د کاربن ډای اکسایډ ليزر	炭酸ガスレーザー
د اصفهان ولايت	エスファハーン州
ويکيپېډيا:وييپانگه	Wikipedia:ウィキペディア用語集
فضل حق خالقيار	ファズルリハク・ハレキヤル
محمد موسى شفيق	モハマッド・ムサ・シャフィク
وېشنيزه:د امريکا متحده ايالات	Category:アメリカ合衆国
وېشنيزه:روسيه	Category:ロシア
وېشنيزه:کاناډا	Category:カナダ
وېشنيزه:برطانيه	Category:イギリス
وېشنيزه:چين	Category:中国
وېشنيزه:هندوستان	Category:インド
وېشنيزه:سعودي عربستان	Category:サウジアラビア
وېشنيزه:ايران	Category:イラン
پښتونولي	パシュトゥーンワーリ
هانډلې پېج ټايپ او	ハンドレページ O/400
لامبوځنه ښیښه	フロートガラス
ابدالي	ドゥッラーニー部族連合
وېشنيزه:افغانستان	Category:アフガニスタン
وېشنيزه:الجېريا	Category:アルジェリア
ام – ۵۳/۵۹	M53/59プラガ
وېشنيزه:عراق	Category:イラク
وېشنيزه:نېدرلانډ/هالېنډ	Category:オランダ
وېشنيزه:نايجېريا	Category:ナイジェリア
وېشنيزه:پاکستان	Category:パキスタン
وېشنيزه:د روم امپراطوری	Category:ローマ帝国
وېشنيزه:مارغان	Category:鳥類
وېشنيزه:بوټي	Category:植物
وېشنيزه:ژونپوهنه	Category:生物学
وېشنيزه:پېښليک	Category:歴史
وېشنيزه:ځمکپوهنه	Category:地理
وېشنيزه:ټولنه	Category:社会
وېشنيزه:مذهب	Category:宗教
وېشنيزه:ورزښت	Category:スポーツ
وېشنيزه:اروپايي اتحاديه	Category:欧州連合
وېشنيزه:ټوليزې رسنۍ	Category:マスメディア
وېشنيزه:ژبه	Category:言語
وېشنيزه:ځمکه	Category:地球
مړاپ زره پوښ گاډي	MRAP
ټېمېلين اټومي برېښناکوټ	テメリン原子力発電所
خواږه مرچ	ピーマン
گوند مشر	党首
چاودونکي شکل لرونکي مردک	自己鍛造弾
شهاب الدين محمد غوري	シハーブッディーン・ムハンマド
سهيلا صديقي	ソヘイラ・スィッディーキー
اورمکۍ	ガ
کينډۍ:/بکس-پايليک	Template:Box-footer
ملهم	バルサム
کاربون نانو نل	カーボンナノチューブ
د ۰۵۲ بي جنگي بېړۍ	広州級駆逐艦
خبريال	ジャーナリスト
مضاربت	ムダーラバ
د حسن او حسين مياشت	ムハッラム
وېشنيزه:فلسفه	Category:哲学
وېشنيزه:عيسويت	Category:キリスト教
وېشنيزه:اسلام	Category:イスラム教
وېشنيزه:يهوديت	Category:ユダヤ教
پارت	パルティア
جزء	ジュズウ
ويکيپېډيا:د پټنتيا تګلاره	プライバシーポリシー
تاکتيک	戦術
ملا صدرا	モッラー・サドラー
خمس	フムス (イスラーム)
رهبانيت	修道会
هنسېکا موټواني	ハンシカ・モトワニ
گوربت	鷲
سلطان معزالدين کيقباد	ムイズッディーン・カイクバード
اسلام شاه سوري	イスラーム・シャー
اسلام او عيسويت	キリスト教とイスラム教
ساتنه	保護
وړانگه	レイ
بکتر شکن	HJ-8 (ミサイル)
بوښوتنيکا	ボホトニツァ
اناپلازموسېز	アナプラズマ病
تولید (سوداگري)	商品
د عراق او شام اسلامي دولت	ISIL
يونس	ヨナ
د فيلسوفانو لړليک	思想家一覧
ویدانتا	ヴェーダーンタ学派
د کيميا فلسفه	化学の哲学
پښتانه	パシュトゥーン人
رانا سنگا	サングラーム・シング
پانډور زره پوښ موټر	パンデュールII
تخنيک	技術
سيير بهادرزاده	シアー・バハドゥルザダ
چامبېلي	ソケイ
مهرانا پراتاپ	プラタープ・シング (メーワール王)
بهلول لودي	バフルール・ローディー
نكاح	ムスリムと非ムスリムとの婚姻
سمبالښت	経営管理論
ننداره	ショー
وېشنيزه:هڅوب	Category:文化
وېشنيزه:لويې وچې	Category:大陸
وېشنيزه:ځمکپېژنده	Category:地質学
وېشنيزه:الوتکې	Category:航空機
ايشوبی	ボイラー
انوارالحق احدي	アンワル・ウル＝ハク・アハディ
تانبه:ځمکپوهنه	Portal:地理学
د مليت له پلوه د خلکو لړليک	出身別の人名記事一覧の一覧
د جاينيزم فلسفه	ジャイナ哲学
تانبه:فلسفه	Portal:哲学
د کوکا کولا شرکت	ザ コカ・コーラ カンパニー
ويکيپېډيا:غونډال ته څنګه ورننوځو	Help:ログイン
پير سيد احمد گيلاني	サイード・アフマド・ギラニ
کيمياوي وسلې	化学兵器
کلمپ	クランプ
وېشنيزه:د پوهنغونډ روباټان	Category:Wikipedia bots
وېشنيزه:د افغانستان توکمونه	Category:アフガニスタンの民族
تانبه:ټولنه	Portal:メディア
څلوريځ	二行連
غياث الدين غوري	ギヤースッディーン・ムハンマド
تانبه:هنرونه	Portal:美術
محمد حنيف اتمر	ムハンマド・ハニーフ・アトマル
عبدالستار سيرت	アブドゥル・サタール・シラート
کينډۍ:دوراشې کامه	Template:Quote
د وينې رېفرانسي حدود	血液検査の参考基準値
ويکيپېډيا:د نن ورځې انځور	Wikipedia:秀逸な画像の推薦
وېشنيزه:هېوادونه	Category:国
وېشنيزه:وټپوهنه	Category:経済学
ويکيپېډيا:پازوالان	Wikipedia:管理者
ويکيپېډيا:روباټان	Wikipedia:Bot
وېشنيزه:وخت	Category:時間
وېشنيزه:انټرنټ	Category:インターネット
وېشنيزه:پیسې	Category:貨幣
وېشنيزه:بوټپوهنه	Category:植物学
وېشنيزه:اناتومي	Category:解剖学
وېشنيزه:طب	Category:医学
وېشنيزه:سياست	Category:政治
گڼنه	会計
مصر	エジプト
اسلامي نظام	イスラム国家
وېشنيزه:فيلسوفان	Category:哲学者
کينډۍ:Bot	Template:Bot
خپگان	抑うつ
کاناډا	カナダ
وېشنيزه:هنګري	Category:ハンガリー
وېشنيزه:د اروپایي اتحادیې غړي هیوادونه	Category:欧州連合加盟国
وېشنيزه:چېک جمهوريت	Category:チェコ
وېشنيزه:سلواکيا	Category:スロバキア
غلام فاروق يعقوبي	グラム・ファルク・ヤクビ
وېشنيزه:مايکروسافټ	Category:マイクロソフト
تانبه:پوهنه	Portal:自然科学
کينډۍ:Flagicon	Template:Flagicon
وېشنيزه:د اروپا هېوادونه	Category:ヨーロッパの国
وېشنيزه:اروپا	Category:ヨーロッパ
تانبه:تازه پېښې	Portal:最近の出来事
کينډۍ:لاسوند	Template:Documentation
ويکيپېډيا:د ټولنې تانبه	Wikipedia:コミュニティ・ポータル
وېشنيزه:User languages	Category:言語別の利用者
ويکيپېډيا:کارن-نوم	Wikipedia:利用者名
عبدالجبار ثابت	アブドゥル・ジャバル・サビト
عايشه بنت ابي بکر	アーイシャ・ビント・アブー・バクル
سوداگري	企業
کينډۍ:Softredirect	Template:Softredirect
کينډۍ:ړنگول	Template:即時削除
وېشنيزه:ژبې	Category:諸言語
ويکيپېډيا:General disclaimer	Wikipedia:免責事項
وېشنيزه:د چېک جمهوريت ښارونه	Category:チェコの都市
کينډۍ:Navbox	Template:Navbox
ويکيپېډيا:Shortcut	Template:ショートカット
وېشنيزه:د ایران ښارونه	Category:イランの都市
خيميران	ギンザメ目
کينډۍ:Citation needed	Template:要出典
تانبه:ژوندليکونه	Portal:人物伝
کينډۍ:!	Template:!
کينډۍ:Tnavbar	Template:Tnavbar
ايمان	信仰
کينډۍ:Clear	Template:Clear
کينډۍ:Col-begin	Template:Col-begin
کينډۍ:Col-end	Template:Col-end
کينډۍ:Anchor	Template:Anchors
کينډۍ:Babel	Template:Babel
کينډۍ:Commons	Template:Commons
کينډۍ:لړسرچينې	Template:Reflist
کينډۍ:AFG	Template:AFG
کينډۍ:نابشپړ	Template:Stub
کينډۍ:User de	Template:User de
کينډۍ:User en-3	Template:User en-3
کينډۍ:User en-1	Template:User en-1
کينډۍ:User en-2	Template:User en-2
کينډۍ:User en	Template:User en
کينډۍ:User fa	Template:User fa
وېشنيزه:افغاني هڅوب	Category:アフガニスタンの文化
کينډۍ:User ja	Template:User ja
کينډۍ:User ja-1	Template:User ja-1
وېشنيزه:امريکايي لرغونپوهان	Category:アメリカ合衆国の考古学者
کينډۍ:د هېواد مالومات تاجکستان	Template:Country data Tajikistan
وېشنيزه:آسيا	Category:アジア
کينډۍ:Esoteric	Template:複雑なテンプレート
کينډۍ:د هېواد مالومات کویټ	Template:Country data Kuwait
کينډۍ:Mod	Template:Mod
کينډۍ:ISO639-3Documentation	Template:Infobox Language/codelist
کينډۍ:د هېواد مالومات بلجيم	Template:Country data Belgium
کينډۍ:د هېواد مالومات سلواکيا	Template:Country data Slovakia
کينډۍ:د هېواد مالومات اېل سلوادور	Template:Country data El Salvador
کينډۍ:د هېواد مالومات پاناما	Template:Country data Panama
کينډۍ:د هېواد مالومات اېکوادور	Template:Country data Ecuador
کينډۍ:د هېواد مالومات اېتوپيا	Template:Country data Ethiopia
کينډۍ:د هېواد مالومات تونېسيا	Template:Country data Tunisia
کينډۍ:د هېواد مالومات د چېک جمهوريت	Template:Country data Czech Republic
کينډۍ:د هېواد مالومات تايلنډ	Template:Country data Thailand
کينډۍ:د هېواد مالومات کيوبا	Template:Country data Cuba
کينډۍ:د هېواد مالومات اندونېزيا	Template:Country data Indonesia
کينډۍ:د هېواد مالومات کمبوډيا	Template:Country data Cambodia
کينډۍ:د هېواد مالومات سېنېگال	Template:Country data Senegal
کينډۍ:د هېواد مالومات ماداګاسکر	Template:Country data Madagascar
کينډۍ:د هېواد مالومات البانيا	Template:Country data Albania
وېشنيزه:درملپوهنه	Category:薬理学
کينډۍ:د هېواد مالومات پېرو	Template:Country data Peru
کينډۍ:د هېواد مالومات پاراګوای	Template:Country data Paraguay
کينډۍ:د هېواد مالومات کېنيا	Template:Country data Kenya
کينډۍ:د هېواد مالومات نيکاراګوا	Template:Country data Nicaragua
کينډۍ:د هېواد مالومات هندوراس	Template:Country data Honduras
کينډۍ:د هېواد مالومات ازبکستان	Template:Country data Uzbekistan
کينډۍ:د هېواد مالومات بولېويا	Template:Country data Bolivia
کينډۍ:د هېواد مالومات د ډومينيکان جمهوريت	Template:Country data Dominican Republic
کينډۍ:د هېواد مالومات توگو	Template:Country data Togo
کينډۍ:د هېواد مالومات ګواتمالا	Template:Country data Guatemala
وېشنيزه:ژبپوهنه	Category:言語学
کينډۍ:د هېواد مالومات هايېتي	Template:Country data Haiti
کينډۍ:د هېواد مالومات مالي	Template:Country data Mali
کينډۍ:د هېواد مالومات مولدووا	Template:Country data Moldova
کينډۍ:د هېواد مالومات لاتويا	Template:Country data Latvia
کينډۍ:د هېواد مالومات مالټا	Template:Country data Malta
کينډۍ:د هېواد مالومات ډېنمارک	Template:Country data Denmark
کينډۍ:د هېواد مالومات آيسلېنډ	Template:Country data Iceland
کينډۍ:د هېواد مالومات پولنډ	Template:Country data Poland
کينډۍ:د هېواد مالومات کېپ وردا	Template:Country data Cape Verde
کينډۍ:Click	Template:Click
کينډۍ:د هېواد مالومات بلغاريه	Template:Country data Bulgaria
کينډۍ:د هېواد مالومات بوسنيا او هېرزگوينا	Template:Country data Bosnia and Herzegovina
کينډۍ:د هېواد مالومات ګايانا	Template:Country data Guyana
کينډۍ:Wikivar	Template:Wikivar2
کينډۍ:د هېواد مالومات ناروې	Template:Country data Norway
کينډۍ:د هېواد مالومات سوېلي افريقا	Template:Country data South Africa
کينډۍ:د هېواد مالومات جمايکا	Template:Country data Jamaica
کينډۍ:د هېواد مالومات ګورجستان	Template:Country data Georgia
کينډۍ:د هېواد مالومات ارجنټاين	Template:Country data Argentina
کينډۍ:د هېواد مالومات يوروګوای	Template:Country data Uruguay
کينډۍ:Country showdata	Template:Country showdata
کينډۍ:د هېواد مالومات ټرېنېډاډ او توباګو	Template:Country data Trinidad and Tobago
کينډۍ:د انځور نښه	Template:Image label
کينډۍ:د هېواد مالومات برونای	Template:Country data Brunei
کينډۍ:د هېواد مالومات سريلانکا	Template:Country data Sri Lanka
کينډۍ:د هېواد مالومات مکسيکو	Template:Country data Mexico
کينډۍ:د هېواد مالومات یونان	Template:Country data Greece
کينډۍ:د هېواد مالومات لوکسېمبورگ	Template:Country data Luxembourg
کينډۍ:د هېواد مالومات سعودي عربستان	Template:Country data Saudi Arabia
کينډۍ:د هېواد مالومات بهاماس	Template:Country data Bahamas
کينډۍ:د هېواد مالومات کرواتيا	Template:Country data Croatia
کينډۍ:د هېواد مالومات عراق	Template:Country data Iraq
کينډۍ:ليکوال-مالوماتبکس/لاسوند	Template:Infobox 作家
کينډۍ:د هېواد مالومات متحده عرب امارات	Template:Country data United Arab Emirates
کينډۍ:د هېواد مالومات ماروکو	Template:Country data Morocco
کينډۍ:د هېواد مالومات سربيا	Template:Country data Serbia
کينډۍ:د هېواد مالومات آسټراليا	Template:Country data Australia
کينډۍ:د هېواد مالومات فرانسه	Template:Country data France
کينډۍ:Ambox	Template:Ambox
کينډۍ:DorlandsDict	Template:DorlandsDict
کينډۍ:دکارنبکس-بېخ	Template:Boxboxbottom
کينډۍ:هېواد-مالوماتبکس	Template:基礎情報 国
کينډۍ:د هېواد مالومات لاووس	Template:Country data Laos
کينډۍ:د هېواد مالومات اتريش	Template:Country data Austria
کينډۍ:د فلسفې څنگپټه	Template:哲学のサイドバー
کينډۍ:د هېواد مالومات نيپال	Template:Country data Nepal
کينډۍ:ترسره شو	Template:済
کينډۍ:لاسوند/دلاسوندنوم	Template:Documentation/docname
کينډۍ:د هېواد مالومات فېنلاند	Template:Country data Finland
کينډۍ:Audio	Template:Audio
کينډۍ:د هېواد مالومات مصر	Template:Country data Egypt
کينډۍ:د هېواد مالومات لېتوانيا	Template:Country data Lithuania
ويکيپېډيا:ځان زده کړه (د ويکيپېډيا تړنې)	Wikipedia:チュートリアル リンク
کينډۍ:د هېواد مالومات جاپان	Template:Country data Japan
کينډۍ:د هېواد مالومات نېدرلنډ	Template:Country data Netherlands
کينډۍ:Start box	Template:S-start
کينډۍ:ساينسپوه-مالوماتبکس	Template:Infobox Scientist
کينډۍ:پوهنتون مالوماتبکس/لاسوند	Template:Infobox University
کينډۍ:د هېواد مالومات آذربايجان	Template:Country data Azerbaijan
کينډۍ:د فايرفاکس کارن	Template:User browser:Firefox
کينډۍ:Ar	Template:Lang-ar
کينډۍ:د هېواد مالومات وېتنام	Template:Country data Vietnam
کينډۍ:Featured article	Template:Featured article
کينډۍ:د هېواد مالومات لېبيا	Template:Country data Libya
کينډۍ:د هېواد مالومات روسیه	Template:Country data Russia
وېشنيزه:User en	Category:User en
وېشنيزه:User en-2	Category:User en-2
کينډۍ:مالوماتبکس	Template:Infobox
کينډۍ:د ايران ولايتونه	Template:イランの地方行政区画
کينډۍ:Navy	Template:Navy
کينډۍ:د هېواد مالومات اېکواټوريال گوينا	Template:Country data Equatorial Guinea
کينډۍ:User zh	Template:User zh
کينډۍ:Colorbox	Template:Colorbox
کينډۍ:د هېواد مالومات اټاليا	Template:Country data Italy
کينډۍ:د المان ايالتي نقشه	Template:ドイツの地方行政区分
کينډۍ:User ru-4	Template:User ru-4
کينډۍ:Pp-template	Template:Pp-template
کينډۍ:د هېواد مالومات سويډن	Template:Country data Sweden
وېشنيزه:کرهڼه	Category:農業
کينډۍ:Infobox settlement	Template:Infobox Settlement
کينډۍ:User ru	Template:User ru
کينډۍ:نغا	Template:IPA2
وېشنيزه:سياستوال	Category:政治家
وېشنيزه:لمريز نظام	Category:太陽系の惑星
وېشنيزه:امريکا	Category:アメリカ
کينډۍ:د هېواد مالومات کوسټاريکا	Template:Country data Costa Rica
کينډۍ:د هېواد مالومات هند	Template:Country data India
کينډۍ:د هېواد مالومات الجېريا	Template:Country data Algeria
کينډۍ:د هېواد مالومات وېنېزوېلا	Template:Country data Venezuela
کينډۍ:د هېواد مالومات فيجي	Template:Country data Fiji
کينډۍ:Infobox Officeholder	Template:Infobox Officeholder
کينډۍ:د هېواد مالومات انډورا	Template:Country data Andorra
کينډۍ:د هېواد مالومات آنگولا	Template:Country data Angola
کينډۍ:د هېواد مالومات بوټسوانا	Template:Country data Botswana
کينډۍ:د هېواد مالومات اروپايي اتحاديه	Template:Country data European Union
کينډۍ:Border	Template:Border
کينډۍ:د هېواد مالومات ډومنيکا	Template:Country data Dominica
کينډۍ:د هېواد مالومات پارتوګال	Template:Country data Portugal
کينډۍ:د هېواد مالومات آيرلېنډ	Template:Country data Ireland
کينډۍ:د هېواد مالومات واټيکان ښار	Template:Country data Vatican City
کينډۍ:Fmbox	Template:Fmbox
کينډۍ:د هېواد مالومات چین	Template:Country data China
کينډۍ:د هېواد مالومات بېنين	Template:Country data Benin
کينډۍ:د هېواد مالومات د کانگو جمهوريت	Template:Country data Republic of the Congo
کينډۍ:ويکيسازنه	Template:Wikify
کينډۍ:د هېواد مالومات ترکيه	Template:Country data Turkey
وېشنيزه:ليکوال	Category:作家
کينډۍ:د هېواد مالومات قبرس	Template:Country data Cyprus
کينډۍ:د هېواد مالومات سويتزرلاند	Template:Country data Switzerland
کينډۍ:د هېواد مالومات فلېپين	Template:Country data Philippines
کينډۍ:د هېواد مالومات نايجېريا	Template:Country data Nigeria
کينډۍ:د هېواد مالومات آيرلنډ	Template:Country data Belarus
کينډۍ:د هېواد مالومات مالېزيا	Template:Country data Malaysia
کينډۍ:د هېواد مالومات ارمنستان	Template:Country data Armenia
کينډۍ:د هېواد مالومات زېمبابوې	Template:Country data Zimbabwe
کينډۍ:د هېواد مالومات ختيځ تېمور	Template:Country data Timor-Leste
وېشنيزه:تومانچې	Category:自動式拳銃
کينډۍ:د هېواد مالومات ماينامار	Template:Country data Myanmar
کينډۍ:د هېواد مالومات قزاقستان	Template:Country data Kazakhstan
کينډۍ:د هېواد مالومات چېلي	Template:Country data Chile
کينډۍ:د هېواد مالومات سلووېنيا	Template:Country data Slovenia
کينډۍ:د هېواد مالومات لبنان	Template:Country data Lebanon
کينډۍ:د کتاب مالوماتبکس-1	Template:基礎情報 書籍
وېشنيزه:اسلامي وييپانګه	Category:アラビア語の語句
کينډۍ:د هېواد مالومات بهوټان	Template:Country data Bhutan
کينډۍ:Booland	Template:Both
وېشنيزه:څارګرې ادارې	Category:諜報・情報機関
کينډۍ:سورت	Template:スーラ (クルアーン)
کينډۍ:Tlx	Template:Tlx
کينډۍ:Lang-la	Template:Lang-la
کينډۍ:Lang-el	Template:Lang-el
محمد هاشم زماني	ハジ・モハマッド・ハシェム・ザマン
وېشنيزه:اخلاق	Category:倫理
د سره صليب نړيواله ټولنه	赤十字国際委員会
وېشنيزه:چاودېدونكى مواد	Category:爆薬
کينډۍ:Pp-meta	Template:Pp-meta
کينډۍ:IPA-en	Template:IPA-en
کينډۍ:Mergefrom	Template:Mergefrom
وېشنيزه:سولګر	Category:パーソナルコンピュータ
وېشنيزه:توکي	Category:機器
کينډۍ:MMAstatsbox	Template:MMA statsbox
کينډۍ:مالوماتبکس لويه وچه	Template:Infobox Continent
وېشنيزه:پخوانی ژبې	Category:死語
وېشنيزه:User ja-N	Category:User ja-N
تانبه:اسلام	Portal:イスラーム
کينډۍ:دشريان-مالوماتبکس	Template:Infobox 動脈
کينډۍ:Polytonic	Template:Polytonic
کينډۍ:نامبهمېدنه	Template:Aimai
وېشنيزه:د ایران امپراتورۍ او پاچاهۍ	Category:古代ペルシア
وېشنيزه:پوځي الوتکې	Category:軍用機
کينډۍ:Lang-grc	Template:Lang-grc
کينډۍ:د هېواد مالومات کوموروس	Template:Country data Comoros
کينډۍ:د فلسفې سرليکونه	Template:哲学
کينډۍ:Lang-pt	Template:Lang-pt
کينډۍ:د هېواد مالومات قطر	Template:Country data Qatar
کينډۍ:FRA	Template:FRA
کينډۍ:د هېواد مالومات اسرایل	Template:Country data Israel
کينډۍ:د هېواد مالومات اوکراين	Template:Country data Ukraine
کينډۍ:د هېواد مالومات کولمبيا	Template:Country data Colombia
کينډۍ:د هېواد مالومات پاکستان	Template:Country data Pakistan
کينډۍ:د هېواد مالومات ګانا	Template:Country data Ghana
کينډۍ:د هېواد مالومات رومانیا	Template:Country data Romania
کينډۍ:د هېواد مالومات سوېلي کوريا	Template:Country data South Korea
کينډۍ:Npov	Template:観点
جمعه خان همدرد	ジュマ・カーン・ハムダード
کينډۍ:Afghanistan-stub	Template:Afghan-stub
کينډۍ:د هېواد مالومات بحرين	Template:Country data Bahrain
کينډۍ:بوديزم	Template:Buddhism
وېشنيزه:User ja	Category:User ja
وېشنيزه:User ur	Category:User ur
وېشنيزه:User ko-N	Category:User ko-N
وېشنيزه:User ru-N	Category:User ru-N
وېشنيزه:وختتېری	Category:娯楽
وېشنيزه:افغاني ټولنه	Category:アフガニスタンの社会
وېشنيزه:چینی الوتکې	Category:中華人民共和国の戦闘機
وېشنيزه:تاريخپوهان	Category:歴史学者
وېشنيزه:User de	Category:User de
وېشنيزه:User de-N	Category:User de-N
کينډۍ:د افغانستان ولايتونه	Template:アフガニスタンの州
وېشنيزه:User en-3	Category:User en-3
وېشنيزه:User en-N	Category:User en-N
آلو	スモモ亜属
وېشنيزه:User fa	Category:User fa
کينډۍ:N/A	Template:N/a
کينډۍ:د هېواد مالومات برونډي	Template:Country data Burundi
کينډۍ:د هېواد مالومات جرمني	Template:Country data Germany
کينډۍ:د هېواد مالومات بريتانيه	Template:Country data United Kingdom
وېشنيزه:مېچپوهنه	Category:幾何学
کينډۍ:د سورة مالوماتبکس	Template:Infobox Sura
کينډۍ:د هېواد مالومات اېسټونيا	Template:Country data Estonia
کينډۍ:د هېواد مالومات مانټېنېګرو	Template:Country data Montenegro
کينډۍ:Weather box	Template:Weather box
وېشنيزه:هنرمندان	Category:美術家
وېشنيزه:User ja-1	Category:User ja-1
کينډۍ:نستعليق	Template:Script/Nastaliq
وېشنيزه:ژمنۍ لوبې	Category:ウィンタースポーツ
وېشنيزه:User ko	Category:User ko
وېشنيزه:د امريکا د متحده ايالاتو ايالتونه	Category:アメリカ合衆国の州
کينډۍ:Smallsup	Template:Smallsup
کينډۍ:وټپوهنه	Template:経済学のサイドバー
کينډۍ:د ژغورنې کينډۍ	Template:Protection templates
کينډۍ:کورنۍ	Template:家族
وېشنيزه:بانکوالی	Category:銀行業
کينډۍ:د هېواد مالومات د عاج ساحل	Template:Country data Côte d'Ivoire
وېشنيزه:د ایران ولایتونه	Category:イランの地方行政区分
وېشنيزه:User ru-1	Category:User ru-1
کينډۍ:وپ دلارښود-مخونه (سرپټه)	Template:ヘルプページヘッダ
وېشنيزه:مخدره مواد	Category:ドラッグ・カルチャー
وېشنيزه:اند	Category:思考
وېشنيزه:سياسي هڅوب	Category:政治文化
وېشنيزه:لمريز غونډال	Category:太陽系
کينډۍ:د هېواد مالومات برازیل	Template:Country data Brazil
وېشنيزه:مخترعين	Category:発明家
وېشنيزه:سر او غاړه	Category:頭頸部
کينډۍ:د هېواد مالومات سوازيلاند	Template:Country data Swaziland
وېشنيزه:ژوپوهنه	Category:動物学
وېشنيزه:د رضوي خراسان ولايت	Category:ラザヴィー・ホラーサーン州
تانبه:دين	Portal:宗教
وېشنيزه:هلیکوپترونه	Category:ヘリコプター
وېشنيزه:ټولنيزې پوهنې	Category:社会科学
کينډۍ:د هېواد مالومات هنګري	Template:Country data Hungary
وېشنيزه:د آفریقاهیوادونه	Category:アフリカの国
وېشنيزه:د هخامنشیانو حکمرانان	Category:アケメネス朝
کينډۍ:Template reference list	Template:Template reference list
وېشنيزه:حزب الله	Category:ヒズボラ
کينډۍ:د هېواد مالومات نيوزيلاند	Template:Country data New Zealand
وېشنيزه:القاعده	Category:アルカーイダ
وېشنيزه:User ro-3	Category:User ro-3
وېشنيزه:User ru	Category:User ru
وېشنيزه:User ru-2	Category:User ru-2
وېشنيزه:User ru-3	Category:User ru-3
وېشنيزه:User ru-4	Category:User ru-4
وېشنيزه:User ur-2	Category:User ur-2
کينډۍ:Lang	Template:Lang
کينډۍ:د هېواد مالومات د امريکا متحده ايالات	Template:Country data United States
کينډۍ:د هېواد مالومات ترکمنستان	Template:Country data Turkmenistan
وېشنيزه:د ۱۹۵۷ کال زېږېدنې	Category:1957年生
کينډۍ:د هېواد مالومات سهېلي کوريا	Template:Country data North Korea
کينډۍ:د هېواد مالومات افغانستان	Template:Country data Afghanistan
کينډۍ:د هېواد مالومات بنگله دېش	Template:Country data Bangladesh
لوگر ولايت	ローガル州
کينډۍ:د پاکستان سياسي جغرافي وېش	Template:パキスタンの地方行政区画
کينډۍ:امينواسيدونه	Template:タンパク質を構成するアミノ酸
وېشنيزه:افغانان	Category:アフガニスタンの人物
وېشنيزه:بي بي سي	Category:英国放送協会
کينډۍ:Biochemical families	Template:生体物質
د آلمان دپاره آلترناتیف	ドイツのための選択肢
کينډۍ:د هېواد مالومات د کانگو ډيموکراتيک جمهوريت	Template:Country data Democratic Republic of the Congo
کينډۍ:Elementbox isotopes stable	Template:Elementbox isotopes stable
کينډۍ:ICDO	Template:ICDO
وېشنيزه:اوبتلونه	Category:潜水艦
کينډۍ:OrganicBox atom	Template:OrganicBox
وېشنيزه:ماشیندارونه	Category:短機関銃
وېشنيزه:ليبيا	Category:リビア
وېشنيزه:افغاني رسنۍ	Category:アフガニスタンのメディア
وېشنيزه:په وچې پورې تړلي هیوادونه	Category:内陸国
کينډۍ:Infobox Language/family-color	Template:Infobox Language/family-color
کينډۍ:User ru-1	Template:User ru-1
کينډۍ:د هېواد مالومات بېلاز	Template:Country data Belize
کينډۍ:د هېواد مالومات کوسووا	Template:Country data Kosovo
کينډۍ:د هېواد مالومات ماورېتانيا	Template:Country data Mauritania
کينډۍ:د هېواد مالومات ګابون	Template:Country data Gabon
کينډۍ:د هېواد مالومات جبوتي	Template:Country data Djibouti
کينډۍ:د هېواد مالومات آروبا	Template:Country data Aruba
کينډۍ:د هېواد مالومات سوډان	Template:Country data Sudan
کينډۍ:د هېواد مالومات چاډ	Template:Country data Chad
وېشنيزه:روسي ساينسپوهان	Category:ロシアの学者
وېشنيزه:طالبان	Category:ターリバーン
وېشنيزه:بازارموندنه	Category:マーケティング
وېشنيزه:د نړۍ هېوادونه	Category:国際関係
کينډۍ:د هېواد مالومات انټيگ او بربودا	Template:Country data Antigua and Barbuda
کينډۍ:د هېواد مالومات ګامبيا	Template:Country data Gambia
وېشنيزه:غږپوهنه	Category:音韻論
کينډۍ:د هېواد مالومات نامېبيا	Template:Country data Namibia
کينډۍ:Tnavbar-header	Template:Tnavbar-header
وېشنيزه:مالیه	Category:金融
وېشنيزه:د افغانستان ولايتونه	Category:アフガニスタンの地方行政区分
وېشنيزه:د چېک خلک	Category:チェコの人物
وېشنيزه:آلمانی الوتکې	Category:ドイツの軍用機
وېشنيزه:مرکزي بانکونه	Category:中央銀行
وېشنيزه:کيمياوي توکي	Category:元素
وېشنيزه:امريکايي فيلسوفان	Category:アメリカ合衆国の哲学者
وېشنيزه:ساينسپوهان	Category:科学者
وېشنيزه:سولګر ملتونونه	Category:コンピュータ企業
وېشنيزه:سهېلي کوريا	Category:朝鮮民主主義人民共和国
وېشنيزه:د آسيا ارزونه	Category:アジアの通貨
وېشنيزه:ايراني سیاستوال	Category:イランの政治家
وېشنيزه:د پاکستان سياستوال	Category:パキスタンの政治家
کينډۍ:د هېواد مالومات بورکينا فاسو	Template:Country data Burkina Faso
کينډۍ:د هېواد مالومات د منځنۍ افريقا جمهوريت	Template:Country data Central African Republic
وېشنيزه:خبريالي	Category:報道
وېشنيزه:اوزبکستان	Category:ウズベキスタン
وېشنيزه:مغولو پاچايي	Category:ムガル帝国
وېشنيزه:عثماني پېر	Category:オスマン帝国
کينډۍ:د هېواد مالومات سېچېلېس	Template:Country data Seychelles
کينډۍ:د هېواد مالومات پاپوا نيوګوينا	Template:Country data Papua New Guinea
وېشنيزه:مېوې	Category:果物
وېشنيزه:زهرلرونکي نباتونه	Category:有毒植物
وېشنيزه:د اروپا سيمې	Category:ヨーロッパの地域
وېشنيزه:د آسیا جغرافیا	Category:アジアの地理
وېشنيزه:جوماتونه	Category:モスク
وېشنيزه:د ترکیې جوماتونه	Category:トルコのモスク
وېشنيزه:انتي بيوتيکونه	Category:抗生物質
وېشنيزه:مسکنونه	Category:鎮痛剤
وېشنيزه:د افشاريانو حکمرانان	Category:アフシャール朝
وېشنيزه:ددرمل شکل	Category:剤形
وېشنيزه:خبري اژانس	Category:通信社
وېشنيزه:بشرِی حقوق	Category:人権
تورن	キャプテン
وېشنيزه:ناټو	Category:NATO
وېشنيزه:غړي	Category:器官
وېشنيزه:وسلې	Category:武器
وېشنيزه:د ټوپولف الوتکې	Category:ツポレフ製旅客機
وېشنيزه:بم غورځونکي الوتکې	Category:爆撃機
وېشنيزه:د بېټا-لاکټاماز انتي بيوتيکونه	Category:Β-ラクタム系抗生物質
وېشنيزه:پاړسي ژبه	Category:ペルシア語
وېشنيزه:اېډز	Category:HIV/AIDS
وېشنيزه:قران	Category:クルアーン
وېشنيزه:ناروغۍ	Category:病気
وېشنيزه:ترافيک ترانسپورت	Category:交通
وېشنيزه:لوبې	Category:スポーツ競技
وېشنيزه:کورنۍ	Category:家族
وېشنيزه:قضاء	Category:公平
وېشنيزه:سندرغاړي	Category:歌手
وېشنيزه:وټپوهان	Category:経済学者
کينډۍ:Flagcountry	Template:Flagcountry
کينډۍ:د ژبې مالوماتبکس	Template:Infobox Language
وېشنيزه:ځمکپوهان	Category:地理学者
وېشنيزه:ولسواکي	Category:民主主義
وېشنيزه:درمل	Category:医薬品
وېشنيزه:ټانکونه	Category:戦車
وېشنيزه:د آفریقا د هېوادونو پلازمېنې	Category:アフリカの首都
وېشنيزه:ايراني هڅوب	Category:イランの文化
وېشنيزه:د رومانیا ښارونه	Category:ルーマニアの都市
وېشنيزه:کراچۍ	Category:カラチ
وېشنيزه:کابل	Category:カーブル
وېشنيزه:د آسیا د هېوادونو پلازمېنې	Category:アジアの首都
وېشنيزه:پښتانه	Category:パシュトゥーン人
وېشنيزه:چېکي واکمنان	Category:ボヘミア国王
وېشنيزه:د باميان ولايت	Category:バーミヤーン州
وېشنيزه:د افغانستان ژبې	Category:アフガニスタンの言語
وېشنيزه:هندوکش	Category:ヒンドゥークシュ
وېشنيزه:هزاره ګان	Category:ハザーラ人
وېشنيزه:شوبلې ضد وسلې	Category:対戦車ミサイル
کينډۍ:Dmbox	Template:Dmbox
کينډۍ:WPFCevent	Template:Infobox former country/event
وېشنيزه:د قاجاريانو حکمرانان	Category:ガージャール朝
وېشنيزه:افغاني ګوندونه	Category:アフガニスタンの政党
کينډۍ:د هېواد مالومات اسپانيا	Template:Country data Spain
کينډۍ:دچينايي-لوبگراوسندرغاړي-مالوماتبکس	Template:Infobox Chinese-language singer and actor
کينډۍ:د هېواد مالومات کاناډا	Template:Country data Canada
کينډۍ:د درملو لويې ډلې	Template:Major drug groups
کينډۍ:د هېواد مالومات بربادوس	Template:Country data Barbados
کينډۍ:د هېواد مالومات ګرېنادا	Template:Country data Grenada
کينډۍ:د هېواد مالومات اردن	Template:Country data Jordan
کينډۍ:د هېواد مالومات قرغزستان	Template:Country data Kyrgyzstan
کينډۍ:د هېواد مالومات لېسوتو	Template:Country data Lesotho
کينډۍ:د هېواد مالومات لايبېريا	Template:Country data Liberia
کينډۍ:د هېواد مالومات ملاوي	Template:Country data Malawi
کينډۍ:د هېواد مالومات مالديپ	Template:Country data Maldives
کينډۍ:د هېواد مالومات ماورېشوس	Template:Country data Mauritius
کينډۍ:د هېواد مالومات مغولستان	Template:Country data Mongolia
کينډۍ:د هېواد مالومات نايجېر	Template:Country data Niger
کينډۍ:د هېواد مالومات فلسطين	Template:Country data Palestine
کينډۍ:د هېواد مالومات پورټو ريکو	Template:Country data Puerto Rico
کينډۍ:د هېواد مالومات راوانډا	Template:Country data Rwanda
کينډۍ:د هېواد مالومات سېراليون	Template:Country data Sierra Leone
کينډۍ:د هېواد مالومات سورينام	Template:Country data Suriname
کينډۍ:د هېواد مالومات سوريه	Template:Country data Syria
کينډۍ:د هېواد مالومات سېنگاپور	Template:Country data Singapore
کينډۍ:د هېواد مالومات يوگانډا	Template:Country data Uganda
کينډۍ:د هېواد مالومات ونواتو	Template:Country data Vanuatu
کينډۍ:د هېواد مالومات يمن	Template:Country data Yemen
کينډۍ:د هېواد مالومات زېمبيا	Template:Country data Zambia
کينډۍ:د هېواد مالومات اېرېتېريا	Template:Country data Eritrea
کينډۍ:Free media	Template:Free media
مهرانا اودی سېنگ	ウダイ・シング2世
کينډۍ:رنگ مالوماتبکس	Template:Infobox color
وېشنيزه:د آسیا هېوادونه	Category:アジアの国
کينډۍ:آډولف هېټلر	Template:アドルフ・ヒトラー
کينډۍ:پوځي رتبې	Template:軍隊の階級
کينډۍ:سياسي اندونه	Template:政治思想
کينډۍ:Sw icon	Template:Sw icon
وېشنيزه:مسافروړونکي الوتکې	Category:旅客機
وېشنيزه:د القلوید مواد	Category:アルカロイド
کينډۍ:د هېواد مالومات لوېديځه سحارا	Template:Country data Western Sahara
کينډۍ:د هېواد مالومات د فالکلاند ټاپوان	Template:Country data Falkland Islands
نومونپوهنه	学術用語
کينډۍ:د هېواد مالومات ګونې	Template:Country data Guinea
کينډۍ:د هېواد مالومات ګوينې بېساو	Template:Country data Guinea-Bissau
کينډۍ:وسله مالوماتبکس	Template:Infobox Weapon
کينډۍ:د هېواد مالومات آذربايجان-SSR	Template:Country data Azerbaijan SSR
لارښود:نيوليک/انځورونه او رسنۍ	Help:目次 画像などのファイル
کينډۍ:غوږ شه	Template:試聴
وېشنيزه:د ساسانیانو حکمرانان	Category:サーサーン朝
وېشنيزه:سنډ	Category:シンド
وېشنيزه:امريکايي بم غورځونکي الوتکې	Category:アメリカ合衆国の爆撃機
کينډۍ:د هېواد مالومات مقدونيه	Template:Country data Macedonia
وېشنيزه:مسلمان فيلسوفان	Category:イスラムの哲学者
وېشنيزه:ليکتوکي	Category:文房具
وېشنيزه:بسونه	Category:バス車両
وېشنيزه:ورکړېنې	Category:租税
وېشنيزه:سينگار توکي	Category:トイレタリー
وېشنيزه:افغاني فلمونه	Category:アフガニスタンの映画作品
وېشنيزه:امریکایی الوتکې	Category:アメリカ合衆国の軍用機
کينډۍ:د هېواد مالومات تانزانيا	Template:Country data Tanzania
کينډۍ:د هېواد مالومات سوماليا	Template:Country data Somalia
کينډۍ:Pp-dispute	Template:保護
وېشنيزه:قراني سورتونه	Category:スーラ (クルアーン)
وېشنيزه:د لويديځ سلاوي ژبې	Category:西スラヴ語群
کينډۍ:Infobox Language/IPA notice	Template:Infobox Language/IPA notice
وېشنيزه:User en-1	Category:User en-1
وېشنيزه:اسلامپوهان	Category:イスラム学者
کينډۍ:نيمگړي کينډۍ	Template:Asbox
کينډۍ:Hlist	Template:Hlist
ويکيپېډيا:ځان زده کړه (د بحث مخونه)	Wikipedia:チュートリアル ノートページ
ويکيپېډيا:ځان زده کړه (په ياد ولره)	Wikipedia:チュートリアル 注意点
کينډۍ:Userbox-level	Template:Userbox-level
گنگسيت	めまい
دويم بريدمن	少尉
کينډۍ:User zh-min-nan-3	Template:User zh-min-nan-3
کينډۍ:Tim	Template:Tim
کينډۍ:Supranational European Bodies	Template:Supranational European Bodies
ويکيپېډيا:ځان زده کړه (تړل او نور مالومات)	Wikipedia:チュートリアル まとめ
ويکيپېډيا:ځان زده کړه (ثبتونه)	Wikipedia:チュートリアル アカウント登録
ويکيپېډيا:ډ-ځ-پ/مخليدنه	Wikipedia:FAQ プロジェクト
د افغانستان پوځ	アフガニスタンの軍事
کوکۍ	チョウ
درملتون	薬局
کينډۍ:Style/ril	Template:Style/ril
ويکيپېډيا:ډ-ځ-پ/لوستونکي	Wikipedia:FAQ 読者向け
کينډۍ:Infobox Language/genetic2	Template:Infobox Language/genetic
ويکيپېډيا:ډ-ځ-پ/بېلابېل	Wikipedia:FAQ その他
وېشنيزه:ويکيپيډيا وړې کينډۍ	Template:済/関連テンプレート
کينډۍ:هېواد-بېرغ	Template:Flagcountry2
کينډۍ:Style/IPA	Template:Style/IPA
کينډۍ:Style/yid	Template:Style/yid
Module:Convert	モジュール:Convert
سوفيست	ソフィスト
کينډۍ:د هېواد مالومات عمان	Template:Country data Oman
کينډۍ:د هېواد مالومات موزمبيق	Template:Country data Mozambique
کينډۍ:د هېواد مالومات کېمرون	Template:Country data Cameroon
کينډۍ:Infobox event	Template:Infobox event
ځانګړی:اوسني بدلونونه	特別:最近の更新
Module:Coordinates	モジュール:Coordinates
د پېښور پر پوځي ښوونځي بريد	2014年ペシャーワル学校襲撃事件
