Afrika	アフリカ
Jabaan	日本
Ameerikada koonfureed	南アメリカ
Norway	ノルウェー
Ingiriiska	イングランド
Skotland	スコットランド
Waalis	ウェールズ
Waqooyiga Ayrland	北アイルランド
Ireland	アイルランド
Hungaria	ハンガリー
Isbania	スペイン
Mareykanka	アメリカ合衆国
Beljim	ベルギー
Luksemburg	ルクセンブルク
Koon	宇宙
Dhul	地球
Nolosha	生命
Biniaadan	ヒト
George Washington	ジョージ・ワシントン
Finland	フィンランド
Iswiidhan	スウェーデン
Denmark	デンマーク
Boland	ポーランド
Lithuaniya	リトアニア
Talyaaniga	イタリア
Iswisarland	スイス
Austriya	オーストリア
Giriig	ギリシャ
Turkiga	トルコ
Bortuqaal	ポルトガル
Yurub	ヨーロッパ
Aasiya	アジア
Woqooyiga Ameerika	北アメリカ
Antiarktis	南極大陸
Wikipedia	ウィキペディア
Holland	オランダ
New York	ニューヨーク
Washington D.C	ワシントンD.C.
Baarliin	ベルリン
Los Angeles	ロサンゼルス
Boeing	ボーイング
Kumbuyuutar	コンピュータ
Jineefa	ジュネーヴ
Internet	インターネット
Barack Obama	バラク・オバマ
Uruguay	ウルグアイ
London	ロンドン
Qaahiro	カイロ
Baariis	パリ
Android	Android
Google	Google
Meksiko	メキシコ
Badweynta Atlaantik	大西洋
Badweynta Baasifik	太平洋
Kalifornia	カリフォルニア州
Isniin	月曜日
Janaayo	1月
Febraayo	2月
Maarso	3月
Farraare	火星
Kiinya	ケニア
Itoobiya	エチオピア
Gaana	ガーナ
Abriil	4月
May	5月
Juun	6月
Luuliyo	7月
Agoosto	8月
Sebteembar	9月
Oktoobar	10月
Nofeembar	11月
Diseembar	12月
Talaado	火曜日
Arbaco	水曜日
Khamiis	木曜日
Jimco	金曜日
Sabti	土曜日
Axad	日曜日
Libaax	ライオン
Faransiiska	フランス
Esberanto	エスペラント
Ey	イヌ
Midowga boqortooyada Britan	イギリス
Yaanyuur	ネコ
Shiinaha	中華人民共和国
Af-Faransiis	フランス語
Malaay	魚類
Khamri	酒
Barasiil	ブラジル
François Hollande	フランソワ・オランド
Ruushka	ロシア
Nibiri	クジラ目
Labajibaarane	正方形
Bad	海
Bada madaw	黒海
Pi Sumad xisaabeed	円周率
Wiki	ウィキ
Toronto	トロント
Alabama	アラバマ州
São Paulo	サンパウロ
São Paulo (Gobol)	サンパウロ州
Wikimedia	ウィキメディア財団
Jimmy Wales	ジミー・ウェールズ
Ingiriis	イングリッシュ
Jarmalka	ドイツ
Belarus	ベラルーシ
Af-Jarmal	ドイツ語
Island	アイスランド
Estoniya	エストニア
David Cameron	デーヴィッド・キャメロン
Raage	土星
Chocolate	チョコレート
Dagaalada	戦争
Kow	1
Labo	2
Sadax	3
Afar (lambar)	4
Shan	5
0	0
George W. Bush	ジョージ・W・ブッシュ
Laydi	長方形
Latfiya	ラトビア
Ukrain	ウクライナ
Jamhuuriyadda Tashik	チェコ
Islofaakiya	スロバキア
Isloveeniya	スロベニア
Moldofa	モルドバ
Romania	ルーマニア
Bulgaria	ブルガリア
Roma	ローマ
Jamhuriyada Makedonia	マケドニア共和国
Albania	アルバニア
Griinland	グリーンランド
Kroatia	クロアチア
Bosniya	ボスニア・ヘルツェゴビナ
Aserbiijaan	アゼルバイジャン
Andorra	アンドラ
Jasiirada Qabrus	キプロス
Joorjiya	グルジア
Kasakhstan	カザフスタン
Malta	マルタ
Monako	モナコ
Montenegro	モンテネグロ
Faatikan	バチカン
San Marino	サンマリノ
Boroksel	ブリュッセル市
Kuuba	キューバ
Belise	ベリーズ
Barbados	バルバドス
Indunisiya	インドネシア
Wolfgang Amadeus Mozart	ヴォルフガング・アマデウス・モーツァルト
Af-Turki	トルコ語
Koonfur Afrika	南アフリカ共和国
Aljeeriya	アルジェリア
Usbekistan	ウズベキスタン
Biyo	水
Alwaax	木材
Telefishin	テレビ
Claude Monet	クロード・モネ
Diego Velázquez	ディエゴ・ベラスケス
Jili	チリ
El Greco	エル・グレコ
Ciise	イエス・キリスト
Dusaa	水星
Taariikh	歴史
Apple Inc	アップル インコーポレイテッド
Waxaraxir	金星
Jaceyl	愛
Cirjeex	木星
Uraano	天王星
Nicolas Sarkozy	ニコラ・サルコジ
Nebtuun	海王星
Xiddigis	天文学
Singabuur	シンガポール
Saynis	科学
Buluuto	冥王星
Liechtenstein	リヒテンシュタイン
Ciyaaraha	スポーツ
Adolf Hitler	アドルフ・ヒトラー
Facebook	Facebook
Julian Assange	ジュリアン・アサンジ
Dagaalkii koowaad	第一次世界大戦
Dagaalkii Labaad ee Aduunka	第二次世界大戦
Goorsheegto	時計
Linux	Linux
Xisaab	数学
Af-Laatiin	ラテン語
Baxrayn	バーレーン
Armania	アルメニア
Seerbiya	セルビア
Bil	月
Istanbuul	イスタンブル
Australia	オーストラリア
Fiisigis	物理学
Arjantiina	アルゼンチン
Isgaarsiinta	電気通信
Peru	ペルー
Bayoloji	生物学
Waqooyiga Kuuriya	朝鮮民主主義人民共和国
Kambodiya	カンボジア
Qur'aan	クルアーン
Diinsoor (xayawaan)	恐竜
Islaam	イスラム教
Ljubljana	リュブリャナ
World Wide Web	World Wide Web
Naag	女性
Gabay	詩
Chernobyl	チェルノブイリ原子力発電所事故
Milan	ミラノ
Torino	トリノ
Liin dhanaan	レモン
Moos	バナナ
Ubax	花
Magaalo	都市
Napoleon Bonaparte	ナポレオン・ボナパルト
Xidig	恒星
Qorax	太陽
Cir	空
Ooshiyaaniya	オセアニア
Bahda Midaysay Qoraxdu	太陽系
Ilig	歯
Hydrogen	水素
Hiliyaam	ヘリウム
Cadaab	地獄
Wikimedia Commons	ウィキメディア・コモンズ
Liithiyaam	リチウム
Beriiliyaam	ベリリウム
Buug	本
Maalin	日
Bariga Timor	東ティモール
Sanad	年
Qarni	世紀
Oslo	オスロ
Lissabon	リスボン
Dubay	ドバイ
Lionel Messi	リオネル・メッシ
Booron	ホウ素
Versailles	ヴェルサイユ
Kaarboon	炭素
Nitrojiin	窒素
Ogsajiin	酸素
FC Internazionale Milano	インテルナツィオナーレ・ミラノ
Meere	惑星
Muusig	音楽
Moskow	モスクワ
Foloriin	フッ素
Af-Taliyaani	イタリア語
Niyoon	ネオン
Saint Petersburg	サンクトペテルブルク
Jad	チャド
Sodhiyaam	ナトリウム
Woqooyi	北
Magniisiyaam	マグネシウム
Alumiiniyaam	アルミニウム
New Zealand	ニュージーランド
Koonfur	南
Hindiya	インド
Silikoon	ケイ素
Faransiyaam	フランシウム
Tuvalu	ツバル
Fosforos	リン
Xadiid	鉄
Galbeed	西
Salfar	硫黄
Bari (Jiho)	東
Jasiiradaha Solomon	ソロモン諸島
Koloriin	塩素
Koofurta Holland	南ホラント州
Balau	パラオ
Aargon	アルゴン
Nawru	ナウル
Firefox	Mozilla Firefox
Waqooyiga Holland	北ホラント州
Botashiyaam	カリウム
Zeeland	ゼーラント州
Kaalshiyaam	カルシウム
Flevoland	フレヴォラント州
Lead	鉛
Jasiirada Marshall	マーシャル諸島
Kiribati	キリバス
Mongolia	モンゴル国
Fiji	フィジー
Iskaandhiyaam	スカンジウム
Titaaniyaam	チタン
Fanansuwela	ベネズエラ
Jinkis Khan	チンギス・カン
Fanadhiyaam	バナジウム
Koroomiyaam	クロム
Faras	ウマ
Amistardam	アムステルダム
Hub	武器
Xayawaan	動物
Surinam	スリナム
Manganiis	マンガン
Paraguay	パラグアイ
Guyana	ガイアナ
Fan	芸術
Ikwadoor	エクアドル
Reheniyaam	レニウム
Kolombiya	コロンビア
Kobalti	コバルト
Tungsten	タングステン
Nikel	ニッケル
Boliifia	ボリビア
Osmiyaam	オスミウム
Groningen	フローニンゲン州
Kober	銅
Beer	植物
Sinki	亜鉛
Leonardo da Vinci	レオナルド・ダ・ヴィンチ
Boqoshaa	菌類
Jamayka	ジャマイカ
Friesland	フリースラント州
Drenthe	ドレンテ州
Overijssel	オーファーアイセル州
Guatemala	グアテマラ
Gelderland	ヘルダーラント州
Utrecht	ユトレヒト州
Bahamas	バハマ
Dooro	ニワトリ
Antigua iyo Barbuda	アンティグア・バーブーダ
Hawaay	ハワイ州
Dominika	ドミニカ国
Doofaar	ブタ
Haiti	ハイチ
El Salfador	エルサルバドル
Iiraan	イラン
Ciraaq	イラク
Xikmad	知恵
Kosta Rika	コスタリカ
Israaiil	イスラエル
Magaalada Utrecht	ユトレヒト
Banama	パナマ
Yemen	イエメン
Virus	ウイルス
Urdun	ヨルダン
Nikaragua	ニカラグア
Florida	フロリダ州
Qargistan	キルギス
Kuwayt	クウェート
Laos	ラオス
Lubnaan	レバノン
Jasiirada Maldiif	モルディブ
Ameerika	アメリカ州
Lo'	ウシ
Malaysiya	マレーシア
Burma	ミャンマー
Nebal	ネパール
Cumaan	オマーン
Bakistaan	パキスタン
Qatar	カタール
Ciyaarta Teeniska	テニス
Sacuudi Carabiya	サウジアラビア
Siri Lanka	スリランカ
Suuriya	シリア
Gaaliyaam	ガリウム
Tadsjikistan	タジキスタン
Pokemon	ポケットモンスター
Taywan	中華民国
YouTube	YouTube
Jermaaniyaam	ゲルマニウム
Tayland	タイ王国
Tareen	列車
Aarsenik	ヒ素
Turkmenistan	トルクメニスタン
Seleniyaam	セレン
Iridiyaam	イリジウム
Imaaraatka Carabta	アラブ首長国連邦
Boromiin	臭素
Balatiniyaam	白金
Fiyetnam	ベトナム
Charlie Chaplin	チャールズ・チャップリン
Koonfur Kuuriya	大韓民国
Kiribtoon	クリプトン
Afgaanistan	アフガニスタン
Gangnam Style	江南スタイル
Rubiidhiyaam	ルビジウム
Dahab	金
Kanaalka Suweys	スエズ運河
Bangladesh	バングラデシュ
Maali	マリ共和国
Sokrades	ソクラテス
Angola	アンゴラ
Butaan	ブータン
Twitter	Twitter
Barunay	ブルネイ
Tansaaniya	タンザニア
Meerkuri	水銀
Roald Amundsen	ロアール・アムンセン
Harry Mulisch	ハリー・ムリシュ
Filibiin	フィリピン
Jamhuuriyadda Bartamaha Afrika	中央アフリカ共和国
Cirifka Koonfur	南極点
Cirifka waqooyi	北極点
Isxaaq Newton	アイザック・ニュートン
Albert Einstein	アルベルト・アインシュタイン
Istoroontiyaam	ストロンチウム
Itriyaam	イットリウム
Bismuth	ビスマス
Jaale	黄色
Togo	トーゴ
Tunisiya	チュニジア
Saambiya	ザンビア
Simbaabwi	ジンバブエ
Beijing	北京市
Koonfur Suudaan	南スーダン
Benin	ベナン
Botswana	ボツワナ
Burkina Faso	ブルキナファソ
Burundi	ブルンジ
Komoros	コモロ
Jamhuuriyadda Kongo	コンゴ共和国
Jamhuuriyada Dimuqaraadiga Kongo	コンゴ民主共和国
Jabuuti	ジブチ
Boloniyaam	ポロニウム
Ikweetiga Guinea	赤道ギニア
Eratareya	エリトリア
New Delhi	ニューデリー
Ilmo	赤ちゃん
Astatiin	アスタチン
Gabon	ガボン
Mahatma Gandhi	マハトマ・ガンディー
Gambia	ガンビア
Guinea	ギニア
Guinea-Bissau	ギニアビサウ
Xeebta Foolmaroodi	コートジボワール
Kamiruun	カメルーン
Kab Ferde	カーボベルデ
Lesotho	レソト
Liberia	リベリア
Libiya	リビア
Madagaskar	マダガスカル
Malaawi	マラウイ
Mauritania	モーリタニア
Mauritius	モーリシャス
Marooko	モロッコ
Musanbiig	モザンビーク
Nambiya	ナミビア
Nayjar	ニジェール
Nayjeeriya	ナイジェリア
Yugandha	ウガンダ
Ruwanda	ルワンダ
Sirkooniyaam	ジルコニウム
Sao Tome iyo Prinsipe	サントメ・プリンシペ
Sinigaal	セネガル
Seyshelles	セーシェル
Sierra Leone	シエラレオネ
Soomaaliya	ソマリア
Niyobiyaam	ニオブ
Julius Caesar	ガイウス・ユリウス・カエサル
Suudaan	スーダン
Swasiland	スワジランド
Qaansa Roobaad	虹
Molybdenum	モリブデン
Teknetiyaam	テクネチウム
Qaramada Midoobay	国際連合
Juquraafi	地理学
Wadno	心臓
Maskax	脳
Maqaar	皮膚
Midab	色
Rutheniyaam	ルテニウム
Roodhiyaam	ロジウム
Baluug	青
Baladiyaam	パラジウム
Naxaas	銀
Kaadmiyaam	カドミウム
Limburg	リンブルフ州 (オランダ)
Tin (curiye)	スズ
Antimony	アンチモン
Teluriyaam	テルル
Waqooyiga Brabant	北ブラバント州
Aaydhiin	ヨウ素
Siinoon	キセノン
Kaasiyaam	セシウム
Baariyaam	バリウム
Haafniyaam	ハフニウム
Aktiiniyaam	アクチニウム
Tantalum	タンタル
Bill Clinton	ビル・クリントン
Raadhiyaam	ラジウム
Raadhoon	ラドン
Lorraine	ロレーヌ地域圏
Buerto Riko	プエルトリコ
Niedersachsen	ニーダーザクセン州
Lombardia	ロンバルディア州
Qudus	エルサレム
Rutherfordium	ラザホージウム
Dubniyaam	ドブニウム
Siiborgiyaam	シーボーギウム
Badweynta Hindiya	インド洋
Kosofo	コソボ
Badda Karabiya	カリブ海
Bohriyaam	ボーリウム
Hasiyaam	ハッシウム
Meitneriyaam	マイトネリウム
Darmstadtiyaam	ダームスタチウム
Roentgeniyaam	レントゲニウム
Dortmund	ドルトムント
Ununtriyaam	ウンウントリウム
Lifermoriyaam	リバモリウム
Ununoktiyaam	ウンウンオクチウム
Maastricht	マーストリヒト
Jiilaal	冬
Gu	春
Xagaa	夏
Dayr	秋
Sadaam Xuseen	サッダーム・フセイン
Usaama bin Laadin	ウサーマ・ビン・ラーディン
Caarcaaro	クモ
Miro	果実
Lacagta	貨幣
Xasharaad	昆虫
Faladimir Lenin	ウラジーミル・レーニン
Uetersen	ユーテルゼン
Augustus Octavian	アウグストゥス
Microsoft Windows	Microsoft Windows
Jibraltaar	ジブラルタル
Nokia	ノキア
Baabuur	自動車
Juventus FC	ユヴェントスFC
Texas	テキサス州
Bruno Mars	ブルーノ・マーズ
Sasiiliya	シチリア
Sardiiniya	サルデーニャ
Fuuqbax	クローン病
Buenos Aires	ブエノスアイレス
Tokyo	東京都
Barcelona	バルセロナ
Abidjan	アビジャン
Minnesota	ミネソタ州
Baqdaad	バグダード
Isuduwaha Waqtiga Caalamiga	協定世界時
AC Milan	ACミラン
Internet Explorer	Internet Explorer
Sigaar	紙巻きたばこ
Nayl armistaroong	ニール・アームストロング
Maxamed Faarax	モハメド・ファラー
München	ミュンヘン
Fiyena	ウィーン
Kobanhaygan	コペンハーゲン
Stockholm	ストックホルム
Helsinki	ヘルシンキ
Dublin	ダブリン
Bratislava	ブラチスラヴァ
Budapest	ブダペスト
Frankfurt	フランクフルト・アム・マイン
Lanthanum	ランタン
Kitaabka quduska	聖書
Phnom Penh	プノンペン
Ho Chi Minh City	ホーチミン市
Luteetiyaam	ルテチウム
Mida Rumeed Kaniisada Ciise	真イエス教会
Ingiriis (luqad)	英語
Bangkok	バンコク
Dong Hoi	ドンホイ
Concepción	コンセプシオン (チリ)
Franck Ribéry	フランク・リベリー
Ottawa	オタワ
Dayaxa Cirjeex	木星の衛星と環
Juba	ジュバ
Końskowola	コィンスコヴォラ
Dar es Salaam	ダルエスサラーム
Khartuum	ハルツーム
Dayaxa raage	土星の衛星と環
2000	2000年
2003	2003年
2002	2002年
2001	2001年
2012	2012年
2011	2011年
2010	2010年
2009	2009年
2013	2013年
2014	2014年
2008	2008年
2004	2004年
2005	2005年
2006	2006年
2007	2007年
1900	1900年
1901	1901年
Charles De Gaulle	シャルル・ド・ゴール
1906	1906年
1908	1908年
1909	1909年
1992	1992年
1991	1991年
1990	1990年
1993	1993年
1994	1994年
1995	1995年
1996	1996年
1910	1910年
1911	1911年
1912	1912年
1913	1913年
1914	1914年
1997	1997年
1998	1998年
1999	1999年
1918	1918年
Cunto	食品
Mas	ヘビ
Dayaxa docay	海王星の衛星と環
Dashiishe	1月1日
1920	1920年
1919	1919年
1921	1921年
Georges Pompidou	ジョルジュ・ポンピドゥー
Malmö	マルメ
Birmingham	バーミンガム
Microsoft	マイクロソフト
Borotoon	陽子
Kurów	クルフ
Kimisteri	化学
Robin van Persie	ロビン・ファン・ペルシ
27	27年
1989	1989年
1988	1988年
1987	1987年
1986	1986年
1985	1985年
1984	1984年
1983	1983年
1982	1982年
1981	1981年
1980	1980年
Muqdisho	モガディシュ
Sana'a	サナア
1970	1970年
1971	1971年
1972	1972年
1973	1973年
1974	1974年
1975	1975年
1976	1976年
1977	1977年
1978	1978年
1979	1979年
1969	1969年
18 Abriil	4月18日
25 Abriil	4月25日
26 Abriil	4月26日
Dayax	衛星
Kristian Wulff	クリスティアン・ヴルフ
15 Meey	5月15日
SSC Napoli	SSCナポリ
1968	1968年
1967	1967年
1966	1966年
1965	1965年
1964	1964年
27 Juun	6月27日
Kubadda Cagta	サッカー
AS Roma	ASローマ
1963	1963年
Holokost	ホロコースト
1962	1962年
Michael Jackson	マイケル・ジャクソン
Bogota	ボゴタ
29 Diseembar	12月29日
Quito	キト
Adhi	ヤギ
21 Oktoobar	10月21日
Paramaribo	パラマリボ
Wiil	少年
Gabar	少女
Kanbera	キャンベラ
Sydney	シドニー
Cagaar	緑
Gaduud	赤
Perth	パース (西オーストラリア州)
Galbeed Australia (gobol)	西オーストラリア州
New South Wales	ニューサウスウェールズ州
Wabiga Niil	ナイル川
Jini	ジン (アラブ)
Wabiga Nijer	ニジェール川
Rabat	ラバト
Algiers	アルジェ
Tunis	チュニス
Triboli	トリポリ
Rede Globo	ヘジ・グローボ
Jabuuti (magaalo)	ジブチ市
Tahraan	テヘラン
Addis Abeba	アディスアベバ
Ankara	アンカラ
Asmara	アスマラ
Nijamiina	ンジャメナ
Niamey	ニアメ
Nawakshot	ヌアクショット
1961	1961年
Bamako	バマコ
Belgaraad	ベオグラード
Dakar	ダカール
Banjul	バンジュール
Konakri	コナクリ
Bissau	ビサウ
Category:Template	Category:ウィキペディアのテンプレート
Monrofia	モンロビア
Braia	プライア
1960	1960年
Akara	アクラ
Dimishiq	ダマスカス
Yamoussoukro	ヤムスクロ
Faransiis Guyana	フランス領ギアナ
Ougadougou	ワガドゥグー
Freetown	フリータウン
Abuja	アブジャ
Lome	ロメ
Borto-Novo	ポルトノボ
Yawunde	ヤウンデ
Malabo	マラボ
Librefille	リーブルヴィル
Bangui	バンギ
Kinshasa	キンシャサ
Barasafille	ブラザヴィル
Bujumbura	ブジュンブラ
Kigali	キガリ
Dodoma	ドドマ
Nayroobi	ナイロビ
Lilongwe	リロングウェ
Lusaka	ルサカ
Qorax madoobaad	日食
Mabuto	マプト
Kambaala	カンパラ
Luanda	ルアンダ
Moroni	モロニ
Mabane	ムババーネ
Maseru	マセル
Dugsi	学校
Antananarifo	アンタナナリボ
Jaamacad	大学
Gaborone	ハボローネ
Harare	ハラレ
Pretoria	プレトリア
Bort Lois	ポートルイス
Sao Tome	サントメ
Windhoek	ウィントフック
Wikipedia:Bacaadka	Wikipedia:サンドボックス
Fiktoria	ヴィクトリア (セーシェル)
Guri	家屋
Kombuyuuterka Dhabta	ノートパソコン
Computer Hardware	ハードウェア
Aljebra	代数学
Webiyada	川
Osasko	オザスコ (サンパウロ州)
Garoonka ee Dong Hoi	ドンホイ空港
Curitiba	クリチバ
Pangea	パンゲア大陸
Keyn	森林
Anne Frank	アンネ・フランク
Shilin Soomaali	ソマリア・シリング
Confucius	孔子
Category:Taariikhda Ciraaq	Category:イラクの歴史
Corbin Bleu	コービン・ブルー
Category:Xisaab	Category:数学
Jasiiradaha Feroe	フェロー諸島
Maxamed Morsi	ムハンマド・ムルシー
Euro	ユーロ
Bada Dhexe	地中海
Masiixiyad	キリスト教
Windows 8	Microsoft Windows 8
Template:Dalalka Aasiya	Template:アジア
Bariis	米
Céline Dion	セリーヌ・ディオン
Qaaradaha	大陸
Adelaide	アデレード
Shimbir	鳥類
Template:Islaam	Template:Islam
Bilaha	月 (暦)
Mustafa Kemal Atatürk	ムスタファ・ケマル・アタテュルク
1948	1948年
Jeejniya	チェチェン共和国
1949	1949年
Garoosni	グロズヌイ
Huang Xianfan	黄現ハン
1956	1956年
1941	1941年
1945	1945年
1958	1958年
1926	1926年
1947	1947年
1944	1944年
1952	1952年
Bill Gates	ビル・ゲイツ
Encyclopedia	百科事典
DVD	DVD
Bogga Hore	メインページ
CPU	CPU
1959	1959年
Template:Maqaal Cusub	Template:Good article
Dhesibel	デシベル
Kubadda Koleyga	バスケットボール
Kab town	ケープタウン
Bada Qaswiin	カスピ海
Harta Fiktooriya	ヴィクトリア湖
Harada malaawi	マラウイ湖
Salvador Dalí	サルバドール・ダリ
Finsent van Gogh	フィンセント・ファン・ゴッホ
Hokusai	葛飾北斎
Mishelangelo	ミケランジェロ・ブオナローティ
Bablo bekaso	パブロ・ピカソ
Rembrandt van Rijn	レンブラント・ファン・レイン
Eminem	エミネム
Bas	バス (交通機関)
Baabiyloon	バビロン
Katalooniya	カタルーニャ州
Samarqanda	サマルカンド
Bukhaara	ブハラ
Mekka	メッカ
Che Guvara	チェ・ゲバラ
Mao Zedong	毛沢東
Kabul	カーブル
Luqada Tamil-ka	タミル語
Filasoofiyada	哲学
50 Cent	50セント
Dr. Dre	ドクター・ドレー
Snoop Dogg	スヌープ・ドッグ
Shaax	茶
Tupac Shakur	2パック
Xidig-dhul	ハリネズミ
1507	1507年
Shuuciyad	共産主義
Amadeyo afogadro	アボガドロ定数
Liberalinimo	自由主義
Wadan	国
Qaran	国民
Jow Bayden	ジョー・バイデン
Hillary Clinton	ヒラリー・クリントン
Dabaal	水泳
Category:Xiddigis	Category:天文学
1542	1542年
1543	1543年
Jaan Jaak Rosoo	ジャン＝ジャック・ルソー
Saxaara	サハラ砂漠
Hambeegar	ハンバーガー
Shaydaanka	悪魔
1606	1606年
Maktabad	図書館
FC Barcelona	FCバルセロナ
Midowga afrika	アフリカ連合
Siyaasadda,	政治
Jaamacada Carabta	アラブ連盟
Dimoqraadi	民主主義
Hay'ada laanqayrta cas	赤十字社
Gaashaanbuurta NATO	北大西洋条約機構
Qin Shi Huang	始皇帝
Bariga Dhexe	中東
Jamhuriyadda	共和制
Hantiwadaag	社会主義
Dowlad	国家
Xisbi	政党
Kilimanjaaro	キリマンジャロ
Kristoffer Kolombus	クリストファー・コロンブス
Rixlaat Ibn Batuuta	イブン・バットゥータ
Kanaalka Banama	パナマ運河
Dheg	耳
San	鼻
Muruq	筋肉
Hees	歌
Kaneeco	カ
Libaax Badeed	サメ
Geel	ラクダ
Naasley	哺乳類
Maroodi	ゾウ
Quraansho	アリ
Shini	ハナバチ
Software	ソフトウェア
Af-Holandees	オランダ語
DNA	デオキシリボ核酸
Nuucyada dhirta	種 (分類学)
Hooyo	母親
Aabe	父親
Waalid	親
Gaadiidka Dadweynaha	交通
Debian	Debian
1669	1669年
1670	1670年
1671	1671年
1672	1672年
1673	1673年
1674	1674年
1675	1675年
1676	1676年
1677	1677年
1678	1678年
1679	1679年
1680	1680年
1856	1856年
Af-Ruush	ロシア語
Faladimir Putin	ウラジーミル・プーチン
Dastuur	コンスティチューション (法学)
Dalalka Kommonwels	イギリス連邦
OPEC	石油輸出国機構
Rooti	パン
UNESCO	国際連合教育科学文化機関
Baaqa Caalamiga ee Xuquuqda Aadanaha	世界人権宣言
1796	1796年
1797	1797年
1899	1889年
Sawaaxili	スワヒリ語
1893	1893年
Unug	細胞
Dhiig	血液
Qolfoof	骨格
Sambab	肺
Hab Neefsi	呼吸器
Habdhiska Taranka	生殖器
Af-Romani	ルーマニア語
Roob	雨
Dhulgariir	地震
Ibn Siinaa	イブン・スィーナー
Nelson Mandela	ネルソン・マンデラ
Martin Luther King,	マーティン・ルーサー・キング・ジュニア
Ensiim	酵素
Borotiin	タンパク質
Daad	洪水
Tsunami	津波
Fulkaano	火山
Caad	雲
Tirignoometeri	三角法
Joomitiri	幾何学
Qarnigii 2aad	2世紀
Qarnigii 1aad	1世紀
Dhaqaale	経済学
Warshad	産業
Farta laatiinka	ラテン文字
Suugaan	文学
Category:Faransiiska	Category:フランス
Category:Muusig	Category:音楽
Kun Habeen Iyo Habeen	千夜一夜物語
Category:Suugaanta	Category:文学
Category:Gabayada	Category:詩
Waxbarasho	教育
Qoys	家族
Hugo Chavez	ウゴ・チャベス
Nin	男性
Guur	結婚
Midab Takoor	人種差別
Adoon	奴隷
Dagaal Sokeeye	内戦
Cumar	ウマル・イブン・ハッターブ
Suldaan Suleymaan kan 1aad	スレイマン1世
Bun	コーヒー
Caano	乳
Buur	山
Salaaxudiin al-Ayyuubi	サラーフッディーン
Karaaji	カラチ
Riyaal Madrid	レアル・マドリード
Dagaalkii qaboobaa	冷戦
Seoul	ソウル特別市
Tomas Edison	トーマス・エジソン
Michael Faraday	マイケル・ファラデー
Internet protocol	Internet Protocol
HTML	HyperText Markup Language
Af-Iswiidhan	スウェーデン語
Muxamed bin Muuse al-Khwarizmī	フワーリズミー
Karl Marx	カール・マルクス
Nabi Muuse C.S.	モーセ
Aqoon	知識
Naas	乳房
Atom	原子
Ileys	光
Af Giriig	ギリシア語
Operating system	オペレーティングシステム
Naf	霊魂
Af-Faarsi	ペルシア語
Diin	宗教
Nabi Ibraahiim C.S.	アブラハム
Saladh	サラダ
Yuhuuda	ユダヤ教
Af-Hebrow	ヘブライ語
Ibn Khalduun	イブン・ハルドゥーン
Beer (xubin)	肝臓
Bakeyle	ウサギ
Cilminafsi	心理学
Badweyn	大洋
Gootama buuda	釈迦
Muxamed	ムハンマド・イブン＝アブドゥッラーフ
BBC	英国放送協会
Shahrukh Khan	シャー・ルク・カーン
Al-Ghazaali	ガザーリー
Gerald Ford	ジェラルド・R・フォード
Shiica	シーア派
Suufi	スーフィズム
Carab	舌
Chelsea FC	チェルシーFC
Arsenal F.C.	アーセナルFC
Ganac	膵臓
Qolfoofta Dadka	ヒトの骨格
Qoor	首
Af	口
Sakaar	胸
Elizabeth II	エリザベス2世
Caajiska	疲労
Schiphol	スキポール空港
Haarlem	ハールレム
Ronald Reagan	ロナルド・レーガン
Af-Zulu	ズールー語
Foosto	樽
Sabool	貧困
Gordon Brown	ゴードン・ブラウン
Jadwalka Curiyayaasha	周期表
Robert Mugabe	ロバート・ムガベ
Xamaam(Shinbir)	ハト科
Bakteeri	真正細菌
Geed	木
Canab	ブドウ
Malab	蜂蜜
Hilib	食肉
Barandho	ジャガイモ
Sonkor	砂糖
Khudaar	野菜
Robot	ロボット
Makiinad	機械
Saxaafad	報道
Taleefoon	電話機
Dhaqan	文化
RNA	リボ核酸
Xidigisyahan	天文学者
Habdhiska Wareega Dhiiga	循環器
Mindhicirka weyn	大腸
Mindhicirka yar	小腸
Ibn Haytham	イブン・ハイサム
Isku dhis	化合物
Sharci dajinta	立法府
Windows 7	Microsoft Windows 7
Boqolleey	パーセント
Windows Vista	Microsoft Windows Vista
Fidel Castaro	フィデル・カストロ
Category:Barasiil	Category:ブラジル
Tamar	エネルギー
Abala-abalayn bayoloji	生物の分類
Awood	力
Cufisjiidad	重力
Cuf	質量
Bir	金属
Hawo	気体
Dareere	液体
Adke	固体
Bushkuleeti	自転車
Markab	船
Beeraha	農業
Cudbi	木綿
Tiknolajiga nano	ナノテクノロジー
Xaansho	紙
Bac	合成樹脂
Bed	面積
Lambar	数
Kiilogaraam	キログラム
Cristiano Ronaldo	クリスティアーノ・ロナウド
Mitir	メートル
Ilbiriqsi	秒
Galley	トウモロコシ
Kelvinka	ケルビン
Dalalka	国の一覧
Ludwik Lejzer Zamenhof	ルドヴィコ・ザメンホフ
Mesobotaamiya	メソポタミア
Buti	クマ
Britney Spears	ブリトニー・スピアーズ
Habdhiska Dheefshiidka	消化
Habka Samayska Cuntada	光合成
Kansar	悪性腫瘍
Boqortooyo	王
Qamadi	コムギ
Kalandar	暦
Dhagool	ろう者
Cudur	病気
Niikotiin	ニコチン
Malaariyo	マラリア
Cunto xumida	栄養失調
Benseliin	ペニシリン
Nantes	ナント
AIDS	後天性免疫不全症候群
Sokorow	糖尿病
Template:Location map Yemen	Template:Location map Yemen
Mona Lisa	モナ・リザ
Horgale (Fiisikis)	国際単位系
Burj Khalifa	ブルジュ・ハリファ
Gidaarka Shiinaha	万里の長城
Abyoone	整数
Kubad	球面
Dawladii Cabaasiyiinta	アッバース朝
Dawlada Cosmaniya	オスマン帝国
Koronto	電気
Seef	剣
Pawlo Kuwelho	パウロ・コエーリョ
Stephan El Shaarawy	ステファン・エル・シャーラウィ
Liin	オレンジ
Af-Soomaali	ソマリ語
Aljaziira	アルジャジーラ
Hal-xeraale	パズル
Carabi	アラビア語
Xorta ah	フリーコンテント
Baar	ヤシ
Dollar	ドル
Ra'iisul wasaare	首相
Araga	光学
Calan	旗
Qalin Qori	鉛筆
Saabaan	家具
Template:Location map Sudan	Template:Location map Sudan
Template:Location map Eritrea	Template:Location map Eritrea
Template:Location map Ethiopia	Template:Location map Ethiopia
Template:Location map Djibouti	Template:Location map Djibouti
Template:Location map Somalia	Template:Location map Somalia
Template:Location map Nigeria	Template:Location map ナイジェリア
Template:Location map Uganda	Template:Location map ウガンダ
Geri	キリン
Faruur	唇
Shaarbo	口髭
Midowga Sofiyet	ソビエト連邦
Qolofta kore ee Dhulka	地殻
Lil Wayne	リル・ウェイン
FC Bayern München	バイエルン・ミュンヘン
Queen	クイーン (バンド)
Kanye West	カニエ・ウェスト
Huguri	咽喉
Wikipedia:Maqaallo Xul Ah	Wikipedia:秀逸な記事
Template:Link FA	Template:Link FA
Maalmaha	昼
Aduunka	世界
Wikipedia:Goob	Wikipedia:井戸端
Nanjing	南京市
Mayotte	マヨット
Goobo	円 (数学)
Cesc Fàbregas	セスク・ファブレガス
Mobile	携帯電話
Goronyo	ダチョウ
Kuuriya	朝鮮
Manchester	マンチェスター
1000	1000年
999	999年
Yeey	オオカミ
1955	1955年
1954	1954年
1953	1953年
1951	1951年
1950	1950年
1946	1946年
1943	1943年
1942	1942年
1940	1940年
1939	1939年
1938	1938年
1937	1937年
1936	1936年
Manchester United FC	マンチェスター・ユナイテッドFC
1935	1935年
1934	1934年
Axdiga Cusub	新約聖書
Qafqaas	コーカサス
Sagaal	9
Dabaqaroof	サソリ
Koobka Adduunka	FIFAワールドカップ
Boolo	ペリカン属
Macdin Alkaliini ah	第1族元素
Macdin dhuleed ah	第2族元素
Rafael Correa	ラファエル・コレア
Transitional Metal	遷移元素
Bir la Mood	半金属
Bir Ma Ahe	非金属元素
Guruubka 17	第17族元素
Neefta Gobta	第18族元素
5	5年
4	4年
3	3年
Boqorad	女王
2	2年
Buqarest	ブカレスト
Louvre	ルーヴル美術館
Motorhead	モーターヘッド
Dameer	ロバ
Wikipedia:Maqaal Cusub	Wikipedia:良質な記事
6	6年
Axdigii Hore	旧約聖書
Saddax-xagal	三角形
Lady Gaga	レディー・ガガ
Luqada Hindo Yurub	インド・ヨーロッパ語族
Breinigerberg	ブライニガーベルク
Muammar Qadaafi	ムアンマル・アル＝カッザーフィー
Shabeel	トラ
Francesco Totti	フランチェスコ・トッティ
PSY	PSY
Nissan	日産自動車
Booyad	タンクローリー
Walhade	振り子
Samsung	サムスングループ
Skandinafiyen	スカンディナヴィア
Aruba	アルバ
Smartphone	スマートフォン
Shidaal	石油
Isuduwe Habka Juqraafiga	地理座標系
Banki	銀行
1	1年
10	10年
20	20年
30	30年
Abkhazia	アブハジア
40	40年
9	9年
7	7年
8	8年
Todoba	7
Sideed	8
Todobaad	週
Deero	シカ
Baraf	氷
Toon	ニンニク
Musée d'Orsay	オルセー美術館
Anthroboloji	人類学
Badacas	紅海
13	13年
Koonfur Ossetia	南オセチア
Ulan Bator	ウランバートル
51	51年
Jasiirad	島
Cad	白
Madaw	黒
37	37年
900	900年
Lordi	ローディ (バンド)
Basal	タマネギ
Lix	6
700	700年
Yaanyo	トマト
George H. W. Bush	ジョージ・H・W・ブッシュ
68	68年
89	89年
11	11年
Quang Binh	クアンビン省
Entrena	エントレナ
Dhulbare	赤道
NASA	アメリカ航空宇宙局
Benito Mussolini	ベニート・ムッソリーニ
15	15年
14	14年
17	17年
500	500年
150	150年
Qaamuus	辞典
Bermuda	バミューダ諸島
Madax	頭
Wellington	ウェリントン
23	23年
800	800年
Heesta qaranka	国歌
42	42年
Afarta jiho	方位
18	18年
Nuurad	石灰岩
19	19年
16	16年
21	21年
26	26年
41	41年
32	32年
33	33年
Falastiin	パレスチナ
Valletta	バレッタ
200	200年
38	38年
43	43年
39	39年
24	24年
79	79年
61	61年
104	104年
29	29年
102	102年
100	100年
Haramcad	チーター
Afarta xilli	季節
101	101年
105	105年
108	108年
Dhuxul Dhagax	石炭
22	22年
46	46年
25	25年
153	153年
156	156年
31	31年
28	28年
Liverpool	リヴァプール
85	85年
88	88年
76	76年
54	54年
60	60年
47	47年
Guumees	フクロウ目
Nederlaan Antiilis	オランダ領アンティル
Bahda Bisada	ネコ科
Ambeer	アンペア
Isotope	同位体
Göteborg	ヨーテボリ
Culeys	重さ
Geed Timir	ナツメヤシ
Burris	槌
Racibórz	ラチブシュ
Odense	オーデンセ
Kobe Bryant	コービー・ブライアント
Luqadaha Berberiga	ベルベル語
600	600年
400	400年
300	300年
Tilburg	ティルブルフ
Dayax gacmeed	人工衛星
Taylor Swift	テイラー・スウィフト
Khaalid bin Waliid	ハーリド・イブン・アル＝ワリード
Bariga Afrika	東アフリカ
Fiat	フィアット
Bartamaha Ameerika	中央アメリカ
Af-Cafari	アファル語
Magrib	マグリブ
Amxaari	アムハラ語
36)	36年
Tin	毛 (動物)
Wareeg	周長
Dhicis	流産
Dhar	織物
Kacdoonka masar	エジプト革命 (2011年)
Willis Tower	ウィリス・タワー
Kacbada	カアバ
Beatriks	ベアトリクス (オランダ女王)
Isuzu	いすゞ自動車
Dublad	漏斗
159	159年
107	107年
103	103年
152	152年
240	240年
197	197年
70	70年
Duqa	市町村長
81	81年
69	69年
87	87年
65	65年
66	66年
67	67年
55	55年
34	34年
44	44年
35	35年
64	64年
151	151年
155	155年
50	50年
260	260年
45	45年
49	49年
230	230年
Zhengzhou	鄭州市
154	154年
52	52年
82	82年
84	84年
73	73年
72	72年
62	62年
71	71年
75	75年
74	74年
83	83年
78	78年
77	77年
90	90年
80	80年
91	91年
190	190年
109	109年
53	53年
270	270年
Madaxweyne	大統領
63	63年
86	86年
401	401年
99	99年
98	98年
110	110年
137	137年
138	138年
140	140年
130	130年
210	210年
220	220年
Dell	デル
180	180年
158	158年
157	157年
106)	106年
48	48年
97	97年
Yuumbi	カジキ
56	56年
93	93年
Alofi	アロフィ
57	57年
Jamestown	ジェームズタウン (セントヘレナ)
Walaal	兄弟姉妹
170	170年
171	171年
172	172年
58	58年
59	59年
139	139年
134	134年
135	135年
96)	96年
92	92年
133	133年
176	176年
131	131年
Fowdo	無政府状態
Jasiirad Dhuleedka Carabta	アラビア半島
250	250年
280	280年
290	290年
Mindi	ナイフ
Masaajid	モスク
Akon	エイコン
Dumnad	ドミノ
174	174年
International Standard Book Number	ISBN
132	132年
178	178年
Luqadaha Tashaadiga	チャド語派
Drake	ドレイク (エンターテイナー)
Luqadaha Kushiitiga	クシ語派
Afguri	方言
95	95年
94	94年
257	257年
Biriq	雷
Gacan	手
Af-Oromo	オロモ語
Caleen	葉腋
Jilaa	俳優
Niue	ニウエ
Luqadaha Semitiga	セム語派
Justin Bieber	ジャスティン・ビーバー
Xusni Mubaarak	ホスニー・ムバーラク
Af-Tigrinya	ティグリニャ語
Af-Tigre	ティグレ語
Dhululubo	円柱 (数学)
Subag	バター
Yaasir Carafaat	ヤーセル・アラファート
Fara-ka hadal	手話
136	136年
Injiil	福音書
Alexander Graham Bell	アレクサンダー・グラハム・ベル
Tasmaniya	タスマニア州
Rotterdam	ロッテルダム
Saabuun	石鹸
Mošovce	モショヴツェ
Shakira	シャキーラ
Jaamacadda Oxford	オックスフォード大学
Maxamuud Axmadinajaad	マフムード・アフマディーネジャード
CD	コンパクトディスク
Al-Qaacida	アルカーイダ
Maxamed Al-faatex	メフメト2世
Jeer	カバ
Far	指
Furaat	ユーフラテス川
Gacanka Faarsiga	ペルシア湾
Cilmiga bulshada	社会科学
Somaliland	ソマリランド
Ciida sanadka cusub	新年
Babaay	パパイア
Brisbane	ブリスベン
Fiitamiin	ビタミン
Towraad	トーラー
Koonfur Joorjiya iyo Koonfurta Jasiiradaha Sanwij	サウスジョージア・サウスサンドウィッチ諸島
Maahmaah	ことわざ
Noemi	ノエミ (歌手)
Website	ウェブサイト
Ido	イド語
Sumeer	シュメール
Kolonbo	コロンボ
Dariishad	窓
Medina	マディーナ
Akkadiyaan	アッカド語
Booliis	警察
UEFA	欧州サッカー連盟
Tigris	チグリス川
Koonfur Australia (gobol)	南オーストラリア州
Baarlamaan	議会
Maatar	物質
Jaamacadda Cambridge	ケンブリッジ大学
Fulinta (Dawlad)	行政
Hurdo	睡眠
Neefta	気管支喘息
Doon	ボート
Queensland	クイーンズランド州
Mohammed ali Clay,	モハメド・アリ
Beyoncé Knowles	ビヨンセ
Urur	集合
Siligo	シーリゴ
Riyo	夢
Bur	穀粉
Dhigaha	経度
Kimikal dibusocod	化学反応
Den Haag	デン・ハーグ
Goriila	ゴリラ
Daylight saving time	夏時間
Daanta galbeed	ヨルダン川西岸地区
Maraykanka assalkoodii	アメリカ州の先住民族
Siinaa	シナイ半島
Albaab	扉
Rihanna	リアーナ
Hargab Doofaar	豚インフルエンザ
Cinjo	爪
Ugaadhsi	狩猟
Toshiro Mifune	三船敏郎
Waji	顔
Aleksander Fileming	アレクサンダー・フレミング
Musmaar	釘
Nabi Suleymaan C.S.	ソロモン
Yahoo	Yahoo!
AK-47	AK-47
Mowjad	波動
Dhexroor	径
Bare	教員
Internet Movie Database	インターネット・ムービー・データベース
Dalai Lama	ダライ・ラマ
Jilib (xubin)	膝
ISO 4217	ISO 4217
Tomas hobis	トマス・ホッブズ
Campora San Giovanni	カンポラ・サン・ジョヴァンニ
Jirjiroole	カメレオン科
Cusmaan bin Cafaan	ウスマーン・イブン・アッファーン
Jaandi	合金
Nafto	軽油
Qare	スイカ
Toban iyo shan	15
Rikter Cabir	マグニチュード
Xamaas	ハマース
Ruhollah Khomeini	ルーホッラー・ホメイニー
Rajab Dayib Erdogaan	レジェップ・タイイップ・エルドアン
Mug	体積
Jamaal Cabdinaasir	ガマール・アブドゥル＝ナーセル
Bluetooth	Bluetooth
Cali	アリー・イブン・アビー・ターリブ
Marinka Gaza	ガザ地区
Radio Studio 54 Network	Radio Studio 54 Network
Cabitaan	飲料
Qoori	砂浜
Qabaal	楕円
Hobart	ホバート
Dayax Gacmeed	宇宙機
Doorashada	選挙
Iskudhufasho	乗法
Saxaraha Galbeed	サハラ・アラブ民主共和国
.et	.et
Geeska Afrika	アフリカの角
Lisa Gerrard	リサ・ジェラルド
Nabi Yaxye C.S.	洗礼者ヨハネ
Jennifer Lopez	ジェニファー・ロペス
Faraq	減法
Breda (Netherlands)	ブレダ (オランダ)
Shuban	下痢
Nancy	ナンシー
Honiara	ホニアラ
PH	水素イオン指数
Asiyriya	アッシリア
Qardhaas	菱形
Xayla Siilaasi	ハイレ・セラシエ1世
Xalab	アレッポ
Big Ben	ビッグ・ベン
Dhererka Mowjadda	波長
Nabi Daa'uud C.S.	ダビデ
Borussia Dortmund	ボルシア・ドルトムント
Xidido	根
Mole	モル
Frank Lampard	フランク・ランパード
Qallal	てんかん
Ramadaan	ラマダーン
Baqal	ラバ
Garaam	グラム
Shahaadah	シャハーダ
Gacanka Cadmeed	アデン湾
Beeraha laalaada	バビロンの空中庭園
Maas	マース川
Khadiija binti Khuweylad	ハディージャ・ビント・フワイリド
Waraabe	ハイエナ
Sariir	ベッド
Madaxwayne kuxigeen	副大統領
Cilmibaadhis	研究
Faaranhaayt	華氏
Dhuldaaqsiin	サバナ (地理)
Dhogor	ウール
Toobin	円錐
Daliban	ターリバーン
MP3	MP3
Ismaamulka Falastiin	パレスチナ自治政府
.ke	.ke
Fernando Torres	フェルナンド・トーレス
Gar	髭
Nabi	預言者
Derbi	壁
SMS	ショートメッセージサービス
Yaxaas	クロコダイル科
Majladda Time	タイム (雑誌)
Dhedig	メス (動物)
Farabadne	ムカデ
Amedeo Avogadro	アメデオ・アヴォガドロ
Shambay	ヤマネコ (種)
Federaalka	連邦
Sedex Geesoodka Bermuda	バミューダトライアングル
Arjen Robben	アリエン・ロッベン
Xamid Karzai	ハーミド・カルザイ
Lab	オス
Rey mysterio	レイ・ミステリオ・ジュニア
Dayax madoobaad	月食
Taxane	行列
Kayene	カイエンヌ
John Cena	ジョン・シナ
Waran	槍
Dadqalato	カニバリズム
Busbus	水痘
Provinces of Argentina	アルゼンチンの地方行政区画
Dekad	港湾
Garoonka Diyaaradaha ee Bole	ボレ国際空港
Dadka Berberiga	ベルベル人
Afganbi	クーデター
Burcad Badeed	海賊
RSS	RSS
Lacagta Meherka	持参金
Barbaroole	平行四辺形
Leeb	矢
Chris Paul	クリス・ポール
Awood Socota	運動エネルギー
Koor	台形
Qaanso	弓矢
Amiibada	アメーバ
Zlatan Ibrahimović	ズラタン・イブラヒモビッチ
GSM	GSM
Dhaban	頬
Saint-Denis	サン＝ドニ (レユニオン)
Arsène Wenger	アーセン・ベンゲル
Baabiylooniya	バビロニア
Muslim	ムスリム
Warqadda aqoonsiga	身分証明書
Template:Commonscat	Template:Commonscat
Qoorgooye	髄膜炎
399	399年
Iidi Amiin Daada	イディ・アミン
Kayseri	カイセリ
CNN	CNN
Drogbaa	ディディエ・ドログバ
Dhakhaatiirta Bilaaxuduudaa	国境なき医師団
Abwaan	詩人
Manchester city	マンチェスター・シティFC
Ilaahay	トロムス県
John Dramani Mahama	ジョン・ドラマニ・マハマ
Luqada Masaarida	エジプト語
Anatooliya	アナトリア半島
Nabi Ciise	イスラームにおけるイーサー
Cudurka Ebola	エボラ出血熱
Template:Taxobox	Template:生物分類表
Carly Rae Jepsen	カーリー・レイ・ジェプセン
Toyota	トヨタ自動車
Osmose	浸透
Af-Hawsa	ハウサ語
Saxan	皿
Mwai Kibaki	ムワイ・キバキ
Jalaal Daalabaani	ジャラル・タラバニ
Ismaaciil Cumar Geelle	イスマイル・オマル・ゲレ
Nuur Al-Maliki	ヌーリー・マーリキー
Dileita Maxamed Dileita	ディレイタ・モハメド・ディレイタ
Mark Rutte	マルク・ルッテ
Cumar Cabdirashiid Cali Sharmaarke	オマル・アブディラシド・アリ・シルマルケ
Axmed Dafutoglu	アフメト・ダウトオール
Robinho	ロビーニョ
Bada Carbeed	アラビア海
Dhircun	草食動物
Calanka Denmark	デンマークの国旗
Jay-Z	ジェイ・Z
Caroog	巻貝
Yuusuf Alqardaawi	ユースフ・アル＝カラダーウィー
Sahel	サヘル
Henry Kissinger	ヘンリー・キッシンジャー
Nabi Aadam C.S.	アダム
Diego Milito	ディエゴ・ミリート
Habaryar	おば
Abti	おじ
Ilmo adeer	いとこ
Shumac	ろうそく
Wikipedia:Sharaxaada Maqaalada Xulka Ah	Wikipedia:秀逸な記事の選考
Wikipedia:Sharaxaada Maqaalada Cusub	Wikipedia:良質な記事/良質な記事の選考
Dhalo	瓶
Raqay	タマリンド
Shabeelada Tamil	タミル・イーラム解放のトラ
Qaangaadh	大人
Enjerneer	技術者
Gacanka Caqaba	アカバ湾
KwaZulu-Natal Province	クワズール・ナタール州
Hilibcun	肉食動物
AFC Ajax	アヤックス・アムステルダム
Qaado	スプーン
VOIP	VoIP
Jibriil	ガブリエル
Astaamayn	句読点
Taksi	タクシー
Soqotra	ソコトラ島
Timor	ティモール島
Almere	アルメレ
Xoor-dubbur	スカンク
Dooli	ハツカネズミ
Suul	親指
Mesut ozil	メスト・エジル
Turki	トルコ人
HyperText	ハイパーテキスト
Xeeb	海岸
Ibb	イッブ
Lobamba	ロバンバ
Walxaha	元素の周期
Magarete2	マルグレーテ2世 (デンマーク女王)
Calanka jabuuti	ジブチの国旗
Xareed	淡水
Calanka Suudaan	スーダンの国旗
Daanyeer	ヒト上科
Sodium Hydroxide	水酸化ナトリウム
Xoolo	家畜
Cirid	歯肉
Chalcogen	第16族元素
Tufaax	リンゴ属
Shakaal	斜辺
Biniktojiin	第15族元素
Lambedusa	ランペドゥーザ島
Manuel Neuer	マヌエル・ノイアー
Jalmad	やかん
Eris	エリス
Wiz Khalifa	ウィズ・カリファ
Agool	頭垢
Barfasoor	教授
Maydhax	木部
Dhax kujir	内陸国
Andalus	アンダルス
Sako	ザカート
Dhadhan	味覚
ICAO	国際民間航空機関
.so	.so
Western Cape Province	西ケープ州
Mario Balotelli	マリオ・バロテッリ
Qiiq	煙
Eastern Cape Province	東ケープ州
Cerebellum	小脳
Haaruun Alrashiid	ハールーン・アッ＝ラシード
Kaftan	ジョーク
Funaanad	Tシャツ
IMMAGINE&POESIA	IMMAGINE&POESIA
Tangent	接線
Niisaabuur	ニーシャープール
Khilaafada Islaamka	イスラム帝国
Cadan	アデン
Het Wilhelmus	ヴィルヘルムス・ファン・ナッソウエ
Mpumalanga Province	ムプマランガ州
Northern Cape Province	北ケープ州
Mamawdsaw	マムズ
Gauteng Province	ハウテン州
Lug	脚
Cagaarshow	黄疸
Du gamla, Du fria	古き自由な北の国
Shaydaanimo	サタニズム
Limpopo Province	リンポポ州
LG	LGグループ
Ogaden	オガデン
Alexandre Pato	アレシャンドレ・ロドリゲス・ダ・シウヴァ
Wabiga Jubba	ジュバ川
Qooleey	伝書鳩
Wabiga Shabeelle	シェベリ川
Masago	カラフトシシャモ
Marsho	歯車
Nabi Yuusuf	ヨセフ (ヤコブの子)
One Direction	ワン・ダイレクション
Mille	溶媒
Herpesviruses	ヘルペスウイルス科
Degmo	ディストリクト
Tomahok (gantaal)	トマホーク (ミサイル)
Dambas	灰
Eduard Douwes Dekker	ムルタトゥーリ
Yuusuf Islaam	キャット・スティーヴンス
Kiyaawe	レンチ
Awood Kaydsan	位置エネルギー
Chris Brown	クリス・ブラウン (歌手)
Aadan Cabdulle Cusmaan	アデン・アブドラ・ウスマン
Saylac	ゼイラ
Anopheles	ハマダラカ
Malawad	直腸
Universidade Federal da Bahia	バイーア連邦大学
Calanka Soomaaliya	ソマリアの国旗
Dhuuso	屁
Free State Province	フリーステイト州
Maqal	聴覚
Oorfane	孤児院
Ubuc	胴体
Meles Zenawi	メレス・ゼナウィ
Nicki Minaj	ニッキー・ミナージュ
Wahaabi	ワッハーブ派
Diffusion	拡散
DDT	DDT
Ibrahim Affelay	イブラヒム・アフェレイ
Angry Birds	Angry Birds
Daango	ポップコーン
Qalin	ペン
Aadaan	アザーン
Usher	アッシャー (歌手)
Hummaag noqod	反射
North West Province	北西州 (南アフリカ)
Lelystad	レリスタット
Midabada Asaasiga	原色
Isnidaamis	疥癬
Daaf	結膜炎
CAF	アフリカサッカー連盟
Hargeysa	ハルゲイサ
Nabiyada Islaamka	イスラム教の預言者
Xijaas	ヒジャーズ
Filibs	フィリップス
Kaliber	口径
Geed Hindi	インドセンダン
Jidh	体
Qosol	笑い
Nektar	蜜
Mount kenya	ケニア山
Uunsi	乳香
Jomo Kenyatta	ジョモ・ケニヤッタ
Gacan (Joomitiri)	半径
Centimetre	センチメートル
Millimeter	ミリメートル
Baadiye	田舎
Portal:Taariikh	Portal:歴史
Hunguriga neefta	気管
Bowdo	大腿骨
Baarlamaanka Federaalka Soomaaliya	連邦議会 (ソマリア)
Qaamo-qashiir	流行性耳下腺炎
Tiirarka Islaamka	五行 (イスラム教)
Fanaan	歌手
Huulaaku Khan	フレグ
Wadan soo kobcooyo	開発途上国
Dhuxul	木炭
Shansho	脛骨
Saac (faah faahin)	腕時計
Alchemist(Buug)	アルケミスト - 夢を旅した少年
The Notorious B.I.G.	ノトーリアス・B.I.G.
Sanab	塑像
Saadiyom bicarbonate	炭酸水素ナトリウム
Nabi Ayuub C.S.	ヨブ
Fatima bint Muxamed	ファーティマ
Baras	尋常性白斑
Sumad xisaabed	数学記号の表
Daan	顎
Ricir	椎骨
Qol	部屋
Dhado	湿度
Curiye	エレメント
Mucaawiye bin Abii Sufyaan	ムアーウィヤ
Xasan Nasrallaah	ハサン・ナスルッラーフ
Mahathir Bin Maxamed	マハティール・ビン・モハマド
Bidaar	脱毛症
Aafda tahriibka	人身売買
KLM	KLMオランダ航空
Johan Rudolph Thorbecke	ヨハン・ルドルフ・トルベッケ
Gabareey-maanyo	人魚
Mitsubishi	三菱グループ
Cashuura	アーシューラー
Tamaashiir	チョーク (岩石)
Memory card	メモリーカード
Daxal	錆
Will.i.am	ウィル・アイ・アム
Saxaro	厩肥
Gaamur	乾留液
UFC	UFC
Pitbull	ピットブル (ラッパー)
Tariikhda Shiikh Axmed Yaasiin	アフマド・ヤースィーン
Saxaabi	サハーバ
Gows	大臼歯
Shanbal	シンバル
Harar	ハラール (エチオピア)
Dhismaha websiteka	ウェブデザイン
Golcas	ガゼル
Session Initiation Protocol	Session Initiation Protocol
Salafiya	サラフィー主義
Berbera	ベルベラ
Botka internetka	インターネットボット
Bergen op Zoom	ベルヘン・オプ・ゾーム
Mengista Xayle Maryam	メンギスツ・ハイレ・マリアム
Mowliidka Nebiga	預言者生誕祭
Ciraaqi Diinaar	イラク・ディナール
Adenoviridae	アデノウイルス
Daniel arap Moi	ダニエル・アラップ・モイ
Ne-Yo	ニーヨ
Sin	股関節
Axmed Binu Xambal	イブン・ハンバル
Jirid	トランク
Sheybaar	顕微鏡
Peso (Arjantiina)	アルゼンチン・ペソ
Yamanta Koonfureed	南イエメン
Assur	アッシュール
Decimetre	デシメートル
Sean paul	ショーン・ポール
Yazidi (yasiidi)	ヤズィーディー
Calanka somaliland	ソマリランドの国旗
Soomaali Galbeed	ソマリ州
Shilin Kiinyaati	ケニア・シリング
Astaannta Qaranka ee Soomaaliya	ソマリアの国章
Astaannta Qaranka ee Imaaraatka	アラブ首長国連邦の国章
Velupillai Prabhakaran	ヴェルピライ・プラバカラン
Federaaliisim	連邦主義
Biomolikule	生体物質
Nabi Alyasac C.S.	エリシャ
Birr	ブル (通貨)
Jaad	チャット (麻薬)
Cows	芝
S-block	Sブロック元素
Dab Damis	消防車
SliTaz	Slitaz
Kung fu	功夫
Maxamed Siyaad Barre	モハメド・シアド・バーレ
Salo	サロ (フィンランド)
Ívi Adámou	イヴィ・アダムー
Cafar	アファル人
Saliid Macsaro	ごま油
Cumar Mukhtaar	オマル・ムフタール
Angalool	貝殻
Flo Rida	フロー・ライダー
Eden Hazard	エデン・アザール
T.I.	T.I.
Budhcad badeeda geeska afrika	ソマリア沖の海賊
Ayaan Xirsi Cali	アヤーン・ヒルシ・アリ
P-block	Pブロック元素
D-block	Dブロック元素
F-block	Fブロック元素
Cabdullaahi Yuusuf Axmed	アブドゥラヒ・ユスフ
Ururka Dawladaha aan la aqoonsan Wali	代表なき国家民族機構
Qof	人間
Darawal	運転手
Addimo-yaqaan	整形外科学
Dhul (dhulka lagu socdo)	床
Faysal Bin Cabdil Caziiz	ファイサル (サウジアラビア王)
Wadar	総和
Qormo saynis	指数表記
C.H	BC
Adam Levine	アダム・レヴィーン
Al-Faatixa	開端 (クルアーン)
Al-Baqara	雌牛 (クルアーン)
Hogaamiye Kooxeed	ウォーロード
T-pain	T-ペイン
Anggun	アングン
Carlos the Jackal	カルロス (テロリスト)
Fatima	ファティマ (曖昧さ回避)
Mombaaso	モンバサ
Alexa Internet	アレクサ・インターネット
Sheekh Xasan Albanaa	ハサン・アル＝バンナー
Daariq ibn Ziyaad	ターリク・イブン・ズィヤード
Seed	腱
Al-Ikhlas	純正 (クルアーン)
Suurad	スーラ (クルアーン)
Xadiis	ハディース
Sunna	スンナ
Allaah	アッラーフ
Salaad	サラート
Xaj	ハッジ
Malag	天使
Astaannta Qaranka ee Kolombiya	コロンビアの国章
Xisbiga shacabka iyo xoriyada Holalnd	自由民主国民党
Qeshm	ゲシュム島
Bukhaari	ムハンマド・アル＝ブハーリー
Dadka Soomaaliyeed	ソマリ族
Haumea	ハウメア
Dagaalkii sokeeye ee Soomaaliya	ソマリア内戦
Jason Derulo	ジェイソン・デルーロ
Macrakadii Ceyn Jaaluut	アイン・ジャールートの戦い
Iskugeyn	プラス
FIFA	国際サッカー連盟
Uumi	蒸気
Iman model	イマン・アブドゥルマジド
Laf	骨
Wayne Rooney	ウェイン・ルーニー
Al Hudaydah	フダイダ
Sheekh Shariif Axmed	シェイク・シャリフ・シェイク・アフマド
Kismaayo	キスマヨ
Beydaan	モモタマナ
R. Kelly	R・ケリー
Fool	切歯
Dhul Udug	プント国
Nabi Yacquub C.S.	ヤコブ (旧約聖書)
Zubeyr bin Cawaam R.C	ズバイル・イブン・アウワーム
Demba Ba	デンバ・バ
Xasan Guuleed Abtidoon	ハッサン・グレド・アプティドン
K'naan	K'Naan
Greyson Chance	グレイソン・チャンス
Cabdul-Qadir Jilani	アブド・アルカーディル・アルジーラーニー
Cabdi Bile Cabdi	アブディ・ビレ
Cabdiqaasim Salaad Xassan	アブディカシム・サラ・ハッサン
Cabdirashiid Cali Sharma'arke	アブディラシッド・アリー・シェルマルケ
Al-Shabaab	アル・シャバブ (ソマリア)
Sheekh Yaasir Al-Xabiib	ヤセル・アル・ハビブ
Cody Simpson	コーディー・シンプソン
Madfac	砲弾
Dagaalkii xoraynta ogaden	オガデン戦争
Oromo	オロモ人
Xasan Sheekh Maxamuud	ハッサン・シェイク・モハムド
Rodolfo Graziani	ロドルフォ・グラツィアーニ
Maxamed Faarax Caydiid	モハメッド・ファッラ・アイディード
Biyo baxa deg dega ah	早漏
Dhulka Talyaaniga ee Soomaaliya	イタリア領ソマリランド
Trey songz	トレイ・ソングス
Macawiis	サロン (民族衣装)
Nuuraddin Faarax	ヌルディン・ファラー
Compaq	コンパック
Unimog	ウニモグ
Lufthansa Duulimaadkii 181	ルフトハンザ航空181便ハイジャック事件
Tooreey	刃
Boosaaso	ボサソ
Dowladda federaalka kumeelgaarka	ソマリア暫定連邦政府
Abu Bakr	アブー・バクル
Imaam Axmed Guray	アフマド・イブン・イブリヒム・アル＝ガジー
Dun	スレッド
Daahir Rayaale Kaahin	ダヒル・リヤレ・カヒン
Timo Soini	ティモ・ソイニ
Cali maxamed Geedi	アリー・ムハンマド・ゲーディ
Marek Grechuta	マレク・グレフタ
Jeddah	ジッダ
Axmed Maxamed Maxamuud (Siilaanyo)	アフメッド・シランヨ
Afmadow	アフマドゥ
Xulka Qaranka Soomaaliya	サッカーソマリア代表
Woqooyi bari	北東州 (ケニア)
Masjid al-Aqsa	アル＝アクサー・モスク
Computer Engineering	計算機工学
Masjid al-Xaram	マスジド・ハラーム
Karl Wolf	カール・ウルフ
Astaanta Calanka Soomaaliya	目覚めよ、ソマリア
Amxaaro	アムハラ人
Ta'izz	タイズ
Murgacasho	捻挫
Calooleey	トライプ
Maxamed Xaaji Ibraahim Cigaal	イブラヒム・エガル
Paramore	パラモア
Tuur	猫背
Lafdhabar	脊椎
Luís Carlos Almeida da Cunha	ルイス・カルロス・アルメイダ・ダ・クーニャ
Paris Saint-Germain FC	パリ・サンジェルマンFC
Ahlu sunno waljamaaca	スンナ派
Puntland	プントランド
Qureysh	クライシュ族
Masjidka Nabiga	預言者のモスク
Dagaalkii uxud	ウフドの戦い
Sambuus	サモサ
Imaam Mujtahid Sheykhul-Islaam	イブン・タイミーヤ
Bilaal ibn Ribaax	ビラール・ビン＝ラバーフ
Fiat 124	フィアット・124
Busteejo	バスステーション
Galatasaray SK	ガラタサライSK (サッカー)
IGAD	政府間開発機構
Astaanta Calanka Jabuuti	ジブチ (国歌)
Baydhabo	バイドア
G-Spot	Gスポット
Kulmiye	平和統一開発党
Xiriirka Soomaaliyeed ee Kubadda Cagta	ソマリアサッカー連盟
Sayid Maxamed Cabdulle Xassan	サイイド・ムハンマド・アブドゥラー・ハッサン
Maxamed Cabdulaahi Maxamed	モハメド・アブドゥライ・モハメド
Baskin-Robbins	バスキン・ロビンス
Baraawe	ブラバ (ソマリア)
Xisbiga Hantiwadaagga Kacaanka Soomaaliyeed	ソマリ社会主義革命党
Aakhiro	来世
Dhuusamareeb	ドゥサマレブ
Maxamed Cusman Jawaari	モハメド・オスマン・ジャワリ
Jowhar	ジョハール
Shimbiris	シンビリス山
Marka	マルカ
Biciid	オリックス属
Astaannta Qaranka ee somaliland	ソマリランドの国章
Dhulka Biritishka ee Soomaaliya	イギリス領ソマリランド
Wax soo saar	プロダクション
Nabi Isxaaq C.S.	イサク
Soomaaliweyn	大ソマリア主義
Cabdi Faarax Shirdoon	アブディ・ファラ・シルドン
Hanti maguurto	不動産
Carta	アルタ (ジブチ)
Liiska dalalka dad ahaan	国の人口順リスト
Godol	授乳
Jaamacada Banaadir	ベナディール大学
Bari (Gobol)	バリ州 (ソマリア)
Wajeer	ワジール (ケニア)
Adult Film Database	アダルト・フィルム・データベース
Cali Mahdi Maxamed	アリ・マフディ・ムハンマド
Midowga Maxkamadaha Islaamiga	イスラム法廷会議
Somaliland shilling	ソマリランド・シリング
Taleefoonada fiilada	固定電話
UNICEF	国際連合児童基金
Behra	ベイラ (動物)
Abuu Cubeydah Caamir ibn Jaraax	アブー・ウバイダ
Garoonka Diyaaradaha ee Da Nang	ダナン国際空港
Cirbadii dhimashada	オブトサソリ
Nansi Ajram	ナンシー・アジュラム
Awdal	アウダル州
Ayuub Daa'uud	アユブ・ダウド
Bankiga Somaliland	ソマリランド銀行
Baardheere	バルデラ
Badhan	バハン
Banaadir	バナディール州
Bari	バーリ (曖昧さ回避)
Sedjibeke	正六面体
Beledweyne	ベレトウェイン
Garoowe	ガローウェ
Kilometer	キロメートル
Xaawo	イヴ
Soor	コーンミール
Dhuun	レンサ球菌咽頭炎
Web feed	フィード
YouPorn	YouPorn
Liiska magaalooyinka adduunka dad ahaan	世界の市域人口の順位
Guraag	グラジェ族
Hectometre	ヘクトメートル
Gaarisa	ガリッサ
Eurobeat	ユーロビート
Decametre	デカメートル
York University	ヨーク大学 (カナダ)
Buurta Xira	ヒラー山
Gedo	ゲド州
Gaalkacyo	ガルカイヨ
Guddi	委員会
Goobogali	多肢選択法
Galguduud	ガルグドゥード州
Woqooyi Galbeed	北部ガルベード州
Mudug	ムドゥグ州
Saxiixu Muslim	サヒーフ・ムスリム
Boorama	ボラマ (ソマリア)
Taran	積
Reoviruses	レオウイルス科
Matoor	モーター
Wikipedia:Caawinaad	Help:目次
Wikipedia:Tutorial	Wikipedia:ガイドブック
Miraha Mucjisada	ミラクルフルーツ
Galmudug	ガルムドゥグ
Canjeelo	インジェラ
USC	統一ソマリ会議
Dawladii Mamaaliikta	マムルーク
Poxviruses	ポックスウイルス科
Burco	ブラオ
Ajdjadajd	ジュバランド
Mandheera	マンデラ (ケニア)
Sheekh Aways	ハッサン・ダヒール・アウェイス
Ibraahim Xasan Caddoow	イブラヒム・ハッサン・アドウ
Bu’aale	ブアレ
Hobyo	ホビョ
Xudur	フドゥール
Garbahaarey	ガーバハレ
Murshid abad	ムルシダーバード
Ceerigaabo	エリガボ
Laascaanood	ラス・アノド
Eyl	エイル (ソマリア)
Saxiixul Bukhaari	サヒーフ・アル＝ブハーリー
Calool	胃
Senary	六進法
Internet Adult Film Database	インターネット・アダルト・フィルム・データベース
Ceres	セレス
Lambar Tubaxan	三進法
Ciidamada Qalabka Sida ee Masaarida	エジプト軍
Dadka Tigrega	ティグレ人
Daallo Airlines	ダーロ航空
Kaniini	丸剤
Garoonka Diyaaradaha ee Aadan Cadde	アデン・アッデ国際空港
Liverpool FC	リヴァプールFC
Duurjoog	ハムバグ
Gobolada somaliland	ソマリランドの行政区画
Raas Caseyr	グアルダフィ岬
Ciise (qabiil)	イッサ族
Wabiga Daawa	ダワ川
Wikipedia:Safaarad	Wikipedia:大使館
Naafto	ディーゼル (曖昧さ回避)
U qeybin	除法
UCID	正義開発党
Ur	スメル
Samuel Eto'o	サミュエル・エトオ
RedTube	RedTube
Noole	被造物
Maakhir	マーヒル
Ra'iisul wasaarayaashii Soomaaliya	ソマリアの首相
Imtixaan	試験
Agnes Monica	アグネス・モニカ
Xuseen Maxamed Faarax Caydiid	フセイン・モハメド・ファラー・アイディード
Category:Jarmal	Category:ドイツ
Category:Talyaaniga	Category:イタリア
Category:Qaramada Midoobey ee Maraykanka	Category:アメリカ合衆国
Category:Ruushka	Category:ロシア
Category:Midowga boqortooyada Britan	Category:イギリス
Category:Isbania	Category:スペイン
Category:Shiinaha	Category:中国
Category:Hindiya	Category:インド
Category:Sucuudiga	Category:サウジアラビア
Category:Turki	Category:トルコ
Category:Koonfur Afrika	Category:南アフリカ共和国
Category:Masar	Category:エジプト
Category:Iiraan	Category:イラン
Category:Arjantiina	Category:アルゼンチン
Category:Afqaanistan	Category:アフガニスタン
Category:Austriya	Category:オーストリア
Category:Itoobiya	Category:エチオピア
Category:Ciraaq	Category:イラク
Category:Nederland	Category:オランダ
Category:Bakistaan	Category:パキスタン
Category:Boland	Category:ポーランド
Category:Bortuqaal	Category:ポルトガル
Category:Suudaan	Category:スーダン
Category:Iswisarland	Category:スイス
Category:Fiyetnam	Category:ベトナム
Category:Shimbir	Category:鳥類
Category:Fiisikis	Category:物理学
Category:Bayoloji	Category:生物学
Category:Kimisteri	Category:化学
Category:Taariikh	Category:歴史
Category:Juqraafi	Category:地理
Category:Diin	Category:宗教
Category:Ciyaaraha	Category:スポーツ
Category:Saynis	Category:科学
Category:Filimaanta	Category:映画
Category:Isgaadhsiin	Category:通信
Jabhadda Wadaniga Xoreynta Ogaadeenya)	オガデン民族解放戦線
Bolol	乾腐病
Hawiye	ハウィエ
Railway Mogadiscio-Villabruzzi	モガディシオ・ヴィラブルッチ鉄道
Ras kambooni	ラス・カンボニ
Template:Box-footer	Template:Box-footer
Waqtiga Bariga Afrika	東アフリカ時間
Cabdiweli Maxamed Cali	アブディウェリ・モハメド・アリ
SNM	ソマリ国民運動
Laas Geel	ラース・ゲール
Xisbiga talada ee dalka jabuuti RPP	進歩人民連合
Isaaq	イサック
Luuq	ルーク (ソマリア)
Aragtida doobnimada	社会問題
Muxaram	ムハッラム
Ciyaalmaamo	マザーコンプレックス
Category:Filasoofiyada	Category:哲学
Category:Cilminafsi	Category:心理学
Category:Masiixiyad	Category:キリスト教
Category:Islaam	Category:イスラム教
Digil iyo Mirifle	ラハンウェイン
UDUB	統一人民民主党
Waajid	ワジド
Dafo	鷲
Badh	1/2
May 2013	Portal:最近の出来事/2013年5月
Saldanadii Cadal	アダル・スルタン国
Nabi Yuunus C.S.	ヨナ
Dad	人民
Mici	上顎犬歯
Awdalland	アウダルランド
Khaatumo state	チャツモ国
Sheekh Aaden Maxamed Nuur	アダン・モハメド・ヌール・マドベ
Laan	枝
Category:Dhaqan	Category:文化
Category:Tobaneeyada sano	Category:10年紀
Category:Sanad	Category:年
Category:Qaaradaha	Category:大陸
Sheikh Mukhtar Mohamed Hussein	シェイハ・ムクター・モハメド・フセイン
Dolo	ドーロ (エチオピア)
Doorashada Madaxtinimada Soomaaliya, 2012	2012年ソマリア大統領選挙
Portal:Cilmi Fallag	Portal:天文学
Portal:Juqraafi	Portal:地理学
Precalculus	Precalculus
Liboy	リボイ
Jagada Madaxwaynaha Somaliland	ソマリランドの大統領一覧
Neef	呼吸器疾患
Gunbur	角錐
Jano	楽園 (宗教)
Ximan iyo xeeb	ハイマン・アンド・ヒーブス
Saami qumman	比
Tiro	伯
Banaadir Stadium	バナディール・スタジアム
Category:Wikipedia bots	Category:Wikipedia bots
XVideos	XVideos
Dagaal Dhaqameedka shiineeska	中国武術
Portal:Bulsho	Portal:メディア
Harti	ハルティ (ダロッド)
Cufka atamka	原子量
Hotmail	Hotmail
Wikipedia:Su'aal/Hordhac	Wikipedia:調べもの案内
Wikipedia:Soo Bandhigga Sawirka Xulka	Wikipedia:秀逸な画像の推薦
Template:Gradient	Template:Gradient
Template:Wikipedialang	Template:メインページ/他言語版
Category:Wadamada	Category:国
Wikipedia:Maamulka	Wikipedia:管理者
Category:Shaqsiyadaad	Category:人物
Wikipedia:Requests for adminship	Wikipedia:管理者への立候補
Wikipedia:Bots	Wikipedia:Bot
Category:Amin	Category:時間
Category:Internet	Category:インターネット
Category:Siyaasad	Category:政治
Category:Waxbarasho	Category:教育
Category:Araga	Category:光学
Category:Fan	Category:芸術
Masar	エジプト
Category:Filasoofiyaasha	Category:哲学者
Category:Doorashooyinka	Category:選挙
Template:Bot	Template:Bot
Kanada	カナダ
Category:Denmark	Category:デンマーク
Category:Giriig	Category:ギリシャ
Category:Iswiidhan	Category:スウェーデン
Category:Islofaakiya	Category:スロバキア
Wikipedia:Copyright	Wikipedia:著作権
Wikipedia:Ku saabsan	Wikipedia:ウィキペディアについて
Qolobaa Calankeed	祖国を賛美せよ
Category:Microsoft	Category:マイクロソフト
Portal:Saynis	Portal:自然科学
Wikipedia:Ogaysiiska Maamulka	Wikipedia:管理者伝言板
Template:Flagicon	Template:Flagicon
Category:Wadamada Yurub	Category:ヨーロッパの国
Category:Yurub	Category:ヨーロッパ
Wikipedia:Bogga Isticmaalaha	Wikipedia:利用者ページ
Portal:Dhacdooyinka Hadda	Portal:最近の出来事
Template:Documentation	Template:Documentation
Category:Delete	Category:削除関連
Wikipedia:Ilaalinta badelka	Wikipedia:保護の方針
Wikipedia:Albaabka bulshada	Wikipedia:コミュニティ・ポータル
Category:Luqadaha wikipediyaasha	Category:言語別の利用者
Wikipedia:Shan walxood	Wikipedia:五本の柱
Wikipedia:Userboxes	Wikipedia:ユーザーボックス
Wikipedia:Saxiix	Wikipedia:署名
Sung Jae-ki	成在基
Caa'isha binti Abiibakar	アーイシャ・ビント・アブー・バクル
Ganacsi	企業
Template:Softredirect	Template:Softredirect
Template:Tirtir	Template:即時削除
Category:Teknooloji	Category:技術
Category:Afafka	Category:諸言語
Category:Kalandar	Category:暦法
Category:Wikipedia	Category:ウィキペディア
Wikipedia:Masuul la'aan guud	Wikipedia:免責事項
Category:Pages with broken file links	Category:壊れたファイルへのリンクがあるページ
Wikipedia:Tirakoob	Wikipedia:統計
Template:Navbox	Template:Navbox
Template:Xaqiiq	Template:要出典
Portal:Siiro	Portal:人物伝
Template:!	Template:!
Template:Tnavbar	Template:Tnavbar
Template:Clear	Template:Clear
Template:Nowrap	Template:Nowrap
Millan	溶液
Wikipedia:Codsiga maamulka/Hordhac	Wikipedia:権限申請
Wikipedia:Maqaalada aan u baahan laheen	Wikipedia:すべての言語版にあるべき項目の一覧
Category:Afrika	Category:アフリカ
Category:Kitaabka quduska	Category:聖書
Category:Buugta	Category:書物
Category:Bilaha	Category:月 (暦)
Template:Babel	Template:Babel
Template:Reflist	Template:Reflist
Category:Isbitaal	Category:医療機関
Wikipedia:Soo bandhigida xogta	Wikipedia:出典を明記する
Template:Digniin	Template:警告
Template:Gumud	Template:Stub
Template:User ar-1	Template:User ar-1
Template:See also	Template:See also
Template:User da-2	Template:User da-2
Template:User da	Template:User da
Template:User de	Template:User de
Template:User de-1	Template:User de-1
Template:User es	Template:User es
Template:User de-3	Template:User de-3
Template:User en-3	Template:User en-3
Template:User en-1	Template:User en-1
Template:User en-2	Template:User en-2
Template:User en-4	Template:User en-4
Template:User fi	Template:User fi
Template:User en-0	Template:User en-0
Template:User en	Template:User en
Template:User de-2	Template:User de-2
Template:User fi-1	Template:User fi-1
Template:User fr-1	Template:User fr-1
Template:User sk	Template:User sk
Template:User fr-2	Template:User fr-2
Template:User ja	Template:User ja
Template:User ja-1	Template:User ja-1
Template:User fr	Template:User fr
Category:Aasiya	Category:アジア
Category:Jili	Category:チリ
Category:Ameerikada koonfureed	Category:南アメリカ
Template:Intricate template	Template:複雑なテンプレート
Template:Mod	Template:Mod
Template:User es-2	Template:User es-2
Template:Country data Belgium	Template:Country data Belgium
Category:Maalmaha usbuuca	Category:曜日
Template:Navy/core	Template:Country flagnavy
Category:Bogga Hore	Category:メインページ
Template:Country data Ethiopia	Template:Country data Ethiopia
Template:Country data Cuba	Template:Country data Cuba
Template:Country data Kenya	Template:Country data Kenya
Template:Country data Denmark	Template:Country data Denmark
Template:Click	Template:Click
Template:Country data Bosnia and Herzegovina	Template:Country data Bosnia and Herzegovina
Template:Number of defined parameters	Template:Number of defined parameters
Template:Country data Norway	Template:Country data Norway
Template:Country data Argentina	Template:Country data Argentina
Template:Country showdata	Template:Country showdata
Template:Image label	Template:Image label
Template:Country data Mexico	Template:Country data Mexico
Template:Infobox dot-com company	Template:Infobox dotcom company
Template:Country data Saudi Arabia	Template:Country data Saudi Arabia
Template:Dalalka Afrika	Template:アフリカ
Template:Country data Iraq	Template:Country data Iraq
Template:Country data United Arab Emirates	Template:Country data United Arab Emirates
Template:Kutaal	Template:Geographic Location
Template:Country data Australia	Template:Country data Australia
Template:Sidebar	Template:Sidebar
Template:Navigation templates	Template:Navigational templates
Template:Infobox Xooga Dalka Soomaaliyeed	Template:Infobox 国軍
Template:Country data Austria	Template:Country data Austria
Template:Collapsible option	Template:Collapsible option
Template:Country data Nepal	Template:Country data Nepal
Template:Country data Finland	Template:Country data Finland
Wikipedia:Tutorial (Wikipedia links)	Wikipedia:チュートリアル リンク
Template:Country data Netherlands	Template:Country data Netherlands
Template:Hatnote	Template:Dablink
Template:Maqaal Xul Ah	Template:Featured article
Template:Country data Russian Federation	Template:Country data Russia
Category:Gaana	Category:ガーナ
Category:User en	Category:User en
Category:User en-2	Category:User en-2
Template:Infobox	Template:Infobox
Template:Navy	Template:Navy
Template:User eo	Template:User eo
Template:User zh	Template:User zh
Category:Farta	Category:アルファベット
Template:Documentation/start box	Template:Documentation/start box
Template:Documentation/end box2	Template:Documentation/end box2
Template:Documentation/start box2	Template:Documentation/start box2
Template:Template other	Template:Template other
Template:Country data Italy	Template:Country data Italy
Template:Country data	Template:Country data
Template:Infobox Dhacdo	Template:Infobox 事故
Template:Pp-template	Template:Pp-template
Template:Min	Template:Min
Category:Astaannta Qaranka	Category:紋章
Category:Beeraha	Category:農業
Template:Maamulka	Template:Admin
Category:Dowladaha	Category:国家
Category:Bahda Midaysay Qoraxdu	Category:太陽系の惑星
Template:Country data Soviet Union	Template:Country data Soviet Union
Template:Country data India	Template:Country data India
Category:Falastiin	Category:パレスチナ
Category:Language user templates	Category:バベル
Template:Navbox subgroup	Template:Navbox subgroup
Template:Farac	Template:Infobox 民族
Template:Category redirect	Template:Category redirect
Template:Macluumaad Qof Madax Ah	Template:Infobox Officeholder
Category:Kacaanka	Category:革命家
Template:Border	Template:Border
Template:Country data Turkey	Template:Country data Turkey
Category:Qoraaga	Category:作家
Category:Jaamacadaha	Category:大学
Template:Country data Nigeria	Template:Country data Nigeria
Template:Hidden begin	Template:Hidden begin
Template:Country data Malaysia	Template:Country data Malaysia
Template:User pt-1	Template:User pt-1
Template:User nl	Template:User nl
Template:Infobox website	Template:Infobox Website
Template:Image label end	Template:Image label end
Template:Documentation subpage	Template:Documentation subpage
Template:Infobox number	Template:整数
Template:Rtl-lang	Template:Rtl-lang
Category:Dekedaha	Category:港湾
Template:Lang-la	Template:Lang-la
Template:Macluumaad askariga	Template:基礎情報 軍人
Template:User	Template:User
Template:References	Template:出典の明記
Template:PD-because	Template:PD-because
Template:Infobox former country	Template:基礎情報 過去の国
Template:1	Template:Gold1
Template:Infobox Political post	Template:Infobox Political post
Template:Suugaan	Template:文学
Template:Kaydka wadahadalka	Template:Talkarchive
Portal:Fiisikis	Portal:物理学
Template:User de-0	Template:User de-0
Template:Usbuuc	Template:曜日
Template:User fr-0	Template:User fr-0
Template:Country data West Germany	Template:Country data West Germany
Template:Hidden end	Template:Hidden end
Category:Booliis	Category:警察
Template:Fb	Template:Fb
Template:Astaamayn	Template:Punctuation marks
Template:Plain link	Template:Plainlink
Template:Country data Comoros	Template:Country data Comoros
Template:Geobox	Template:Geobox
Template:Lower	Template:Lower
Template:Dhintey	Template:Death date
Template:User sandbox	Template:User sandbox
Template:Saynis	Template:科学
Template:High-risk	Template:使用箇所の多いテンプレート
Template:Country data Qadar	Template:Country data Qatar
Template:Country data Ukrain	Template:Country data Ukraine
Template:Country data Pakistan	Template:Country data Pakistan
Template:User pt-3	Template:User pt-3
Template:User pt-2	Template:User pt-2
Category:Qalabka Waxlagu kariyo	Category:調理器具
Category:User sk	Category:User sk
Category:User eo	Category:User eo
Category:User ja	Category:User ja
Category:User da-2	Category:User da-2
Category:Ganacsi	Category:ビジネス
Template:Correct title	Template:記事名の制約
Category:User ar	Category:User ar
Category:Jasiirad	Category:島
Category:User da	Category:User da
Category:User sk-N	Category:User sk-N
Category:User de	Category:User de
Category:User fi	Category:User fi
Template:Country data Burundi	Template:Country data Burundi
Template:Country data Germany	Template:Country data Germany
Template:Country data UK	Template:Country data United Kingdom
Template:Color sample	Template:Color sample
Category:User ja-1	Category:User ja-1
Category:User ko	Category:User ko
Template:Macluumaad	Template:Information
Template:Biological classification	Template:Biological classification
Wikipedia:Babel	Wikipedia:バベル
Template:Wikipedia how to	Template:How-to
Category:Abwaanada	Category:詩人
Template:Sidebar with collapsible lists	Template:Sidebar with collapsible lists
Category:Badaha	Category:海
Template:No2	Template:No2
Category:Ingiriiska	Category:イングランド
Template:Str ≥ len	Template:Str ≧ len
Category:Taariikhda Soomaaliya	Category:ソマリアの歴史
Template:Country data Brazil	Template:Country data Brazil
Template:Yes2	Template:Yes2
Category:Ururada caalamiga ah	Category:国際組織
Category:Juquraafiga Soomaaliya	Category:ソマリアの地理
Template:Country data Somaliland	Template:Country data Somaliland
Category:Madaxda Soomaaliya	Category:ソマリアの大統領
Category:Cilmiga bulshada	Category:社会科学
Category:Wadamada Afrika	Category:アフリカの国
Template:User da-3	Template:User da-3
Category:1542	Category:1542年
Fenerbahce SK	フェネルバフチェSK
Template:Country data United States	Template:Country data United States
Category:Farshaxanka	Category:画家
Wikipedia:Xeerka adeegsiga sawirada	Wikipedia:画像利用の方針
Wikipedia:Habaynta Maqaalada Cusub	Wikipedia:良質な記事/良質な記事の再選考
Category:Dhirta	Category:木
Wikipedia:Habaynta Maqaalada Xulka Ah	Wikipedia:秀逸な記事の再選考
Portal:Baayooloji	Portal:生物学
Template:Mashquul	Template:Busy
Category:Juquraafiga Hindiya	Category:インドの地理
Template:Convert/And0	Template:Convert/And0
Template:Weather box/cold	Template:Infobox Weather/cold
Category:Xisbiyada Somaliland	Category:ソマリランドの政党
Template:User information templates	Template:User information templates
Category:Jabuuti	Category:ジブチ
Category:Ereteriya	Category:エリトリア
Category:Kiinya	Category:ケニア
Category:Komoros	Category:コモロ
Category:Libiya	Category:リビア
Category:Dhaqaalaha Soomaaliya	Category:ソマリアの経済
Category:Lacagta	Category:通貨
Category:Webiyada	Category:河川
Category:Juquraafiga Jabuuti	Category:ジブチの地理
Template:User pt	Template:User pt
Category:Soomaaliya	Category:ソマリア
Template:DecreasePositive	Template:DecreasePositive
Category:Juquraafiga Yemen	Category:イエメンの地理
Category:Magaalooyinka Yemen	Category:イエメンの都市
Template:Country data Djibouti	Template:Country data Djibouti
Category:User nl	Category:User nl
Category:Hay'ada laanqayrta cas	Category:赤十字
Template:Country data Federated States of Micronesia	Template:Country data Federated States of Micronesia
Template:Navbar-header	Template:Tnavbar-header
Category:Suuriya	Category:シリア
Category:Qarniyada	Category:世紀
Category:Qarnigii 16aad	Category:16世紀
Category:Qooriyada	Category:砂浜
Category:Filasoofiyaasha Jarmalka	Category:ドイツの哲学者
Category:Esoteric templates	Category:複雑なテンプレート
Category:Harraha Afrika	Category:アフリカの湖
Category:Madaxda Faransiiska	Category:フランスの大統領
Category:Madaxda Iiraan	Category:イランの大統領
Category:Norway	Category:ノルウェー
Category:Yemen	Category:イエメン
Category:Malaay	Category:魚類
Category:Mutolojiyada	Category:神話
Category:Qaamuus	Category:辞典
Category:Axdiga Cusub	Category:新約聖書
Category:Ilko	Category:歯
Category:Dhaqanka Soomaalida	Category:ソマリアの文化
Category:Wikimedia	Category:ウィキメディア財団
Category:Radio	Category:ラジオ
Category:Xayawaan	Category:動物
Category:Jamhuriyadda	Category:共和国
Category:Kushiinka Soomaalida	Category:ソマリアの食文化
Category:Muqdisho	Category:モガディシュ
Category:Bartamaha Ameerika	Category:中央アメリカ
Category:Caasimadaha	Category:首都
Category:Magaalooyinka Hindiya	Category:インドの都市
Category:Isgaarsiinta	Category:電気通信
Category:Gaadiidka	Category:交通
Category:Ameerikada waqooyi	Category:北アメリカ
Category:Harraha	Category:湖
Category:Calamada	Category:旗
Template:Flagcountry	Template:Flagcountry
Template:Macluumaad luqadda	Template:Infobox Language
Category:Dimoqraadi	Category:民主主義
Kaaroot	ニンジン
Category:Caasimadaha afrika	Category:アフリカの首都
Category:Magaalooyinka Soomaaliya	Category:ソマリアの都市
Category:Magaalooyinka Jabuuti	Category:ジブチの都市
Category:Guurka	Category:結婚
Template:So	Template:So icon
Category:Lahjadaha looga hadlo Soomaaliya	Category:ソマリアの言語
Category:Caasimadaha yurub	Category:ヨーロッパの首都
Category:Somaliland	Category:ソマリランド
Template:POW	Template:POW
Template:H:title	Template:H:title
Template:Infobox former country/event	Template:Infobox former country/event
Category:Caafimaadka	Category:健康
Template:Country data Canada	Template:Country data Canada
Template:Clickable button 2	Template:Clickable button 2
Template:Convert/numdisp/frac	Template:Convert/numdisp/frac
Template:Convert/numdisp/frac1	Template:Convert/numdisp/frac1
Template:Coord/display/inline,title	Template:Coord/display/inline,title
Template:Country data Malawi	Template:Country data Malawi
Template:Country data South Yemen	Template:Country data South Yemen
Template:Country data Uganda	Template:Country data Uganda
Template:Country data Yemen	Template:Country data Yemen
Template:Lang-pl	Template:Lang-pl
Portal:Xisaab	Portal:数学
Trojany	トロヤニ (マゾフシェ県)
Template:HMXA	Template:再選考
Category:Wadamada Aasiya	Category:アジアの国
Portal:Siyaasadda	Portal:政治学
Portal:Qaynuun	Portal:法学
Category:Abidjan	Category:アビジャン
Category:Antananarifo	Category:アンタナナリボ
Category:Bamako	Category:バマコ
Template:Colonne	Template:Multicol
Eray bixin	学術用語
Category:Esperanto	Category:エスペラント
Template:Lang-am	Template:Lang-am
Template:Lang-sv	Template:Lang-sv
Category:Garoomaha Ciyaaraha Soomaaliya	Category:ソマリアのサッカー競技施設
Khilaafadii Umawiyiinta	ウマイヤ朝
Portal:Kimistari	Portal:化学
Category:Linux	Category:Linux
Category:Siyaasada Soomaaliya	Category:ソマリアの政治
Category:Komunistiyaasha	Category:共産主義者
Category:Qiyaasaha Masaafooyinka	Category:長さの単位
Category:Midabada	Category:色
Category:Triboli	Category:トリポリ
Category:Bahalada sheeko xariirka	Category:人魚
Wikipedia:Habka Maqaalada Cusub	Wikipedia:Good article criteria
Template:Country data Somalia	Template:Country data Somalia
Template:Image label begin	Template:Image label begin
Category:Suuradaha Qur'aanka	Category:スーラ (クルアーン)
Category:User en-1	Category:User en-1
Portal:Caafimaad	Portal:医学と医療
Template:Afarta xilli	Template:季節
Wikipedia:Tutorial (Talk pages)	Wikipedia:チュートリアル ノートページ
Wikipedia:Tutorial (Keep in mind)	Wikipedia:チュートリアル 注意点
Template:User nl-3	Template:User nl-3
Template:Goob	Template:井戸端
Template:Infobox/row	Template:Infobox/row
Template:Wayback	Template:Wayback
Wikipedia:Tutorial (Wrap-up and more info)	Wikipedia:チュートリアル まとめ
Wikipedia:Tutorial (Registration)	Wikipedia:チュートリアル アカウント登録
Template:IPA-it	Template:IPA-it
Template:Significant figures	Template:Sigfig
Template:Larger	Template:Larger
Template:Ku saabsan wikipedia	Template:About Wikipedia
Template:Saxaafad	Template:Journalism
Template:For year month day	Template:For year month day
Template:Efn	Template:Efn
Template:Table cell templates	Template:Table cell templates
Template:Weather box/colpastel	Template:Infobox Weather/colpastel
Template:Xpda	Template:Xpda
Parvoviruses	パルボウイルス
Rooman	ローマ水道
Template:Documentation/template page	Template:Documentation/template page
Template:Weather box/oneline/date	Template:Infobox weather/oneline/date
Template:Infobox Weather/khad	Template:Infobox Weather/line
Template:Infobox Weather/colp	Template:Infobox Weather/colp
Template:Infobox Weather/colt	Template:Infobox Weather/colt
Template:UserName	Template:UserName
Template:Flagbig	Template:Flagbig
Template:Weather box/cols	Template:Infobox Weather/cols
Template:Liiska	Template:Do list
Template:D	Template:Em
Adnan Januzaj	アドナン・ヤヌザイ
Cabdiweli Sheekh Axmed	アブディウェリ・シェイハ・アフメド・モハメド
Barkhad Cabdi	バーカッド・アブディ
Special:RecentChanges	特別:最近の更新
Module:Navbox	モジュール:Navbox
Afarta Xili	四季
Category:Wabiyada Afrika	Category:アフリカの河川
