ئافرىقا	アフリカ
ياپونىيە	日本
جەنۇبىي ئامېرىكا	南アメリカ
نورۋېگىيە	ノルウェー
Shotlandiye	スコットランド
Wélsh	ウェールズ
ۋېنگرىيە	ハンガリー
ئىسپانىيە	スペイン
ئامېرىكا قوشما شىتاتلىرى	アメリカ合衆国
بېلگىيە	ベルギー
ليۇكسېمبۇرگ	ルクセンブルク
يەر شارى	地球
گېئورگى ۋاشىنگتون	ジョージ・ワシントン
فىنلاندىيە	フィンランド
شۋېتسىيە	スウェーデン
دانىيە	デンマーク
لەھىستان	ポーランド
لىتۋا	リトアニア
ئىتالىيە	イタリア
شۋېتسارىيە	スイス
ئاۋستىرىيە	オーストリア
گرېتسىيە	ギリシャ
تۈركىيە جۇمھۇرىيىتى	トルコ
پورتۇگالىيە	ポルトガル
ياۋروپا	ヨーロッパ
ئاسىيا	アジア
شىمالىي ئامېرىكا	北アメリカ
ۋىكىپېدىيە	ウィキペディア
گوللاندىيە	オランダ
Nyu York Shehiri	ニューヨーク
ۋاشىنگتون	ワシントンD.C.
San Fransisko	サンフランシスコ
Bérlin	ベルリン
Los Anjélés	ロサンゼルス
كومپيۇتېر	コンピュータ
بېرن	ベルン
Jenwe	ジュネーヴ
سيۇرىخ	チューリッヒ
خەلقارالىق تور	インターネット
باراك ئوباما	バラク・オバマ
ئۇرۇگۋاي	ウルグアイ
London	ロンドン
كايرو	カイロ
ئالما	リンゴ
پارىژ	パリ
مېكسىكا	メキシコ
Kaliforniye Shitati	カリフォルニア州
Boston	ボストン
مارس	火星
كېنىيە	ケニア
ئېفىئوپىيە	エチオピア
گانا جۇمھۇرىيىتى	ガーナ
شىر	ライオン
فرانسىيە	フランス
ئېسپېرانتو	エスペラント
ئىت	イヌ
بۈيۈك بېرىتانىيە	イギリス
مۈشۈك	ネコ
جۇڭخۇا خەلق جۇمھۇرىيىتى	中華人民共和国
فرانسۇز تىلى	フランス語
برازىلىيە	ブラジル
روسىيە	ロシア
قارا دېڭىز	黒海
Toronto	トロント
Alabama Shitati	アラバマ州
San Pawlo	サンパウロ
Kwébék	ケベック州
ۋىكىپېدىيە ۋەخپى	ウィキメディア財団
جىمى ۋالىس	ジミー・ウェールズ
گېرمانىيە	ドイツ
بېلورۇسسىيە	ベラルーシ
نېمىس تىلى	ドイツ語
ئىسلاندىيە	アイスランド
ئېستونىيە	エストニア
ساتۇرن	土星
ئايروپىلان	飛行機
جورج ۋولكېر بۇش	ジョージ・W・ブッシュ
لاتۋىيە	ラトビア
ئۇكرائىنا	ウクライナ
چېخ جۇمھۇرىيەتى	チェコ
سلوۋاكىيە	スロバキア
سلوۋېنىيە	スロベニア
مولدوۋا	モルドバ
رۇمىنىيە	ルーマニア
بۇلغارىيە	ブルガリア
Rim	ローマ
ماكېدونىيە	マケドニア共和国
ئالبانىيە	アルバニア
گرېنلاندىيە	グリーンランド
كرودىيە	クロアチア
بوسنىيە ۋە ھېرسېگوۋىنا	ボスニア・ヘルツェゴビナ
ئەزەربەيجان	アゼルバイジャン
ئاندوررا	アンドラ
سىپرۇس	キプロス
گرۇزىيە	グルジア
قازاقىستان	カザフスタン
مالتا	マルタ
موناكو	モナコ
چېرنوگورىيە	モンテネグロ
ۋاتىكان شەھىرى	バチカン
سان مارىنو	サンマリノ
Bryussél	ブリュッセル
كۇبا	キューバ
بېلىز	ベリーズ
باربادوس	バルバドス
ئاممىباپ ئاپتوموبىل	フォルクスワーゲン
ھىندونېزىيە	インドネシア
Wolfgang Amadeus Mozart	ヴォルフガング・アマデウス・モーツァルト
بىتخوۋىن	ルートヴィヒ・ヴァン・ベートーヴェン
تۈرك تىلى	トルコ語
جەنۇبىي ئافرىقا	南アフリカ共和国
ئالجىرىيە	アルジェリア
ئۆزبېكىستان	ウズベキスタン
Poznan	ポズナン
Tashkent	タシュケント
Warshawa	ワルシャワ
ياۋروۋىزىيون ناخشا مۇسابىقىسى	ユーロビジョン・ソング・コンテスト
تېلېۋىزور	テレビ
ئىسلاندىيە تىلى	アイスランド語
چىلى	チリ
ئەيسا مەسىھ	イエス・キリスト
گالىلېي	ガリレオ・ガリレイ
مېركۇرىي	水星
تارىخ	歴史
ئالما شىركىتى	アップル インコーポレイテッド
ۋېنېرا	金星
مۇھاببەت	愛
يۇپىتېر	木星
سامان يولى سىستىمېسى	銀河系
ئۇران (پلانىت)	天王星
نىكولا ساركوزى	ニコラ・サルコジ
نېپتۇن	海王星
ئاسترونومىيە	天文学
سىنگاپور	シンガポール
پلۇتون	冥王星
Montréal	モントリオール
لىختېنشتېين	リヒテンシュタイン
Kambrij	ケンブリッジ
Facebook	Facebook
بىرىنچى دۇنيا ئۇرۇشى	第一次世界大戦
Kolon	ケルン
سكوپليې	スコピエ
Shchétsin	シュチェチン
لاتىن تىلى	ラテン語
بەھرېيىن	バーレーン
ئەرمېنىيە	アルメニア
سېربىيە	セルビア
Istanbul	イスタンブル
ئاۋستىرالىيە	オーストラリア
فىزىكا	物理学
ئارگېنتىنا	アルゼンチン
پېرۇ	ペルー
بىئولوگىيە	生物学
شىمالىي چاۋشيەن	朝鮮民主主義人民共和国
كامبوجا	カンボジア
قۇرئان كەرىم	クルアーン
دىنوزاۋر	恐竜
ئىسلام دىنى	イスラム教
ليۇبليانا	リュブリャナ
Lion	リヨン
ياۋروپا ئىتتىپاقى	欧州連合
سوفىيە	ソフィア (ブルガリア)
شېئىر	詩
Milan	ミラノ
Turin	トリノ
سوڭ	肛門
ئېۋېرېست	エベレスト
ﻧﺎﭘﻮﻟﯧﺌﻮﻥ ﺑﻮﻧﺎﭘﺎﺭﺕ	ナポレオン・ボナパルト
ۋېزۇۋىي	ヴェスヴィオ
قۇياش	太陽
قۇياش سىستېمىسى	太陽系
ھىدروگېن	水素
گېلىي	ヘリウム
لىتىي	リチウム
بېرىللىي	ベリリウム
شەرقىي تىمور	東ティモール
ئوسلو	オスロ
Bonn	ボン
سېرېرا	ケレス (準惑星)
لىسبون	リスボン
ئېرىدا	エリス (準惑星)
دۇبائى	ドバイ
بور	ホウ素
Wérsayl	ヴェルサイユ
كاربون	炭素
ۋولگا دەرياسى	ヴォルガ川
ئازوت	窒素
ئوكسىگېن	酸素
مۇزىكا	音楽
Wénitsiye	ヴェネツィア
Rénn Shehiri	レンヌ
Lil	リール (フランス)
Moskwa	モスクワ
فىتور	フッ素
ئىتاليان تىلى	イタリア語
نىئون گازى	ネオン
Sankt-Pétérburg	サンクトペテルブルク
چاد	チャド
ناترىي	ナトリウム
ماگنىي	マグネシウム
ئاليۇمىن	アルミニウム
يېڭى زېلاندىيە	ニュージーランド
ھىندىستان	インド
سىلىتسىي	ケイ素
فرانسىي	フランシウム
Tuwalu	ツバル
فوسفور	リン
تۆمۈر	鉄
Ton’ga	トンガ
گۈڭگۈرت	硫黄
ساموئا	サモア
سولومون تاقىم ئاراللىرى	ソロモン諸島
ۋانۇئاتۇ	バヌアツ
خلور گازى	塩素
پاپۇئا يېڭى گۋىنېيە	パプアニューギニア
پالاۋ	パラオ
ئارگون	アルゴン
ناۋرۇ	ナウル
مىكرونېزىيە فېدېراتسىيىسى	ミクロネシア連邦
كالىي	カリウム
كالتىسىي	カルシウム
قوغۇشۇن	鉛
مارشال تاقىم ئاراللىرى	マーシャル諸島
كىرىباتى	キリバス
موڭغۇلىيە	モンゴル国
فىجى	フィジー
سكاندىي	スカンジウム
تىتان	チタン
ۋېنېسۇئېلا	ベネズエラ
چىڭگىزخان	チンギス・カン
ۋانادىي	バナジウム
Méané Shitati	メイン州
خروم	クロム
ئات	ウマ
ئامستېردام	アムステルダム
ھايۋانات	動物
سۇرىنام	スリナム
مانگان	マンガン
پاراگۋاي	パラグアイ
گايانا	ガイアナ
ئېكۋادور	エクアドル
رېنىي	レニウム
كولومبىيە	コロンビア
كوبالت	コバルト
ۋولفرام	タングステン
نىكېل	ニッケル
بۇددا دىنى	仏教
بولىۋىيە	ボリビア
مىس	銅
ترىنىداد ۋە توباگو	トリニダード・トバゴ
سېنت ۋىنسېنت ۋە گرېنادىن ئاراللىرى	セントビンセント・グレナディーン
سىنك	亜鉛
Yéngi Xampishir Shitati	ニューハンプシャー州
سېنت ليۇسىيە	セントルシア
داۋېىنچى	レオナルド・ダ・ヴィンチ
سېنت كىتس ۋە نېۋىس	セントクリストファー・ネイビス
زەمبۇرۇغ	菌類
يامايكا	ジャマイカ
گرېنادا	グレナダ
Massachuséts Shitati	マサチューセッツ州
گۋاتېمالا	グアテマラ
باھاما	バハマ
Konnéktikat Shitati	コネチカット州
ئانتىگۇئا ۋە باربۇدا	アンティグア・バーブーダ
Haway Shitati	ハワイ州
ھوندۇراس	ホンジュラス
دومىنىكا	ドミニカ国
دومىنىكان جۇمھۇرىيەتى	ドミニカ共和国
ھايتى	ハイチ
ئەل سالۋادور	エルサルバドル
ئىران	イラン
ئىراق	イラク
Alyaska Shitati	アラスカ州
كوستارىكا	コスタリカ
ئىسرائىلىيە	イスラエル
پاناما	パナマ
يەمەن	イエメン
پولەك تىلى	ポーランド語
ئىئوردانىيە	ヨルダン
نىكاراگۇئا	ニカラグア
Florida Shitati	フロリダ州
قىرغىزىستان	キルギス
Arizona Shitati	アリゾナ州
كۇۋەيت	クウェート
لائوس	ラオス
لىۋان	レバノン
Orégon Shitati	オレゴン州
مالدىۋ ئاراللىرى	モルディブ
ئامېرىكا قىتئەسى	アメリカ州
Yuta Shitati	ユタ州
مالايسىيا	マレーシア
بىرما	ミャンマー
نېپال	ネパール
ئومان	オマーン
پاكىستان	パキスタン
قاتار	カタール
سەئۇدى ئەرەبىستان	サウジアラビア
سرىلانكا	スリランカ
ستالىن	ヨシフ・スターリン
سۇرىيە	シリア
بىراتۇ	プラトン
گاللىي	ガリウム
تاجىكىستان	タジキスタン
تەيۋەن	中華民国
گېرمانىي	ゲルマニウム
تايلاند	タイ王国
ئارسېن	ヒ素
تۈركمەنىستان	トルクメニスタン
سېلېن	セレン
ئەرەب بىرلەشمە خەلىپىلىكى	アラブ首長国連邦
بروم	臭素
Platina	白金
ۋيېتنام	ベトナム
Nowosibirski	ノヴォシビルスク
جەنۇبىي چاۋشيەن	大韓民国
كرىپتون	クリプトン
ئافغانىستان	アフガニスタン
رۇبىدىي	ルビジウム
ئالتۇن	金
قازان	カザン
بانگلادېش	バングラデシュ
مالى	マリ共和国
ئانگولا	アンゴラ
بۇتان	ブータン
برۇنېي	ブルネイ
تانزانىيە	タンザニア
فىلىپپىن	フィリピン
ئوتتۇرا ئافرىقا جۇمھۇرىيىتى	中央アフリカ共和国
جەنۇبى قۇتۇپ	南極点
شىمالى قۇتۇپ	北極点
ئىسساك نيوتۇن	アイザック・ニュートン
ئالبېرىت ئېينىشتېين	アルベルト・アインシュタイン
سترونتسىي	ストロンチウム
ئىتترىي	イットリウム
ۋىسمۇت	ビスマス
سېرىق رەڭ	黄色
توگو	トーゴ
تۇنىس	チュニジア
زامبىيە	ザンビア
زىمبابۋې	ジンバブエ
بېيجىڭ شەھىرى	北京市
تۇۋا	トゥヴァ共和国
بېنىن	ベナン
بوتسۋانا	ボツワナ
بۇركىنا فاسو	ブルキナファソ
بۇرۇندى	ブルンジ
كومور ئاراللىرى	コモロ
كونگو جۇمھۇرىيىتى	コンゴ共和国
كونگو دېموكراتىك جۇمھۇرىيىتى	コンゴ民主共和国
San Antonio	サンアントニオ
جىبۇتى	ジブチ
پولونىي	ポロニウム
ئېكۋاتور گۋىنېيىسى	赤道ギニア
ئېرىترېيە	エリトリア
Yéngi Déhli	ニューデリー
تبىلىسى	トビリシ
ئاستاتىن	アスタチン
گابون	ガボン
گامبىيە	ガンビア
ۋىنېيە	ギニア
گۋىنېيە بىسسائۇ	ギニアビサウ
پىل چىشى قىرغىغى	コートジボワール
كامېرۇن	カメルーン
يېشىل تۇمشۇق ئاراللىرى	カーボベルデ
لېسوتو	レソト
لىبېرىيە	リベリア
لىۋىيە	リビア
ماداگاسكار	マダガスカル
مالاۋى	マラウイ
Shtutgart	シュトゥットガルト
ماۋرىتانىيە	モーリタニア
ماۋرىتىئۇس	モーリシャス
ماراكەش	モロッコ
موزامبىك	モザンビーク
نامىبىيە	ナミビア
نىگېر	ニジェール
نىگېرىيە	ナイジェリア
دارۋىن	チャールズ・ダーウィン
ئۇگاندا	ウガンダ
رۋاندا	ルワンダ
سىركونىي	ジルコニウム
San Tomé we Prinsipé	サントメ・プリンシペ
سېنېگال	セネガル
سېيشېل ئاراللىرى	セーシェル
سيېررا لېئونې	シエラレオネ
سومالى	ソマリア
نىئوبىي	ニオブ
جولیس سیزر	ガイウス・ユリウス・カエサル
سۇدان	スーダン
سۋازىلېند	スワジランド
مولبېدىن	モリブデン
تېخېتىسىي	テクネチウム
Hamburg	ハンブルク
گۇجارات	グジャラート州
بىرلەشكەن دۆلەتلەر تەشكىلاتى	国際連合
گېئولوگىيە	地質学
Exmetabad	アフマダーバード
يۈرەك	心臓
تېرە	皮膚
پراگا	プラハ
كۆك رەڭ	青
كۈمۈش	銀
قەلەي	スズ
ئۇران	ウラン
سۈرمە	アンチモン
پلوتونىي	プルトニウム
نېپتونىي	ネプツニウム
كسېنون	キセノン
سېزىي	セシウム
پروتاكتىنىي	プロトアクチニウム
بارىي	バリウム
تورىي	トリウム
گافنىي	ハフニウム
ئاكتىنىي	アクチニウム
تانتال	タンタル
بىل كلىنتون	ビル・クリントン
رادىي	ラジウム
رادون	ラドン
Bombay	ムンバイ
Michigan Shitati	ミシガン州
پوئېرتو رىكو	プエルトリコ
Illinoyiz Shitati	イリノイ州
Shimaliy Dakota Shitati	ノースダコタ州
لومبارد	ロンバルディア州
Jenubiy Dakota Shitati	サウスダコタ州
Montana Shitati	モンタナ州
Wyoming Shitati	ワイオミング州
قۇدس	エルサレム
Aydaxo Shitati	アイダホ州
Washin'giton Shitati	ワシントン州
رۇزېرفوردىي	ラザホージウム
Néwada shitati	ネバダ州
دۇبنىي	ドブニウム
سىبورگىي	シーボーギウム
بوھرىي	ボーリウム
ھاسسىي	ハッシウム
مېيتنېرىي	マイトネリウム
Kolorado Shitati	コロラド州
دارمستادتىي	ダームスタチウム
رۆنتگېنىي	レントゲニウム
كوپېرنىي	コペルニシウム
تۈر:تۈرلەر يولباشچىسى	Category:主要カテゴリ
ئاپېنىن تاغ تىزمىسى	アペニン山脈
ئالپ تاغلىرى	アルプス山脈
پاسكال	ブレーズ・パスカル
Gant	ヘント
Chikago	シカゴ
ئۇنۇنترىي	ウンウントリウム
فلېروۋىي	フレロビウム
ئۇنۇنپېنتىي	ウンウンペンチウム
لىۋىرمورىي	リバモリウム
ئۇنۇنسېپتىي	ウンウンセプチウム
ئۇنۇنئوكتىي	ウンウンオクチウム
Arném	アーネム
ئىسپان تىلى	スペイン語
مونتېۋىدېئو	モンテビデオ
Filadélfiye	フィラデルフィア
Kalkutta	コルカタ
Déhli	デリー
داكا	ダッカ
Ban'galor	バンガロール
Ömüchük	クモ
ئىسلامئاباد	イスラマバード
ظاصتاص يئضةن مئؤة	果実
مايمۇن	サル
Wirginiye Shitati	バージニア州
غەربىي ۋىرگىنىيە شىتاتى	ウェストバージニア州
Nyuyork Shitati	ニューヨーク州
سېرىي	セリウム
پرازېئودىمىي	プラセオジム
Rodé Arili Shitati	ロードアイランド州
نېئودىي	ネオジム
Maryland Shitati	メリーランド州
Délawiyer Shitati	デラウェア州
يېۋروپىي	ユウロピウム
Oxayo Shtati	オハイオ州
Pénsilwaniye Shitati	ペンシルベニア州
Yéngi Jérséy Shtati	ニュージャージー州
فىنلاندىيە تىلى	フィンランド語
Indiyanna Shitati	インディアナ州
ئاپتوموبىل	自動車
Giorgiye Shitati	ジョージア州
Zagréb	ザグレブ
Téksas Shitati	テキサス州
Jenubiy Karolina Shitati	サウスカロライナ州
سىتسىلىيە	シチリア
مانىلا	マニラ
ساردىنىيە ئارىلى	サルデーニャ
Bordo	ボルドー
Buénos Ayrés	ブエノスアイレス
مېكسىكا شەھىرى	メキシコシティ
توكيو	東京都
Barsélona	バルセロナ
Missisipi Shitati	ミシシッピ州
Ténnéssi Shitati	テネシー州
Astana	アスタナ
Yéngi Méksika Shitati	ニューメキシコ州
ئافېنا	アテネ
Minnésota Shitati	ミネソタ州
باغداد	バグダード
Karakas	カラカス
Wiskonsin Shitati	ウィスコンシン州
Puna	プネー
AC مىلان	ACミラン
Lowa Shitati	アイオワ州
Nébraska Shitati	ネブラスカ州
گۋاتېمالا شەھىرى	グアテマラシティ
Kanzas Shitati	カンザス州
ھىندى تىلى	ヒンディー語
ماراتىچە	マラーティー語
Missori Shitati	ミズーリ州
Loyizanna Shitati	ルイジアナ州
Kéntukki Shitati	ケンタッキー州
Arkanzas Shtati	アーカンソー州
ئوردو تىلى	ウルドゥー語
Oklaxoma Shitati	オクラホマ州
Potsdam	ポツダム
Hanofér	ハノーファー
Myunxén	ミュンヘン
Drézdén	ドレスデン
ۋالىبول	バレーボール
Wyéna	ウィーン
Kopénhagén	コペンハーゲン
Stokgolm	ストックホルム
Xélsinki	ヘルシンキ
دۇبلىن	ダブリン
رېيكياۋىك	レイキャヴィーク
Tallin	タリン
رىگا	リガ
براتىسلاۋا	ブラチスラヴァ
Budapésht	ブダペスト
Danzig	グダニスク
Frankfort	フランクフルト・アム・マイン
Wroklaw	ヴロツワフ
لانتان	ランタン
جۈي	プロメチウム
چالغا	サマリウム
گادولنىي	ガドリニウム
تېربىي	テルビウム
Katolik dini	カトリシズム
ليۇكسېمبۇرگ شەھىرى	ルクセンブルク (都市)
دىسپروزىي	ジスプロシウム
ۋادۇز	ファドゥーツ
ئىنجىل	聖書
گولمىي	ホルミウム
ئېربىي	エルビウム
فنوم پېن	プノンペン
تۇلىي	ツリウム
سايگون	ホーチミン市
ئىتتېربىي	イッテルビウム
لۇتېتسىي	ルテチウム
خانوي	ハノイ
ھەقىقى ئەيسا چېركاۋى	真イエス教会
ئىنگىلىز تىلى	英語
Bangkok	バンコク
ئاندوررا كەنتى	アンドラ・ラ・ベリャ
كۇئالالۇمپۇر	クアラルンプール
تەيبېي شەھىرى	台北市
ئامېرىتسىي	アメリシウム
كىيۇرىي	キュリウム
Concepción, Chile	コンセプシオン (チリ)
بېركېلىي	バークリウム
كالىفورنىي	カリホルニウム
ئېينشتېينىي	アインスタイニウム
فېرمىي	フェルミウム
مېندېلېيېۋىي	メンデレビウム
كىيېۋ	キエフ
نوبېلىي	ノーベリウム
لاۋرېنسىي	ローレンシウム
كارېلىيە	カレリア共和国
Ottawa	オタワ
Manitoba Ölkisi	マニトバ州
Albérta	アルバータ州
Nowa Skotiye Ölkisi	ノバスコシア州
يېرېۋان	エレバン
دارېسسالام	ダルエスサラーム
خارتۇم	ハルツーム
Yéngi Brunswik Ölkisi	ニューブランズウィック州
Britani Kolumbiye	ブリティッシュコロンビア州
Saskachéwan	サスカチュワン州
Néwfundland Ölkisi	ニューファンドランド・ラブラドール州
Gherbiy Shimal Rayoni	ノースウエスト準州
Yukon Rayoni	ユーコン準州
Florénsa	フィレンツェ
Ésén	エッセン
كومى	コミ共和国
Léypzig	ライプツィヒ
Nyurnbérg	ニュルンベルク
Édmonton	エドモントン
Man'géym	マンハイム
Wiktoriye, Britani Kolumbiye	ビクトリア (ブリティッシュコロンビア州)
Winnipég	ウィニペグ
Halifaks	ハリファックス
Kwébék Shehiri	ケベック・シティー
ئېلېكترون	電子
Birmin'gxam	バーミンガム
مىنىسكى	ミンスク
مىكروسوفىت شىركىتى	マイクロソフト
پروتون	陽子
Kurow	クルフ
Naplés	ナポリ
Braunshwéyg	ブラウンシュヴァイク
Madrid	マドリード
سۇ ئاستى كېمىسى	潜水艦
مايكېل جېكسۇن	マイケル・ジャクソン
Bogota	ボゴタ
لىما	リマ
Santiyago	サンティアゴ (チリ)
كىتو	キト
سۇكرې	スクレ (ボリビア)
ئاسۇنسىئون	アスンシオン
Öçke	ヤギ
Héydélbérg	ハイデルベルク
كاتماندۇ	カトマンズ
سان خوسې (كوستارىكا)	サンホセ (コスタリカ)
سان سالۋادور	サンサルバドル
Kanbérra	キャンベラ
Sidnéy	シドニー
يېشىل رەڭ	緑
Mélburn	メルボルン
قىزىل رەڭ	赤
ماناگۇئا	マナグア
رابات	ラバト
قۇيرۇقلۇق يۇلتۇز	彗星
ئالجىر	アルジェ
تۇنىس شەھىرى	チュニス
ترىپولى	トリポリ
تېھران	テヘラン
جاكارتا	ジャカルタ
Enqere	アンカラ
رىياد	リヤド
بېلگراد	ベオグラード
ئادىگېيە	アディゲ共和国
پرايا	プライア
دەمەشىق	ダマスカス
يامۇسسۇكرو	ヤムスクロ
فرانسىيىگە قاراشلىق گۋىئانا	フランス領ギアナ
لومې	ロメ
ئاممان	アンマン
بېيرۇت	ベイルート
مۇسكات	マスカット
نىكوسىيە	ニコシア
دوھا	ドーハ
نايروبى	ナイロビ
لۇساكا	ルサカ
ئامازون	Amazon.com
قۇياش تۇتۇلۇشى	日食
كامپالا	カンパラ
Mektep	学校
ھارارې	ハラレ
Prétoriye	プレトリア
Astiraxan	アストラハン
Tiktak top	卓球
Wikipedia:Sandbox	Wikipedia:サンドボックス
قالماقىستان	カルムイク共和国
Osasko	オザスコ (サンパウロ州)
Glasgow	グラスゴー
Kuritiba	クリチバ
Orman	森林
بوغاز كۆۋرۈكى	ボスポラス橋
كۇڭزى	孔子
كوربين بيلو	コービン・ブルー
Surat	スーラト
ياۋرۇ	ユーロ
ئامېرىكا دولىرى	アメリカ合衆国ドル
يەر ئوتتۇرا دېڭىزى	地中海
خاڭجۇ شەھىر	杭州市
مەسىھچىلىك	キリスト教
قېلىپ:ئاسىيا	Template:アジア
Séatl	シアトル
Baltimor	ボルチモア
ئادېلايدې	アデレード
داغىستان	ダゲスタン共和国
Monzón	モンソン
گۇجارات تىل	グジャラート語
پورتۇگال تىلى	ポルトガル語
مۇستاپا كامال	ムスタファ・ケマル・アタテュルク
چېچېنىيە	チェチェン共和国
كۋېچۇئا تىلى	ケチュア語
ئىنگۇشېتىيە	イングーシ共和国
شىمالىي ئوسېتىيە	北オセチア共和国
كاباردىنو-بالقارىستان	カバルダ・バルカル共和国
ئالماس	ダイヤモンド
ياپون تىلى	日本語
Énsklopédiye	百科事典
ئۇيغۇرچە ۋىكىپىدىيە	メインページ
Latex	LaTeX
كوندېنساتور	コンデンサ
قاراچاي-چېركېسىيە	カラチャイ・チェルケス共和国
موردوۋىيە	モルドヴィア共和国
ۋاسكېتبول	バスケットボール
چاڭجياڭ دەرياسى	長江
ئۇدمۇرتىيە	ウドムルト共和国
مارى	マリ・エル共和国
ھىمالايا تاغ تىزمىسى	ヒマラヤ山脈
ئاند تاغلىرى	アンデス山脈
قىيىلىق تاغلار	ロッキー山脈
Kapétown	ケープタウン
چۇۋاشىيە	チュヴァシ共和国
تەڭرىتاغ	天山山脈
كاۋكاز تاغ تىزمىسى	コーカサス山脈
تاتارىستان	タタールスタン共和国
1279-يىلى	1279年
ۋېىنىست	フィンセント・ファン・ゴッホ
باشقۇرتىستان	バシコルトスタン共和国
Semerqend	サマルカンド
Buxara	ブハラ
بېتلېخېم	ベツレヘム
Andalusiye	アンダルシア州
كايمان تاقىم ئاراللىرى	ケイマン諸島
Kordowa	コルドバ
شىئەن شەھىرى	西安市
كابۇل	カーブル
لاسا شەھىرى	ラサ市
غىلاپ	膣
تامىل تىلى	タミル語
پەلسەپە	哲学
ئالەم ئايرۇپىلانى	宇宙飛行
ئالتاي تاغ تىزمىسى	アルタイ山脈
تۈر:Candidates for speedy deletion	Category:即時削除対象のページ
ئالتاي	アルタイ共和国
پىئانىنو	ピアノ
Hebe Camargo	ヘーペ・カマルゴ
Portland, Orégon	ポートランド (オレゴン州)
ئانارخىزم	アナキズム
لىبېرالىزىم	自由主義
فاشىسىت	ファシズム
مىللەتچىلىك	ナショナリズム
غەربىي ساھارا	西サハラ
ھىلاري كلىنتون	ヒラリー・クリントン
خاكاسىيە	ハカス共和国
Strasburg	ストラスブール
ياكۇتىيە	サハ共和国
كرودىيە تىلى	クロアチア語
گائۇس	カール・フリードリヒ・ガウス
بۇرياتىيە	ブリヤート共和国
جامىس جويىس	ジェイムズ・ジョイス
كاتالان تىلى	カタルーニャ語
Burχa	仏陀
دىنسىزلىق	無神論
لى بەي	李白
دۇنيا بانكىسى	世界銀行
كونسېرۋاتىپ	保守
شىمالىي ئاتلانتىك ئەھدى تەشكىلاتى	北大西洋条約機構
نوبېل مۇكاپاتى	ノーベル賞
چىن شىخۇاڭ	始皇帝
خەن سۇلالىسى	漢
فېمىنىزم	フェミニズム
ئىدېئولوگىيە	イデオロギー
پەي توپ	バドミントン
يۈەن سۇلالىسى	元 (王朝)
كولۇمبو	クリストファー・コロンブス
يەھۇدىلار	ユダヤ人
سېرىق دەريا	黄河
قۇلاق	耳
بۇرۇن	鼻
كۆز	目
مۇسكۇل	筋肉
Töge	ラクダ
پىل	ゾウ
چۈمۈلە	アリ
سۈي سۇلالىسى	隋
گوللاندىيە تىلى	オランダ語
ماگرىت ساچىر	マーガレット・サッチャー
ياڭ جىيەن	楊堅
دېئوكسىرىبونۇكلېئىك كىسلاتا	デオキシリボ核酸
سۇڭ سۇلالىسى	宋 (王朝)
Çeyze	ナス
رۇس تىلى	ロシア語
ساخالىن	樺太
نېفىت ئېكىسپورت قىلغۇچى دۆلەتلەر تەشكىلاتى (OPEC)	石油輸出国機構
خەلقئارا پۇل فوندى تەشكىلاتى	国際通貨基金
دۇنيا سودا تەشكىلاتى	世界貿易機関
سۋاھىلىچە	スワヒリ語
توكيو ئۇنىۋېرستېتى	東京大学
خەنزۇ تىلى	中国語
ئۆپكە	肺
نەپەسلىنىش سىستېمى	呼吸器
رۇمىنىيە تىلى	ルーマニア語
بۇلغارىيە تىلى	ブルガリア語
يەر تەۋرەش	地震
ماگادان	マガダン
تەبىئىي پەن	自然科学
فرانكلىن روزۋېلت	フランクリン・ルーズベルト
ﺋﯩﺒﯩﻦ ﺳﯩﻨﺎ	イブン・スィーナー
نىلسۇن ماندىلا	ネルソン・マンデラ
مارتىن لوتىر كىڭ	マーティン・ルーサー・キング・ジュニア
Yanardag	火山
ئىسسىق بەلباغ سىكلونى	熱帯低気圧
تېلۇگۇ تىلى	テルグ語
گرۇزىن تىلى	グルジア語
ئىقتىسادشۇناسلىق	経済学
يېن	円 (通貨)
قىزىل تۈلكە	アカギツネ
ئىسكىرىپكا	ヴァイオリン
چوڭ ئىسكىروپكا	チェロ
ئىسكەندەر زۇلقەرنەيىن	アレクサンドロス3世
ئۆمەر ئىبنى خەتتاب	ウマル・イブン・ハッターブ
ئامۇ دەرياسى	アムダリヤ川
سۈت	乳
سۇن جۇڭشەن	孫文
شياڭگاڭ	香港
Miami	マイアミ
كاراچى	カラチ
Rio dé Janéyro	リオデジャネイロ
سوغۇق ئۇرۇش	冷戦
شاڭخەي شەھىرى	上海市
Bilbaw	ビルバオ
Séwéliye	セビリア
چىڭ سۇلالىسى	清
توماس ئىدىسون	トーマス・エジソン
ئالبان تىلى	アルバニア語
باسكى تىلى	バスク語
ئاراگون تىلى	アラゴン語
ئەرمەن تىلى	アルメニア語
ئۇكرائىن تىلى	ウクライナ語
Walénsiye	バレンシア (スペイン)
Malaga	マラガ
شۋېتسىيە تىلى	スウェーデン語
دانىش تىلى	デンマーク語
نورۋېگىيە تىلى	ノルウェー語
ليۇكسېمبۇرگ تىلى	ルクセンブルク語
چېخ تىلى	チェコ語
سلوۋاك تىلى	スロバキア語
كارل ماركىس	カール・マルクス
سلوۋېن تىلى	スロベニア語
ماجار تىلى	ハンガリー語
ۋولتىر	ヴォルテール
ئېستون تىلى	エストニア語
لاتۋىيە تىلى	ラトビア語
لىتۋا تىلى	リトアニア語
ھىندى دىنى	ヒンドゥー教
بېلورۇس تىل	ベラルーシ語
يېلىن	乳房
ئاتوم	原子
گرېك تىلى	ギリシア語
ئرېلاندىيە تىلى	アイルランド語
مالتا تىلى	マルタ語
پارس تىلى	ペルシア語
ئىسلام	宗教
كورىيەچە	朝鮮語
Injilning birinchi tomi	創世記
كانتونچە	広東語
ئېكسودۇس	出エジプト記
ۋيېتنام تىلى	ベトナム語
كخمېر تىلى	クメール語
لائوس تىلى	ラーオ語
تايلاندچە	タイ語
بىرما تىلى	ビルマ語
مالاي تىلى	マレー語
ھىندونېزىيە تىلى	インドネシア語
موڭغۇل تىلى	モンゴル語
Baku	バクー
قازاق تىلى	カザフ語
قىرغىز تىلى	キルギス語
تاجىك تىلى	タジク語
ئۆزبېك تىلى	ウズベク語
تۈركمەن تىلى	トルクメン語
يەھۇدى دىنى	ユダヤ教
تىمپۇ	ティンプー
باندار سەرى بەگاۋان	バンダルスリブガワン
ئىبرانى تىلى	ヘブライ語
ئەزەربەيجان تىلى	アゼルバイジャン語
ماكېدون تىلى	マケドニア語
سېرب تىلى	セルビア語
سېربو-كرودىيىلىكلەر تىلى	セルビア・クロアチア語
بوسنىيە تىلى	ボスニア語
گالىسىيەچە	ガリシア語
ۋېلش تىلى	ウェールズ語
دىلى	ディリ
شوتلاندىيە گائېل تىلى	スコットランド・ゲール語
Wyéntyan	ヴィエンチャン
مالې	マレ
Bishkek	ビシュケク
Düshenbe	ドゥシャンベ
جىگەر	肝臓
تلا	脾臓
بۆرەك	腎臓
دوۋساق	膀胱
نېرۋا سىستىمېسى	神経系
ئوكيانىيە	大洋
مۇھەممەد ئەلەيھىسسالام	ムハンマド・イブン＝アブドゥッラーフ
ئىمام ئەلغازالىي	ガザーリー
رىچارد نىكسون	リチャード・ニクソン
قورساق قىسم	腹
داۋجياۋ دىنى	道教
سوپىزم (تەسەۋۋۇپ)	スーフィズム
ۋېنا تومۇرى	静脈
بېنگال تىلى	ベンガル語
تىل	舌
پانكرېئاتىت	膵臓
بويۇن	首
ئېغىز بوشلۇقى	口
بوغۇز	喉頭
فالكلاند تاقىم ئاراللىرى	フォークランド諸島
سازاڭسىمان ئۆسۈكچە	虫垂
ئېلىزابېت II	エリザベス2世
تاڭ سۇلالىسى	唐
كېننېدى	ジョン・F・ケネディ
تاڭ تەيزوڭ	太宗 (唐)
بالزاك	オノレ・ド・バルザック
مىڭ سۇلالىسى	明
جۇ يۈەنجاڭ	朱元璋
رېگان	ロナルド・レーガン
زۇلۇچە	ズールー語
زازا تىلى	ザザキ語
پلازما	プラズマ
رىم گىلادىئاتورلار مەيدانى	コロッセオ
Saragossa	サラゴサ
Bélfast	ベルファスト
ئېلېمېنتلارنىڭ دەۋرىي جەەدۋىلى	周期表
قۇرۇق ئۈزۈم	ブドウ
ھەسەل	蜂蜜
شېكەر	砂糖
روبوت	ロボット
ماشىنىسازلىق	機械
ئايلىنىش سىستېمىسى	循環器
ئىچكى ئاجراتما سىستېمىسى	内分泌器
كىسلاتا	酸
سارايېۋو	サラエヴォ
تۇز	塩
فۇنكسىيە	関数 (数学)
مولېكۇلا	分子
ئېنېرگىيە	エネルギー
ئىنفرا قىزىل نۇر	赤外線
ماسسا	質量
مېتال	金属
پولات	鋼
نانو تېخنىكىسى	ナノテクノロジー
ئەينەك	ガラス
ۋاكۇئۇم	真空
ئېلېكترون ئىلمى	電子機器
.توك (توك ئېقىمى)	電流
ئىككى پۇتلۇق لامپا	ダイオード
ئامېرىكىغا قاراشلىق ۋىرگىن تاقىم ئاراللىرى	アメリカ領ヴァージン諸島
شېنياڭ شەھىرى	瀋陽市
چۇڭچىڭ شەھىرى	重慶市
تيەنجىن شەھىرى	天津市
Lahor	ラホール
ۋۇخەن شەھىرى	武漢市
نۆۋەتتىكى ھادىسە	国の一覧
ناگويا	名古屋市
تاش قورال دەۋرى	石器時代
ئېيىق	クマ
فوتوسىنتېز رولى	光合成
برېتون تىلى	ブルトン語
پىرېنېي تاغلىرى	ピレネー山脈
Détroyt	デトロイト
بۇرج دۇبەي	ブルジュ・ハリファ
Sedichin Sépili	万里の長城
ئاياسوڧيا	アヤソフィア
ئابباسىيلار خاندانلىقى	アッバース朝
سەلىپنىڭ شەرققە يۈرۈش قىلىشى	十字軍
موڭغۇل ئىمپېرىيىسى	モンゴル帝国
ئوسمان ئىمپېرىيىسى	オスマン帝国
ئىسپانىيە-ئامېرىكا ئۇرۇشى	米西戦争
مىللى دارامەت	国内総生産
ئېلېكتر	電気
يادرو ئېنېرگىيىسى	原子力
ھور ماشىنىسى	蒸気機関
Antwérp	アントウェルペン
باش سۆڭىكى	頭蓋骨
ئانار	ザクロ
ئاپېلسىن	オレンジ
دۇنيا تىلى	ロマンシュ語
جۇاڭزۇ تىلى	チワン語
شىبە تىلى	シベ語
ئۇيغۇر تىلى	ウイグル語
سىنگال تىلى	シンハラ語
ناخۇئاتل تىلى	ナワトル語
مونتسەررات	モントセラト
خارۋارد ئۇنىۋېرسىتېتى	ハーバード大学
Pisa	ピサ
باشقۇرتچە	バシキール語
قېلىپ:Location map Earth	Template:Location map Earth
باغلانغان ئۆردەك	カナール・アンシェネ
ئەرەب تىلى	アラビア語
كيۇسيۇ ئارىلى	九州
خونسيو ئارىلى	本州
شىكوكۇ	四国
كورسىكا ئارىلى	コルシカ島
ئاڧرىقانچە	アフリカーンス語
بۆرە بورسۇق	クズリ
ئاۋمېن	マカオ
خۇ جىنتاۋ	胡錦濤
شى جىنپىڭ	習近平
زىراپە	キリン
شېنجېن شەھىرى	深セン市
گۇئاڭدوڭ ئۆلكىسى	広東省
گۇاڭشى جۇاڭزۇ ئاپتونۇم رايونى	広西チワン族自治区
سوۋېت ئىتتىپاقى	ソビエト連邦
شياڭگاڭ ئۇنىۋېرستېتى	香港大学
شياڭگاڭ جۇڭگو تىللىرى ئۇنۋېرسىتېتى	香港中文大学
رۇبلى	ルーブル
پۇت	足
دولا	肩
قالقانبەز	甲状腺
قېلىپ:Link FA	Template:Link FA
Wikipedia:Tor Jamiyeti	Wikipedia:井戸端
Wérmont Shitati	バーモント州
San Diyégo	サンディエゴ
San Xosé	サンノゼ
Dénwér	デンバー
Hyuston	ヒューストン
Féniks	フェニックス (アリゾナ州)
Dallas	ダラス
Austin	オースティン
Mémfis, Ténnéssi	メンフィス (テネシー州)
Sharlot	シャーロット (ノースカロライナ州)
Kolumbu, Oxéo	コロンバス (オハイオ州)
گۇاڭجۇ شەھىرى	広州市
جىياڭ جىشى	蒋介石
ۋېن جىياباۋ	温家宝
Guam Aril	グアム
ئامېرىكىغا قاراشلىق ساموئا	アメリカ領サモア
شىمالىي مارىئانا فېدېراتسىيىسى	北マリアナ諸島
نەنجىڭ شەھىرى	南京市
بېيجىڭ ئۇنىۋېرسىتېتى	北京大学
ئۈرۈمچى شەھىرى	ウルムチ市
جياڭسۇ ئۆلكىسى	江蘇省
جېجياڭ ئۆلكىسى	浙江省
گۇئادەلوپە	グアドループ
مارتىنىكا	マルティニーク
شىزاڭ ئاپتونوم رايونى	チベット自治区
دالاي لاما	ダライ・ラマ14世
تۆگىقۇش	ダチョウ
Sakraménto	サクラメント (カリフォルニア州)
چاۋشيەن	朝鮮
لى كېچياڭ	李克強
Manchéstér	マンチェスター
تۇركس ۋە كايكوس تاقىم ئاراللىرى	タークス・カイコス諸島
ۋىتامىن A	ビタミンA
ياۋروپا چىمپيونلۇق لوڭقىسى	UEFAチャンピオンズリーグ
Pyongyang	平壌
New Testament	新約聖書
ئادالەت ۋە تەرەققىيات پارتىيىسى	公正発展党
گۈللىنىش پارتىيىسى	共和人民党
مىللى دارامەت بويىچە دۆلەت تەرتىپى	国の国内総生産順リスト (為替レート)
خېيلوڭجياڭ ئۆلكىسى	黒竜江省
ما يىنجىئۇ	馬英九
بۇخارېست	ブカレスト
پوئىرتورىكان مۇستەقىللىق پارتىيىسى	プエルトリコ独立党
Tirana	ティラナ
ئېشەك	ロバ
سىچۈەن ئۆلكىسى	四川省
مۇھەممەر قەززافى	ムアンマル・アル＝カッザーフィー
بارس	トラ
چۆپ ئاش	ヴェルミチェッリ
سامسۇڭ گۇرۇھى	サムスングループ
شىمالىي ياۋروپا	スカンディナヴィア
كىشىنېۋ	キシナウ
بیلگیسايار مۈھەندیسلیغی	計算機科学
Şalom	シャーローム (週刊紙)
ئارۇبا	アルバ
خېبېي ئۆلكىسى	河北省
پرىنسېتون ئۇنىۋېرستېتى	プリンストン大学
نېفىت	石油
پېنسىلۋانىيە نېمىس تىلى	ペンシルベニアドイツ語
پرژىۋالسكى ياۋا ئات	モウコノウマ
قوي	ヒツジ属
ئىرلاندىيە	アイルランド島
Chéshir	チェシャー
Nortumbér Wilayiti	ノーサンバーランド (イングランド)
Staffordshir	スタッフォードシャー
ﻟﯘﺷﯜﻥ	魯迅
Shimaliy Amptonshir	ノーサンプトンシャー
Bédfordshir	ベッドフォードシャー
Kornwél	コーンウォール
Bristol	ブリストル
Déwonshir	デヴォン
خالتىلىق چاشقانلار ئائىلىسى	カンガルー
Nashwil	ナッシュビル
Xampishir	ハンプシャー
Bérkshir	バークシャー
Bukkinxamshir	バッキンガムシャー
Ésséks	エセックス
Ként	ケント (イングランド)
Ulanbatur	ウランバートル
ئېرنېست ھېمىڭۋاي	アーネスト・ヘミングウェイ
Idinburg	エディンバラ
ئاشخاباد	アシガバート
پىياز	タマネギ
پەمىدۇر	トマト
جورج بۇش	ジョージ・H・W・ブッシュ
بالقانلار	バルカン半島
پروتېستانت دىنى	プロテスタント
سەلەنا	セレナ (歌手)
Atlanta	アトランタ
بېرمۇدا	バミューダ諸島
باش	頭
ۋېللىنگتون	ウェリントン
روبوتلارنىڭ ئۈچ قانۇنى	ロボット工学三原則
ئالفېرد نوبىل	アルフレッド・ノーベル
لیلا چڑھاو	リラ・ダウンズ
907-يىلى	907年
Wankuwér	バンクーバー (ブリティッシュコロンビア州)
Liwérpol	リヴァプール
Brémén	ブレーメン
يېڭى نورۋېگىيە تىلى	ニーノシュク
پوند ستېرلىڭ	スターリング・ポンド
ئانگۋىللا	アンギラ
فائېروس تىل	フェロー語
مۈشۈك ئائىلىسى	ネコ科
ISO 3166-1	ISO 3166-1
تاتار تىلى	タタール語
ئەنگلىيىگە قاراشلىق ۋىرگىن تاقىم ئاراللىرى	イギリス領ヴァージン諸島
كىچىك سېسىق كۈزەنى	イイズナ
فرىزانچە	フリジア語
ئاق ئاغمىخان	オコジョ
قارشىلىق	電気抵抗
ناۋاسسا ئاراللىرى	ナヴァッサ島
سېنت بارتھېلەمي ئاراللىرى	サン・バルテルミー島
شىمالىي گېرمانىيە دىئالېكتى	低地ドイツ語
ئاغمىخان ئائىلىسى	イタチ科
ساينت مارتىن	セント・マーチン島
بۆكەن	レイヨウ
قارا بۇلغۇن	クロテン
سۈنئىي ھەمراھ	人工衛星
قوتاز	ヤク
ب م ۋ	BMW
Kuk Taqim Aralliri	クック諸島
رەشىدە داتى	ラシダ・ダティ
شەرقىي ئاسىيا	東アジア
ئوتتۇرا ئاسىيا	中央アジア
ئاق تۆش بۇلغۇن	ムナジロテン
ئامخارا تىلى	アムハラ語
Képinek	チョウ目
چاچ	毛 (動物)
ھىجرىيە كالېندارى	ヒジュラ暦
جيامۇسى شەھىرى	ジャムス市
كەبەك	ケベク
دىرىخلې	ペーター・グスタフ・ディリクレ
ئاستۇرىيە تىلى	アストゥリアス語
خىتاي	中国
قاما	ユーラシアカワウソ
چېڭدۇ شەھىر	成都市
يىلپىز	ユキヒョウ
جېڭجۇ شەھىرى	鄭州市
تېرېسا ئانا	マザー・テレサ
DELL شىركىتى	デル
فرانسىيىگە قاراشلىق پولىنېزىيە	フランス領ポリネシア
618-يىلى	618年
روژدېستۋو ئاراللىرى	クリスマス島 (オーストラリア)
Krakow	クラクフ
بېيجىڭ پايتەخت ئايروپورتى	北京首都国際空港
تىراختور	トラークトゥール・サーズィーFC
ۋېنىسىيە تىلى	ヴェネト語
تەيۋەن ئۇنۋېرسىتې	国立台湾大学
جامى	モスク
تۇڭگان تىلى	ドンガン語
كورسىكا تىلى	コルシカ語
فىلىپىنچە	フィリピン語
چۇۋاش تىلى	チュヴァシ語
قرىم تاتار تىلى	クリミア・タタール語
ھايتى كرېئول تىلى	ハイチ語
قارا قالپاق تىلى	カラカルパク語
ياۋا تىلى	ジャワ語
مۈشۈكئېيىق	ジャイアントパンダ
قالماق تىلى	カルムイク語
مانجۇ تىلى	満州語
كانناداچە	カンナダ語
مۇڭغۇل تىللىرى	モンゴル諸語
پوچېركا	手
دۇفۇ	杜甫
يېڭى كالېدونىيە	ニューカレドニア
ئورىياچە	オリヤー語
نېپال تىلى	ネパール語
نېئاپول تىلى	ナポリ語
نورمان تىلى	ノルマン語
تېئودور روزېۋېلت	セオドア・ルーズベルト
تېلاۋىف	テルアビブ
Nis	ニース
سالار تىلى	サラール語
سىتسىلىيە تىلى	シチリア語
ساردىنىيە تىلى	サルデーニャ語
ژىيۇل ۋېرن	ジュール・ヴェルヌ
سىندى تىلى	シンド語
سۇندا تىلى	スンダ語
شونا تىلى	ショナ語
Niué Arili	ニウエ
تاگالوگ تىلى	タガログ語
تۈركى تىللار ئائىلىسى	テュルク諸語
تونگاچە	トンガ語 (ポリネシア)
ئۇرال تىللىرى	ウラル語族
تىگرىنىيەچە	ティグリニャ語
Oksford	オックスフォード
تۇنگۇس مانجۇ تىللىرى	ツングース諸語
زاڭزۇ تىلى	チベット語
سارى ئۇغۇر	ユグル族
ۋۇ تىلى	呉語
ۋىلسون	ウッドロウ・ウィルソン
ياقۇت تىلى	サハ語
يورۇباچە	ヨルバ語
سېسوتوچە	ソト語
Rottérdam	ロッテルダム
Yéngi Orléan	ニューオーリンズ
فۇشەن شەھىر	仏山市
ئوكسفورد ئۇنىۋېرسىتېتى	オックスフォード大学
ئەھمىدى نىجات	マフムード・アフマディーネジャード
Saynt Xéléna Arili	セントヘレナ
بارماق	指
ساينت پىئېر ئارىلى ۋە مىكېلون تاقىم ئاراللىرى	サンピエール島・ミクロン島
ئون پەرھىز	モーセの十戒
Yohannésburg	ヨハネスブルグ
قاپلان	ヒョウ
Saltzburg	ザルツブルク
X نۇرى	X線
شىنجاڭ ئۇيغۇر ئاپتونوم رايونى	新疆ウイグル自治区
Albukwér kwé	アルバカーキ
Oklaxoma Shehiri	オクラホマシティ
برىسبان	ブリスベン
ئىسساك ئاسىموۋ	アイザック・アシモフ
جەنۇبىي گىئورگىيە ۋە ساندۋىچ ئاراللىرى	サウスジョージア・サウスサンドウィッチ諸島
كۇۋائىت شەھىرى	クウェート市
ئەرەبلەر	アラブ人
سۇمېرلار	シュメール
كولومبو	コロンボ
ئالمۇتا	アルマトイ
قانداغاي	ヘラジカ
ۋاللىس ۋە فۇتۇنا تاقىم ئاراللىرى	ウォリス・フツナ
تاتار مىللىتى	タタール
خوككايدو ئارىلى	北海道
ئۇرال تاغلىرى	ウラル山脈
ماددا	物質
ئوساكا	大阪市
كامبرىج ئۇنىۋېرستېتى	ケンブリッジ大学
ئاكا-ئۇكا رايتلار	ライト兄弟
گۇئارانچە	グアラニー語
شور دېڭىز	アラル海
ئىستانبۇل بوغازى	ボスポラス海峡
Izmir	イズミル
كەئەلىڭ كوكوس تاقىم ئاراللىرى	ココス諸島
مېرسېدېس - بېنز	メルセデス・ベンツ
كۋېنسلاند	クイーンズランド州
Minnéapolis	ミネアポリス
دەرەخ خالتىلىق ئېيىقى	コアラ
2011-يىلدىكى ياپونىيە يەر تەۋرەش ۋە دېڭىز تاشقىنى	東北地方太平洋沖地震
لىنگالاچە	リンガラ語
مالايالامچە	マラヤーラム語
يىپەك يولى	シルクロード
Kalgari	カルガリー
ئوستىيىن	ジェーン・オースティン
قوڭۇر ئېيىق	ヒグマ
كۇرد تىلى	クルド語
مولداۋىيە تىلى	モルドバ語
يېڭى تاش قۇرال دەۋرى	新石器時代
مورېسبى پورتى	ポートモレスビー
خىمىيىلىك رېئاكسىيە	化学反応
لاھەي	デン・ハーグ
جۇاڭزۇ مىللىتى	チワン族
ئوسمانلى تۈركچىسى	オスマン語
يۇھاننا بايان قىلغان خۇش خەۋەر	ヨハネによる福音書
توكېلاۋ تاقىم ئاراللىرى	トケラウ
چاغاتاي ئۇيغۇر يېزىقى	チャガタイ語
تۋىچە	アサンテ方言
چېڭلۇڭ	ジャッキー・チェン
توخار تىلى	トカラ語
ئېلان	広告
Zeytun	オリーブ
ئاۋكلاند	オークランド (ニュージーランド)
سەككىز دۆلەت گۇرۇھى (G8)	主要国首脳会議
ئاۋكادۇر	アボカド
قىزىل قان دانىچىلىرى	赤血球
ئوقۇتقۇچى	教員
تىز	膝
ئۆرۈك	アンズ
گلۇكوزا	グルコース
Sint-Truiden	シント＝トロイデン
ئالتاي تىللىرى سىستېمىسى	アルタイ諸語
ناتالىيە پورتمەن	ナタリー・ポートマン
Ran'gon	ヤンゴン
ناگاساكى	長崎市
يوكوخاما	横浜市
ئادانا	アダナ
لازېر نۇرى	レーザー
Lyuju shehiri	柳州市
خەلق پۇلى يۈەنى	人民元
Ritis	リーズ
رەجەپ تاييىپ ئەردوغان	レジェップ・タイイップ・エルドアン
قىزغۇچ سېرىق	オレンジ色
شىمال بۇغىسى	トナカイ
لۇقا بايان قىلغان خۇش خەۋەر	ルカによる福音書
كونا تاش قۇرال دەۋرى	旧石器時代
ئانتاليا ۋىلايىتى	アンタルヤ県
ھەزرىتى ئەيسا ئەلچىلىرىنىڭ پائالىيەتلىرى	使徒言行録
پەرۋەز مۇشەررەڧ	パルヴェーズ・ムシャラフ
ئادانا ۋىلايىتى	アダナ県
تاشقا ئايلانغان جىسىم	化石
بۇرسا	ブルサ
ئۇرۇق	種子
ئەنخۇي ئۆلكىسى	安徽省
خەلقئارا ئولىمپىك كومىتىتى	国際オリンピック委員会
ماڭلاي	額
ئىچكى موڭغۇل ئاپتونوم رايونى	内モンゴル自治区
Nottingxam	ノッティンガム
راكېتا	ロケット
كۇردىستان	クルディスタン
ستانفورد ئۇنىۋېرستېتى	スタンフォード大学
فۇجيەن ئۆلكىسى	福建省
Kanzas Shehiri, Missuri	カンザスシティ (ミズーリ州)
كىچىك مۈشۈكئېيىق	レッサーパンダ
موڭغۇل مىللىتى	モンゴル系民族
ۋەھىيلەر	ヨハネの黙示録
Sirtlan	ハイエナ
كاسا	尻
خەينەن ئۆلكىسى	海南省
رىمان	ベルンハルト・リーマン
گەنسۇ ئۆلكىسى	甘粛省
ئاق قان ھۈجەيرىسى	白血球
ئەنگلىيىلىكلەر	イングランド人
ئاناتول فرانس	アナトール・フランス
ئوتلاق ياۋا مۈشۈكى	リビアヤマネコ
جەينەك	肘
سۇجۇ شەھىرى	蘇州市
جاڭگال مولۇنى	ジャングルキャット
بېنگال مولۇنى تاغ مۈشۈكى	ベンガルヤマネコ
Wénju shehiri	温州市
ۋۇشى شەھىرى	無錫市
Shawshin shehiri	紹興市
خەنزۇ مىللىتى	漢民族
نىڭبو شەھىرى	寧波市
ئابدۇللاھ گۈل	アブドゥラー・ギュル
نېمىسلار	ドイツ人
خاربىن شەھىرى	ハルビン市
Orkéstr	オーケストラ
تۈرك قەھۋەسى	トルココーヒー
قىزىل ياقۇت	ルビー
كەشمىر	カシミール
گالاتا ساراي	ガラタサライSK
كەۋىن رۇد	ケビン・ラッド
يۈننەن ئۆلكىسى	雲南省
مالكولم X	マルコム・X
مەۋلانا جالالىددىن رۇمى	ジャラール・ウッディーン・ルーミー
Plimowt	プリマス
شەندۇڭ ئۆلكىسى	山東省
قول	腕
Dérbi	ダービー (イギリス)
ياقۇت رەڭلىك	エメラルド
كىرىستال	結晶
خېنەن ئۆلكىسى	河南省
بۇرسا ۋىلايىتى	ブルサ県
ئارتۋىن ۋىلايىتى	アルトヴィン県
كىندىك	へそ
ئادىيامان ۋىلايىتى	アドゥヤマン県
لياۋنىڭ ئۆلكىسى	遼寧省
خىمىيىلىك باغ	化学結合
GNU	GNU
توچىگى ناھىيىسى	栃木県
سېمونت	セメント
جىلىن ئۆلكىسى	吉林省
ئافيون قاراھىسار ۋىلايىتى	アフィヨンカラヒサール県
بېربېرلار	ベルベル人
ئېچىتقۇ	酵母
خۇنەن ئۆلكىسى	湖南省
ھونلار	フン族
چىڭخەي ئۆلكىسى	青海省
ئۇيغۇر مىللىتى	ウイグル
بىلەجىك ۋىلايىتى	ビレジク県
خۇبېي ئۆلكىسى	湖北省
شەنشى ئۆلكىسى	山西省
يۈز	頬
قوڭۇر رەڭلىك	茶色
گۇيلىن ئۆلكىسى	貴州省
بالىكەسىر ۋىلايىتى	バルケスィル県
كيوتو كىلىشىمنامىسى	京都議定書
ئانىلار بايرىمى	母の日
خەلقئارا ئىسلام كېڭىشى تەشكىلاتى	イスラム協力機構
چاناققالە ۋىلايىتى	チャナッカレ県
مىياگى ناھىيىسى	宮城県
Luknow	ラクナウ
شېنشى ئۆلكىسى	陝西省
رىملىقلارغا يېزىلغان خەت	ローマの信徒への手紙
مالىكىي مەزھىبى	マーリク学派
ئوقۇغۇچى	在籍者 (学習者)
Kobe	神戸市
ئىۋاتە ناھىيىسى	岩手県
كولۇمبىيە ئۇنىۋېرستېتى	コロンビア大学
بوستون ئۇنىۋېرستېتى	ボストン大学
يالې ئۇنىۋېرسىتېتى	イェール大学
پېنسىلۋانىيە ئۇنىۋېرستېتى	ペンシルベニア大学
Portland, Méané	ポートランド (メイン州)
نيۇيورك ئۇنىۋېرستېتى	ニューヨーク大学
ئىتاليانلار	イタリア人
پارىژ مېتروسى	メトロ (パリ)
پىرىت	黄鉄鉱
فىلىپىلىكلەرگە يېزىلغان خەت	フィリピの信徒への手紙
قېلىپ:Taxobox	Template:生物分類表
قارا ئېقىم	黒潮
خەلق گېزىتى	人民日報
جياڭشى ئۆلكىسى	江西省
ئىلھام ئالىيېۋ	イルハム・アリエフ
زاردارى	アースィフ・アリー・ザルダーリー
نۇرسۇلتان نازاربايېۋ	ヌルスルタン・ナザルバエフ
نىڭشيا خۇيزۇ ئاپتونۇم رايونى	寧夏回族自治区
ئىسلام كەرىموۋ	イスラム・カリモフ
شۈجو شەھىرى	徐州市
Lyenyün'gang shehiri	連雲港市
ساۋكات مىرزىيويەۋ	シャヴカト・ミルズィヤエフ
خۇەيئەن شەھىرى	淮安市
Yangjo shehiri	揚州市
Teyju shehiri, Jyangsu	泰州市
Nentung shehiri	南通市
جاڭجياڭ شەھىرى	鎮江市
چاڭجو شەھىر	常州市
ئەھمەد داۋۇد ئوغلۇ	アフメト・ダウトオール
تەيجۇ شەھىرى	台州市
جۇشەن شەھىرى	舟山市
شىجياجۇاڭ شەھىرى	石家荘市
تاڭشەن شەھىرى	唐山市
Chinxuangdaw shehiri	秦皇島市
خەندەن شەھىرى	邯鄲市
Bawding shehiri	保定市
پەنجاب تىلى	パンジャーブ語
پاشتوچە	パシュトー語
ساڭجو شەھىرى	滄州市
Langfang shehiri	廊坊市
Juxey shehiri	珠海市
شەنتۇ شەھىرى	汕頭市
Xuyjo shehiri	恵州市
Dongwen shehiri	東莞市
Jongshen shehiri	中山市
مىقدار سۆز	数詞
ئۆت خالتىسى	胆嚢
Jaypur	ジャイプル
فۇجو شەھىرى	福州市
Nenping shehiri	南平市
Putyen shehiri	ホ田市
Senming shehiri	三明市
Chüenju shehiri	泉州市
شيامېن شەھىرى	廈門市
Jyangju shehiri	ショウ州市
Longyen shehiri	竜岩市
Ningdé shehiri	寧徳市
Shining shehiri	西寧市
ئادەم ئەلەيھىسسالام	アダム
خۇئاڭشى شەھىرى	黄石市
ئائومورى ناھىيىسى	青森県
فۇكۇشىما ناھىيىسى	福島県
تەييۈەن شەھىرى	太原市
داتۇڭ شەھىر	大同市
داليەن شەھىرى	大連市
ئەنشەن شەھىرى	鞍山市
يىڭكۇ شەھىرى	営口市
لياۋياڭ شەھەر	遼陽市
يوزگات ۋىلايىتى	ヨズガト県
چوڭ مېڭە پوستلاق ماددىسى	大脳皮質
ئوڭچى	右翼
كارل ۋون دونىتىز	カール・デーニッツ
سۆسۈنە ياقۇت	アメシスト
بىنگۆل ۋىلايىتى	ビンギョル県
تايغان بۇغا	アカシカ
ئارداھان ۋىلايىتى	アルダハン県
ئايدىن ۋىلايىتى	アイドゥン県
ئاماسيا ۋىلايىتى	アマスィヤ県
قازاق مىللىتى	カザフ
ئاغرى ۋىلايىتى	アール県
بۇردۇر ۋىلايىتى	ブルドゥル県
كورىنتلىقلارغا يېزىلغان بىرىنچى خەت	コリントの信徒への手紙一
باتمان ۋىلايىتى	バトマン県
كۇرىل ئاراللىرى	千島列島
يېڭى يەر	ノヴァヤゼムリャ
Patna	パトナ
سۇلتان ئاخمەت جامىي	スルタンアフメト・モスク
ۋان ۋىلايىتى	ヴァン県
كونيا ۋىلايىتى	コンヤ県
ئاكىتا ناھىيىسى	秋田県
سېگولەن رويال	セゴレーヌ・ロワイヤル
بولۇ ۋىلايىتى	ボル県
دېنىزلى ۋىلايىتى	デニズリ県
شافىئىي مەزھىپى	シャーフィイー学派
گىپىس	石膏
ئېڭەك	おとがい
ئامېرىكا ياۋا كالىسى	アメリカバイソン
Léyséstér	レスター
ساكاريا ۋىلايىتى	サカリヤ県
ئاقساراي ۋىلايىتى	アクサライ県
قارس ۋىلايىتى	カルス県
دىيارباقىر ۋىلايىتى	ディヤルバクル県
مور	キノコ
تەيبېي 101	台北101
ئەدىرنە ۋىلايىتى	エディルネ県
ظوسذث	レタス
بىتلىس ۋىلايىتى	ビトリス県
ئىباراكى ناھىيىسى	茨城県
ھاتاي ۋىلايىتى	ハタイ県
پان تۈركىزم	汎テュルク主義
يۇگوسلاۋىيە سوتسىيالىست فېدېرال جۇمھۇرىيىتى	ユーゴスラビア社会主義連邦共和国
تۈرك	テュルク系民族
بارتىن ۋىلايىتى	バルトゥン県
باش بارماق	親指
كوجائەلى ۋىلايىتى	コジャエリ県
تۈرك خاقانلىقى	トルコ人
سازاڭسىمان مەددە	カエノラブディティス・エレガンス
چاڭچۈن شەھىرى	長春市
جىلىن شەھىرى	吉林市
ئېمۇ قۇشى	エミュー
خاككارى ۋىلايىتى	ハッキャリ県
راۋالپىندى	ラーワルピンディー
Emir Kusturica	エミール・クストリッツァ
ماشىنىىسازلىق ئىنژىنىرلىقى	機械工学
ئاينۇ مىللىتى	アイヌ
ئورانگوتان	ヒト上科
يېشىل ياقۇت	緑柱石
Markus bayan qilghan xush xewer	マルコによる福音書
ئازۇرىت	藍銅鉱
بېلىز شەھىرى	ベリーズシティ
مارشال	元帥
Chuju shehiri	ジョ州市
Rékazé shehiri	サムドゥプツェ区
قىرىم	クリミア・タタール人
كىلون تېخنىكىسى	クローニング
پروڧېسسور	教授
كورىنتلىقلارغا يېزىلغان ئىككىنچى خەت	コリントの信徒への手紙二
مۇغلا ۋىلايىتى	ムーラ県
ئاسىيا قارا ئېيىق	ツキノワグマ
گۈلچىلىك	ガーデニング
ئىغدىر ۋىلايىتى	ウードゥル県
ياماگاتا ناھىيىسى	山形県
قاڭشارلىق بۆكەن	サイガ
كۈتاھيا ۋىلايىتى	キュタヒヤ県
كۆك ياقۇت	サファイア
كۈرەشچى ئايروپىلان	戦闘機
ئېرتىش دەرياسى	エルティシ川
ئىبرانىيلارغا يېزىلغان خەت	ヘブライ人への手紙
گالاتىيلىقلارغا يېزىلغان خەت	ガラテヤの信徒への手紙
شاڭ سۇلالىسى	殷
كىلىس ۋىلايىتى	キリス県
تەكىرداغ ۋىلايىتى	テキルダー県
سان	太股
مانىسا ۋىلايىتى	マニサ県
كىچىك مېڭە	小脳
كولوسىلىقلارغا يېزىلغان خەت	コロサイの信徒への手紙
ياقۇپ يازغان خەت	ヤコブの手紙
يۇھاننا يازغان بىرىنچى خەت	ヨハネの手紙一
فىلىمۇنغا يېزىلغان خەت	フィレモンへの手紙
سالونىكىلىقلارغا يېزىلغان ئىككىنچى خەت	テサロニケの信徒への手紙二
پاۋىل كرۇگمەنن	ポール・クルーグマン
سالونىكىلىقلارغا يېزىلغان بىرىنچى خەت	テサロニケの信徒への手紙一
پېترۇس يازغان بىرىنچى خەت	ペトロの手紙一
پېترۇس يازغان ئىككىنچى خەت	ペトロの手紙二
تىموتىيغا يېزىلغان بىرىنچى خەت	テモテへの手紙一
ئېسكىموسلار	エスキモー
IMMAGINE&POESIA	IMMAGINE&POESIA
چىكاگو ئۇنىۋېرستېتى	シカゴ大学
ماردىن ۋىلايىتى	マルディン県
مالاتيا ۋىلايىتى	マラティヤ県
مۇش ۋىلايىتى	ムシュ県
يۇھاننا يازغان ئىككىنچى خەت	ヨハネの手紙二
يۇھاننا يازغان ئۈچىنچى خەت	ヨハネの手紙三
يەھۇدا يازغان خەت	ユダの手紙
تىموتىيغا يېزىلغان ئىككىنچى خەت	テモテへの手紙二
تىتۇسغا يېزىلغان خەت	テトスへの手紙
قىرقلارەلى ۋىلايىتى	クルクラーレリ県
ئاليۇمىن ئوكسىدى	コランダム
مەرسىن ۋىلايىتى	メルスィン県
ئوتتۇرا ئاسىيا ياۋا تۆگىسى	フタコブラクダ
بۇشەھر ۋىلايىتى	ブーシェフル州
تەكلىماكان قۇملۇقى	タクラマカン砂漠
پاچاق	脚
قاشقىئوغلاق	タヌキ
ئاشمورە ۋە كارتىئەر ئاراللىرى	アシュモア・カルティエ諸島
قىرشەھەر ۋىلايىتى	クルシェヒル県
ئەردەبىل ۋىلايىتى	アルダビール州
سىنوپ ۋىلايىتى	スィノプ県
Ajax	Ajax
ئاتىلار بايرىمى	父の日
شۆلگەي بېزى	唾液腺
سېرىق قاشتېشى	トパーズ
بىھارى تىلى	ビハール語
Teynen shehiri	台南市
ۋىتامىنE	ビタミンE
سۇلتان توغرۇلبەگ	トゥグリル・ベグ
Xéngyang shehiri	衡陽市
مالاي ئېيىقى	マレーグマ
مانجۇ مىللىتى	満州民族
تېرەك	ヤマナラシ
ھېيدېلبېرگ ئۇنىۋېرستېتى	ルプレヒト・カール大学ハイデルベルク
سۇلايمان دېمىرەل	スュレイマン・デミレル
ۋەيران بولۇش	倒産
ج.ۋىللارد گىببس	ウィラード・ギブズ
پۇت بارمىقى	爪先
ياغاچچى	大工
نىغدە ۋىلايىتى	ニーデ県
ئوتتۇرا ئاناتولىيە رايونى	中央アナトリア地方
قارا دېڭىز رايونى	黒海地方 (トルコ)
شەرقىي ئاناتولىيە رايونى	東アナトリア地方
يەر ئوتتۇرا دېڭىزى رايونى	地中海地方 (トルコ)
ئېگېي رايونى	エーゲ海地方 (トルコ)
مارمارا رايونى	マルマラ地方
شەرقىي جەنۇبىي ئاناتولىيە رايونى	南東アナトリア地方
لېيدېن ئۇنىۋېرستېتى	ライデン大学
مېڭە ئاستى بېزى	下垂体
تۈر:سىياسىي جۇغراپىيە	地政学
مۇرادئۈچ	ムラト3世
ئىدىنبۇرگ ئۇنىۋېرستېتى	エディンバラ大学
فارابى	ファーラービー
كۆك قۇتان	ムラサキサギ
گەۋدە	胴体
ياپونىيىلىك	日本人
پامىر ئېگىزلىكى	パミール高原
تولۇق كۇرس	学士
تۆش بېزى	胸腺
دۆڭچە مېڭىنىڭ ئاستى	視床下部
ئېلېكتر سىغىمى	静電容量
يېشىل تاش	孔雀石
سولچى	左翼
چاناق قەلئە ئۇرۇشى	ガリポリの戦い
بىريۇزا(ياقۇت)	トルコ石
ئەخمەت نەدجەت سەزەر	アフメト・ネジデト・セゼル
ۋيېنا ئۇنىۋېرسىتېتى	ウィーン大学
توشقانسىمان سۈلەيسۈن	マヌルネコ
ئافيون قاراھىسار	アフィヨンカラヒサール
ئوتتۇرا بارماق	中指
ئەبۇ مۇسا جابىر بىن ھەييام	ジャービル・イブン＝ハイヤーン
ئوشۇق	足関節
ئادىياما	アドゥヤマン
تاغ ئۆچكىسى	アイベックス
پەنجاب	パンジャーブ
شىيا سۇلالىسى	夏 (三代)
جىنەن شەھىرى	済南市
يول بەلگىسى	道路標識
چىڭداۋ شەھىرى	青島市
كالسېدونىيە	玉髄
ئاسىيا تېنچ ئوكيان ئىقتىسادىي ھەمكارلىق تەشكىلاتى	アジア太平洋経済協力
Glutséstér	グロスター
قەشقەر شەھرى	カシュガル市
ئىلام ۋىلايىتى	イーラーム州
نەنچاڭ شەھىرى	南昌市
بېشىكتاش گىمناستىكا كۇلۇبى	ベシクタシュJK
تۈرك لىراسى	トルコリラ
ئۆچكە	ヤギ属
بورمودىلى	ボーアの原子模型
ھەزىم يولى	食道
چاڭشا شەھىر	長沙市
ئۆكچە	かかと
كېكىردەك	咽頭
ئۇيغقاشتېشى	ヒスイ
ۋىتامىن D	ビタミンD
قۇتۇبى ناھىيىسى	フトビ県
2010 دۇنيا لوڭقىسى	2010 FIFAワールドカップ
نەسىرىدىن ئەپەندى	ナスレッディン・ホジャ
سۇلايمانىيە جامىى	スレイマニエ・モスク
كاۋاپ	ケバブ
Wéstminstér Shehiri	シティ・オブ・ウェストミンスター
نەننىڭ شەھىرى	南寧市
Durham	ダラム
تۇرغۇت ئۆزال	トゥルグト・オザル
ﮔﺎﮔﺎﯞﯗﺯ	ガガウズ人
بادام بەز	扁桃
مۇھەممەد خاتەمى	モハンマド・ハータミー
تورونتو ئۇنىۋېرستېتى	トロント大学
تروچكىزم	トロツキズム
ياڭ جىننىڭ	楊振寧
Gawshyung	高雄市
بىرىكمە ماتېرىيال	複合材料
مېڭە غولى	脳幹
تاموژنا	税関
كۈنمىڭ شەھىرى	昆明市
ۋىتامىنB	ビタミンB群
ئىسمەت ئىنۆنۈ	イスメト・イノニュ
مارگارېت ئاتۋود	マーガレット・アトウッド
خۇيزۇ مىللىتى	回族
لەنجۇ شەھىرى	蘭州市
Halva	ハルヴァ
لى جىڭداۋ	李政道
ماگىستىر	修士
كۆرسەتكۈچ بارماق	人差し指
ئوتتۇرا مېڭە	中脳
ئۇپسالا ئۇنىۋېرستېتى	ウプサラ大学
Multan	ムルターン
خېفېي شەھىر	合肥市
ھىيلە	手首
ئىپار مۈشۈك ئائىلىسى	ジャコウネコ科
ئارقار	アルガリ
كوپېنھاگېن ئۇنىۋېرستېتى	コペンハーゲン大学
لوياڭ شەھىرى	洛陽市
كۇئېنلۇن تاغ تىزمىسى	崑崙山脈
تىبەت مىللىتى	チベット系民族
لوندون ئىمپېرىيە ئىنستېتۇت	インペリアル・カレッジ・ロンドン
يىلىك	延髄
گۇيلىن شەھىرى	桂林市
گېئوتىت	針鉄鉱
Xeyko shehir	海口市
مولتىمىتىر	回路計
مەركىزىي مىللەتلەر ئۇنىۋېرسىتېتى	中央民族大学
چىپار بۇغا	ニホンジカ
يۇگوسلاۋىيە پادىشاھلىقى	ユーゴスラビア王国
ئېۋېنكى مىللىتى	エヴェンキ
سېرىق ياۋا مۈشۈك	アジアゴールデンキャット
گۇيياڭ شەھىرى	貴陽市
نامسىز بارماق	薬指
لىمبىك سىستېما	大脳辺縁系
تۇرپان	トルファン市
ئىلى دەرياسى	イリ川
مېڭە كۆۋرۈكى	橋 (脳)
ﺑﺎﻟﻘﺎﺭ ﻣﯩﻠﻠﯩﺘﻰ	バルカル人
ﻧﻮﻏﺎﻱ ﻣﯩﻠﻠﯩﺘﻰ	ノガイ族
كالا گۆشى	牛肉
گلاسگوۋ ئۇنىۋېرستېتى	グラスゴー大学
توخارلار	トハラ人
ئىستانبۇل ئۇنىۋېرسىتېتى	イスタンブル大学
Tuwa	トゥバ人
بۇرما مۈڭگۈزلۈك بۆكەن	ターキン
ئېلېكترون قەۋەت	電子殻
مۇھەررىر	編集
مىكروسكوپ	顕微鏡
كېمىنىڭ يان تىرەكلىرى	肋骨
جاڭ خىڭ	張衡 (科学者)
جاڭ چيەن	張騫
موڭغۇلكۈرە ناھىيىسى	モンゴルキュレ県
Juko shehiri	周口市
جۇگىلىياڭ	諸葛亮
زىبو شەھىرى	シ博市
ۋىتامىن C	ビタミンC
سۇلتان ئالىپ ئارىسلان	アルプ・アルスラーン
گوللاندىيىلىكلەر	オランダ人
مەن، ماشىنا ئادەم (كىنو)	アイ,ロボット
جۇڭخۇا خەلق جۇمھۇرىيىتىنىڭ ئاساسىي قانۇنى	中華人民共和国憲法
قاشتېشى	碧玉
تگرین اعظم	ティグラネス2世
كۆكمۇچ	トウガラシ属
چۆل مۈشۈكى	ハイイロネコ
جۇڭگو شىنخۇا ئاگېنتلىقى	新華社
Lankastér	ランカスター (イングランド)
لىجياڭ شەھىرى	麗江市
چىچىخار شەھىرى	チチハル市
گەبزە	ゲブゼ
ئەلنى ئىدارە قىلىشقا پايدىلىق ئومۇمىي ئۆرنەكلەر	資治通鑑
ئۇزۇن قۇيرۇق بۇغا	シフゾウ
سېرىق تەنلىكلەر	モンゴロイド
Keyféng shehiri	開封市
پارىژ ئۇنىۋېرسىتىتى	パリ大学
بېيخەي شەھىرى	北海市
يەنتەي شەھىرى	煙台市
يىنچۈئەن شەھىرى	銀川市
سەئىد قۇتوب	サイイド・クトゥブ
ئېيقسىمان ئىپار مۈشۈك	ビントロング
ئامستېردام ئۇنىۋېرستېتى	アムステルダム大学
ماتېرىيال	素材
دۇڭزۇ مىللىتى	トン族
تارىم ئويمانلىقى	タリム盆地
بۈيۈك ئويۇن	グレート・ゲーム
لازۇرىت	ラピスラズリ
قاراماي يۇقىر سۇرئەتلىك يولى	カラコルム・ハイウェイ
داغۇر مىللىتى	ダウール族
ساكاريا دەرياسى	サカリヤ川
ﺭﺍﺩﯨﺸﺸﯧﯟ	アレクサンドル・ラジーシチェフ
ئوۋتېز	ジョイス・キャロル・オーツ
مۇدەنجياڭ شەھىرى	牡丹江市
ناشى مىللىتى	ナシ族
ۋاشىنگتون ئۇنىۋېرستېتى	ワシントン大学 (ワシントン州)
زونگۇلداق ۋىلايىتى	ゾングルダク県
سېرىق بوغۇز بولغۇن	キエリテン
شىزاڭ ياۋا ئېشىكى	チベットノロバ
بىرمىنگام ئۇنىۋېرستېتى	バーミンガム大学
چىمەلتەك	小指
ماتېرىيال ئىلمى	物質科学
ھەنبەلىي مەزھىبى	ハナフィー学派
سەي لۇن	蔡倫
قوڭۇر بۇغا	サンバー
مىچىگان ئۇنىۋېرستېتى	ミシガン大学
ئىرۇسالىمغا قايتىش ھەركىتى	バック・トゥー・エルサレム
ﺋﺎﻗﺴﺎﻱ ﭼﯩﻦ	アクサイチン
مانچېستېر ئۇنىۋېرستېتى	マンチェスター大学
تارپان	ターパン
امينة ساندال	エミナ・ヤホヴィッチ
ئاق تەنلىكلەر	白人
تارىم دەرياسى	タリム川
مىننېسوتا ئۇنىۋېرستېتى	ミネソタ大学ツインシティー校
فۇكاڭ شەھىرى	阜康市
ئورخان پامۇك	オルハン・パムク
ئەرتۇغرۇل غازى	エルトゥールル
ﻗﺎﺭﺍ ﭼﺎﻱ ﻣﯩﻠﻠﯩﺘﻰ	カラチャイ人
نەجمەتتىن ئەرباقان	ネジメッティン・エルバカン
ﺋﺎﻟﺘﺎﻱ مىللىتى	アルタイ人
Teyjong shehiri	台中市
مىللەتچى ھەركەت پارتىيىسى	民族主義者行動党
ﭼﯘﯞﺍﺵ ﻣﯩﻠﻠﯩﺘﻰ	チュヴァシ人
ئىسپارتا ۋىلايىتى	ウスパルタ県
چىقچىق	コクイナ
سېرىق ئاغمىخان	チョウセンイタチ
شىزاڭ بۆكىن	チルー
چانقىرى ۋىلايىتى	チャンクル県
چورۇم ۋىلايىتى	チョルム県
ئىران ئەزەربەيجان	アーザルバーイジャーン
تۈركىيە بۈيۈك مىللەت مەجلىسى	トルコ大国民議会
بەيزۇ مىللىتى	ペー族
ﻗﺎﺭﺍ ﻗﺎﻟﭙﺎﻕ ﻣﯩﻠﻠﯩﺘﻰ	カラカルパク人
ئوسمانىيە ۋىلايىتى	オスマニエ県
1.خاتىرەمدىكى ئامېرىكا	ABCニュース (アメリカ)
رابىيە قادىر	ラビア・カーディル
سەزەن ئاقسۇ	セゼン・アクス
ۋەن مارۋىجىك	ベルト・ファン・マルワイク
Hidayet Türkoghli	ヒド・ターコルー
داچىڭ شەھىر	大慶市
لىزۇ مىللىتى	リー族
سۇلتان مەلىك شاھ	マリク・シャー
مەھمەت ئەلىي تالات	メフメト・アリ・タラート
ئابدۇراخمان جامى	ジャーミー
مېلبۇرن ئۇنىۋېرستېتى	メルボルン大学
Dünxuang Shehiri	敦煌市
لوپنۇر	ロプノール
Senya shehiri	三亜市
Dostum	ラシッド・ドスタム
مۇستاپا ساندال	ムスタファ・サンダル
تاغ بورسۇقى	シナイタチアナグマ
ئۈرۈمچى ناھىيىسى	ウルムチ県
سالار مىللىتى	サラール族
كيوتو ئۇنىۋېرستېتى	京都大学
بادام؛بادام؛بادام	扁桃体
ئىستانبۇل تېخنىكا ئۇنىۋېرسىتېتى	イスタンブル工科大学
ئىزمىر ۋىلايىتى	イズミル県
ئاد قەۋمى	アード
بۇغدىيەك	喉頭隆起
بېڭبۇ شەھەرى	蚌埠市
خۇەينەن شەھىرى	淮南市
مائەنشەن شەھىرى	馬鞍山市
ئەنچىڭ شەھىرى	安慶市
ياۋزۇ مىللىتى	ヤオ族
ئەرزۇرۇم ۋىلايىتى	エルズルム県
روبوتلار ۋە ئىمپىرىيە	ロボットと帝国
بىلگە قاغان	毘伽可汗
باتۇر تەڭرىقۇت	冒頓単于
ئەپراسىياپ	アフラースィヤーブ
يېڭى تاڭنامە	新唐書
سۇلتان بەكيارۇق	バルキヤールク
شانلى ئۇرفا ۋىلايىتى	シャンルウルファ県
شهرزاد	シェヘラザード (作詞家)
ترابزون ۋىلايىتى	トラブゾン県
برىتانى كولۇمبىيە ئۇنىۋېرستېتى	ブリティッシュコロンビア大学
Metta bayan qilghan xush xewer	マタイによる福音書
ئەلبورز ۋىلايىتى	アルボルズ州
خوجا ئەھمەد يەسەۋى	アフマド・ヤサヴィー
Tekshi choqqiliq tagh shehiri	平頂山市
شىنشياڭ شەھىرى	新郷市
Nenyang shehiri	南陽市 (河南省)
Shinyang shehiri	信陽市
ئەفەسلىكلەرگە يېزىلغان خەت	エフェソの信徒への手紙
زەمچە	カリウムミョウバン
ﺋﯩﻜﻜﯩﻨﭽﻰ ﻗﯩﺘﯩﻤﻠﯩﻖ ﯬﭘﻴﯘﻥ ﯰﺭﯗﺷﻰ	アロー戦争
ئاقچى ناھىيىسى	アクチ県
ئاقسۇ ۋىلايىتى	アクス地区
ئاقسۇ شەھىرى	アクス市
تېتراپىررول	テトラピロール
ئاقتو ناھىيىسى	アクト県
ميەنياڭ شەھىرى	綿陽市
ھلا رەڭ	ピンク
نەۋشەھەر ۋىلايىتى	ネヴシェヒル県
نازارې	ナザレ
سۇماترا بۆكىنى	スマトラカモシカ
دۈزجە ۋىلايىتى	デュズジェ県
ئالتاي شەھىرى	アルタイ市
سۈبھىدىكى روبوتلار	夜明けのロボット
مەلىكە ئاماننىساخان	アマニサハン
بەشىكتاش	ベシクタシュ
برىستول ئۇنىۋېرستېتى	ブリストル大学
يىزۇ مىللىتى	イ族
روزا ھېيت	イド・アル＝フィトル
شېڭ شىسەي	盛世才
يالىڭاچ قۇياش	はだかの太陽
نوتتىڭخام ئۇنىۋېرستېتى	ノッティンガム大学
تايلاندلىقلار	タイ人
تۈركىيە جۇمھۇريىتى باش مىنىستىرى	トルコの首相
نەمەنگان ۋىلايىتى	ナマンガン州
ھانى مىللىتى	ハニ族
پولات قەلئەلەر	鋼鉄都市
گىرەسۇن ۋىلايىتى	ギレスン県
گۈمۈشخانە ۋىلايىتى	ギュミュシュハーネ県
سىئىرت ۋىلايىتى	スィイルト県
قاھرامان ماراش ۋىلايىتى	カフラマンマラシュ県
ئومۇرتقا	脊椎
قارامان ۋىلايىتى	カラマン県
سامسۇن ۋىلايىتى	サムスン県
ئۆزبېك مىللىتى	ウズベク
ئەسكىشەھەر ۋىلايىتى	エスキシェヒル県
بايبۇرت ۋىلايىتى	バイブルト県
ئۇشاق ۋىلايىتى	ウシャク県
يالوۋا ۋىلايىتى	ヤロヴァ県
ئەلازىغ ۋىلايىتى	エラズー県
سىۋاس ۋىلايىتى	スィヴァス県
غازى ئانتەپ ۋىلايىتى	ガズィアンテプ県
قارابۈك ۋىلايىتى	カラビュック県
ئەرزىنجان ۋىلايىتى	エルズィンジャン県
ئوردۇ ۋىلايىتى	オルドゥ県
كاستامونۇ ۋىلايىتى	カスタモヌ県
توقات ۋىلايىتى	トカト県
نورۇز بايرىمى	ノウルーズ
كايسەرى ۋىلايىتى	カイセリ県
رىزە ۋىلايىتى	リゼ県
تاجىك مىللىتى	タジク人
مۇھەممەد ئىقبال	ムハンマド・イクバール
پارسلار	ペルシア人
قاراقالپاقىستان	カラカルパクスタン共和国
قىرىققالە ۋىلايىتى	クルッカレ県
قىرغىز مىللىتى	キルギス人
شاڭخەي ھەمكارلىق تەشكىلاتى	上海協力機構
تۈركىيە دەرىجىدىن تاشقىرى ئايلانمىسى	スュペル・リグ
تاركان	タルカン (歌手)
ﻳﺎﻗﯘﺕ ﻣﯩﻠﻠﯩﺘﻰ	ヤクート
فەرغانە ئويمانلىقى	フェルガナ盆地
فەرغانە	フェルガナ
Kanzas Shehiri, Kanzas	カンザスシティ (カンザス州)
پەرغانە ۋىلايىتى	フェルガナ州
بۇخارا ۋىلايىتى	ブハラ州
ئەنجان ۋىلايىتى	アンディジャン州
سەمەرقەنت ۋىلايىتى	サマルカンド州
سۇرخاندەريا ۋىلايىتى	スルハンダリヤ州
چاغاتاي خان	チャガタイ
سىردەريا ۋىلايىتى	シルダリヤ州
سىدنېي ئۇنىۋېرستېتى	シドニー大学
خارەزىم ۋىلايىتى	ホラズム州
نەۋايى ۋىلايىتى	ナヴァーイー州
قاشقادەريا ۋىلايىتى	カシュカダリヤ州
تاشكەنت ۋىلايىتى	タシュケント州
ئانا ۋەتەن پارتىيىسى	祖国党
جىزاق ۋىلايىتى	ジザフ州
ئاۋكلاند ئۇنىۋېرستېتى	オークランド大学
قاراخانىيلار خانلىقى	カラハン朝
ئوغۇزلار	オグズ
كۆمۈرچەك	軟骨
ئەلشىر ناۋائى	ミール・アリー・シール・ナヴァーイー
جەنۋە ئۇنىۋېرستېتى	ジュネーヴ大学
قىزىل تاغ	火焔山
Openoffice	OpenOffice.org
قۇربان ھېيت	イード・アル＝アドハー
تىمساھ	アリゲーター属
ئىستانبۇل ۋىلايىتى	イスタンブル県
Kökxot shehiri	フフホト市
ياقۇب بەگ	ヤクブ・ベク
باۋتۇ شەھىر	包頭市
كۈنەس ناھىيىسى	キュネス県
سوغدى يېزىقى	ソグド文字
تۇجيا مىللىتى	トゥチャ族
توقسۇن ناھىيىسى	トクスン県
تېھران ۋىلايىتى	テヘラン州
موناش ئۇنىۋېرستېتى	モナシュ大学
بوکان	ブーカーン
رېگان ئىقتىسادشۇناسلىقى	レーガノミクス
ئۆركەش دۆلەت	ウーアルカイシ
ئۇلۇغچات ناھىيىسى	ウルグチャト県
دۇلۇڭ مىللىتى	トーロン族
تۇنجەلى ۋىلايىتى	トゥンジェリ県
ئارال شەھرى	アラル市
خوتەن دەرياسى	ホータン川
چىپار يۈز قوڭغارچا	ハクビシン
ئارا تۈرۈك ناھىيىسى	アラトゥルク県
مۇز تاغ ئاتا	ムスタグアタ山
قابا ناھىيىسى	カバ県
ئالبېرتا ئۇنىۋېرستېتى	アルバータ大学
قوي گۆشى	羊肉
چەرچەن ناھىيىسى	チャルチャン県
تارباغاتاي ۋىلايىتى	タルバガタイ地区
قوڭۇر تاغ	コングール山
خەينە بۇغىسى	ターミンジカ
شىرناق ۋىلايىتى	シュルナク県
چۆچەك شەھىرى	チョチェク市
قالقانسىمان يان بەز	副甲状腺
قۇمۇل شەھىرى	クムル市
ئوساكا ئۇنىۋېرستېتى	大阪大学
قاراماي شەھىرى	カラマイ市
ئاتۇش شەھىرى	アルトゥシュ市
ئارىشاڭ ناھىيىسى	温泉県
بۇيى مىللىت	プイ族
سۈلەيسۈن	オオヤマネコ
تارماشىرىن	タルマシリン
نان	ナン
سېرىق مۇنتجاك بۇغىسى	キョン
دۇنيا ئۇيغۇر قۇرۇلتىيى	世界ウイグル会議
بۆرەك ئۈستى بېزى	副腎
لىمفا ئىشلەپچىقىرىدىغان	リンパ系
يانپاش	骨盤
ISO 639-1	ISO 639-1
چوسون مىللىتى	朝鮮族
جاڭ چۈنشيەن	張春賢
ۋاڭ لېچۈەن	王楽泉
ISO 639-2	ISO 639-2
ھىمالايا چۇپۇرلۇق قويى	ヒマラヤタール
ئاق تۇمشۇق بۇغا	クチジロジカ
ئۇرال - ئالتاي تىللىرى سېستىمىسى	ウラル・アルタイ語族
شېزۇ مىللىتى	シェ族
قەشقەر ۋىلايىتى	カシュガル地区
نەي	ナーイ
تىن تىننىڭ سەرگۈزەشتىلىرى	タンタンの冒険
يوپۇرغا ناھىيىسى	ヨプルガ県
دۇڭشياڭ مىللىتى	ドンシャン族
لاخۇ مىللىتى	ラフ族
بازا	ファウンデーション (小説)
قارىقۇيرۇق	モウコガゼル
مەكىت ناھىيىسى	マルキト県
ئۈرۈمچى دىۋوپۇ خەلقئارا ئايروپورتى	ウルムチ地窩堡国際空港
ئالتاي ۋىلايىتى	アルタイ地区
نەگۈبەئى	ニグベイ
ۋۇجياچۈ شەھىرى	五家渠市
ئاۋات ناھىيىسى	アーバード県
ئايدىڭكۆل	アイディン湖
بابۇر	バーブル
جەرەنبۇلاق رايونى	白鹸灘区
باركۆل قازاق ئاپتونوم ناھىيىسى	バルクル・カザフ自治県
باي ناھىيىس	バイ県
بايىنغولىن موڭغۇل ئاپتونوم ئوبلاستى	バインゴリン・モンゴル自治州
بونان مىللىتى	バオアン族
قارا تەنلىكلەر	黒人
ئورخۇن ئۇيغۇر خانلىقى	回鶻
كورلا شەھىرى	コルラ市
بازا ۋە ئىمپىرىيە	ファウンデーション対帝国
مېنبا مىللىتى	メンパ族
شەرقىي تۈركىستان	東トルキスタン
چياڭزۇ مىللىتى	チャン族
ۋازۇ مىللىتى	ワ族
5-ئىيۇل ۋەقەسى	2009年ウイグル騒乱
تاجىسىمان يۇرەك قان تومۇر كېسىلى	虚血性心疾患
ISO 639-3	ISO 639-3
ئىلى قازاق ئاپتونوم ۋىلايىتى	イリ・カザフ自治州
شىخەنزە شەھىرى	石河子市
ئاچاڭ مىللىتى	アチャン族
تۇزۇ مىللىتى	トゥ族
ئىككىنچى بازا	第二ファウンデーション
لوبا مىللىتى	ローバ族
يەكەن ناھىيىسى	ヤルカンド県
لىسۇ مىللىتى	リス族
QQ	テンセントQQ
تېڭشۈن شىركىتى	テンセント
قىزىلسۇ قىرغىز ئاپتونوم ئوبلاستى	クズルス・キルギス自治州
بىلكەنت ئۇنىۋېستېتى	ビルケント大学
كۋېنسلاند ئۇنىۋېرستېتى	クイーンズランド大学
غۇلجا شەھىرى	グルジャ市
نۇزۇ مىللىتى	ヌー族
مۇلاۋ مىللىتى	ムーラオ族
تۇرپان ۋىلايىتى	トルファン地区
Néwkastl Undérlim	ニューカッスル＝アンダー＝ライム
تۇڭگان مىللىتى	ドンガン人
بورتالا موڭغۇل ئاپتونوم ئوبلاستى	ボルタラ・モンゴル自治州
پۇمى مىللىتى	プミ族
قئارئاهوجئا	高昌
布朗族	プーラン族
باغراش ناھىيىسى	バグラシュ県
بورتالا شەھىرى	ボルタラ市
جىمىسار ناھىيىسى	ジムサル県
تاشقۇرقان تاجىك ئاپتونوم ناھىيىسى	タシュクルガン・タジク自治県
ياردەم:ياردەم	Help:目次
خوتەن ناھىيىسى	ホータン県
لوپ ناھىيىسى	ロプ県
بازىنىڭ چېتى	ファウンデーションの彼方へ
پارىژ ساھىلى	パリ・プラージュ
يۈسۈپ خاس ھاجىپ	ユースフ・ハーッス・ハージブ
ئورقۇ رايونى	ウルホ区
شەرقى تۈركىستان جۇمھۇرىيىتى	東トルキスタン共和国
تۇمشۇق شەھىرى	トムシュク市
خوتەن ۋىلايىتى	ホータン地区
قۇمۇل ۋىلايىتى	クムル地区
سانجى خۇيزۇ ئاپتونوم ئوبلاستى	昌吉回族自治州
كۈيتۇن شەھىرى	クイトゥン市
سانجى شەھىرى	昌吉市
چاپچال شىبە ئاپتونوم يېزىسى	チャプチャル・シベ自治県
فارس ۋىلايىتى	ファールス州
بۇرچىن ناھىيىسى	ブルチン県
بۇرۇلتوقاي ناھىيىسى	ブルルトカイ県
يېڭىسار ناھىيىسى	イェンギサール県
ۋۇسۇ شەھىرى	ウス市
دۆربىلجىن ناھىيىسى	ドルビルジン県
پوسكام ناھىيىسى	ポスカム県
گۇچۇڭ ناھىيىسى	奇台県
قورغاس ناھىيىسى	霍城県
يەنجى خۇيزۇ ئاپتونوم ناھىيىسى	焉耆回族自治県
لوپنۇر ناھىيىسى	ロプノール県
كوكتوقاي ناھىيىسى	コクトカイ県
قوبۇقسار موڭغۇل ئاپتونوم ناھىيىسى	ホボクサル・モンゴル自治県
قەشقەر كونا شەھەر ناھىيىسى	疏附県
ساۋەن ناھىيىسى	沙湾県
قاغىلىق ناھىيىسى	カルギリク県
خېجىڭ ناھىيىسى	和静県
چاغانتوقاي ناھىيىسى	チャガントカイ県
پىچان ناھىيىسى	ピチャン県
كۇچار ناھىيىسى	クチャ県
مايتاغ رايونى	独山子区
چاقىلىق ناھىيىسى	チャルクリク県
بۈگۈر ناھىيىسى	ブグル県
قەشقەر يېڭىشەھەر ناھىيىسى	疏勒県
شايار ناھىيىسى	シャヤール県
مارالبېشى ناھىيىسى	マラルベシ県
ماناس ناھىيىسى	マナス県
ئونسۇ ناھىيىسى	オンスー県
چىڭگىل ناھىيىسى	チンギル県
پەيزاۋات ناھىيىسى	ファイザバード県
مورى قازاق ئاپتونوم ناھىيىسى	モリ・カザフ自治県
تولى ناھىيىسى	トリ県
خوشۇت ناھىيىسى	ホショード県
يېڭىشەھەر رايونى	新市区 (ウルムチ市)
تۇدۇڭخابا رايونى	頭屯河区
ئىفايلۇت تەڭرىقۇت	伊伐於慮テイ単于
تەڭرىتاغ رايونى	天山区
داۋانچىڭ رايونى	達坂城区
گۇما ناھىيىسى	グマ県
سايباغ رايونى	サイバグ区
ئاشقازان	胃
شىبە مىللىتى	シベ族
كىنو مىللىتى	ジーヌオ族
كروران قەدىمكى شەهىرى	楼蘭
ئورۇنچون مىللىتى	オロチョン族
ئەنقەرە ئۇنىۋېرسىتېتى	アンカラ大学
غەربىي خەن سۇلالىسى	前漢
ئىكول تىل مەكتىپى	アコール言語学校
پېشاۋار	ペシャーワル
دۇڭسەن رايونى	東山区 (ウルムチ市)
كونا تاڭنامە	旧唐書
تاڭ سۇلالىسىگە دائىر مۇھىم خاتىرىلەر	唐会要
جۇڭغار ئويمانلىقى	ジュンガル盆地
قاراشەھەر بازىرى	焉耆
سۈينامە	隋書
سەئىدىيە خانلىقى	ヤルカンド・ハン国
شىمالىي سۇلالىلەرنىڭ تارىخى	北史
باش تومۇز	小暑
تۇغلۇق تۆمۇرخان	トゥグルク・ティムール
چەتئەلگە چىقىپ ئوقۇش	留学
قارا ھۈلەگۈ	カラ・フレグ
ئۇچتۇرپان ناھىيىسى	ウシュトゥルファン県
چىرا ناھىيىسى	チラ県
كەلپىن ناھىيىسى	カルピン県
قاراقاش ناھىيىسى	墨玉県
جىڭ ناھىيىسى	精河県
نىيە ناھىيىسى	ニヤ県
غۇلجا ناھىيىسى	グルジャ県
شۇيموگۇ رايونى	水磨溝区
كېرىيە ناھىيىسى	ケリヤ県
تۇخۇم نەيچىسى	輸卵管
شىنجاڭ ئىشلەپچىقىرىش - قۇرۇلۇش بىڭتۇەنى	新疆生産建設兵団
قەشقەر ھېيتگاھ مەسچىتى	エイティガールモスク
شياڭگاڭ پەن ـ تېخنىكا ئۇنىۋېرسىتېتى	香港科技大学
كونا بەش دەۋر تارىخى	旧五代史
دۇۋا	ドゥア
باراق	バラク (チャガタイ家)
ﻣﯧﯔ ﺟىيەنﺠﯘ	孟建柱
جېمىنەي ناھىيىسى	ジェミナイ県
توققۇزتارا ناھىيىسى	トックズタラ県
قاراماي رايونى	カラマイ区
نىلقا ناھىيىسى	ニルカ県
رۇس مىللىتى	オロス族
تېكەس ناھىيىسى	テケス県
توقسۇ ناھىيىسى	トクス県
ئېسفەھان ۋىلايىتى	エスファハーン州
تۈر:تۈركىيە	Category:トルコ
تۈر:ئۆسۈملۈك	Category:植物
تۈر:فىزىكا	Category:物理学
تۈر:تەبىئىي پەن	Category:自然科学
تۈر:Geografia	Category:地理
لەغمەن	拉麺
سائادەت پارتىيىسى	至福党
تۈر:خرىستىئان دىنى	Category:キリスト教
بارلاس قەبىلىسى	バルラス
قەدىمكى ئۇيغۇر يېزىقى	ウイグル文字
ئائىلە جەمئىيەتشۇناسلىقى	家族社会学
ئەنقەرە ۋىلايىتى	アンカラ県
ئىراق ۋە شام ئىسلام دۆلىتى	ISIL
پوزىترونىك مىڭە	陽電子頭脳
بۇزان	ブザン (東チャガタイ)
پۇشتۇ مىللىتى	パシュトゥーン人
يەسۈ مۆڭكە	イェス・モンケ
قەشقەر ئايىرپورت	カシュガル空港
ئەخمەتجان ﻗﺎﺳﯩﻤﻰ	アフメトジャン・カスィミ
ئەلجىگىدەي	イルジギデイ
گېئورگى بۇچنېر ئەدەبىيات مۇكاپاتى	ゲオルク・ビューヒナー賞
تىيىندورىشۇتى تەڭرىقۇت	亭独尸逐侯テイ単于
شىتۇڭشىجۇ قۇت تەڭرىقۇت	醢僮尸逐侯テイ単于
شولان شىسۇقۇتى تەڭرىقۇت	休蘭尸逐侯テイ単于
كىئۇچۇ گۇيلىنت تەڭرىقۇت	丘除車林テイ単于
ئەنگور تەڭرىقۇت	安国単于
كىئۇفۇيۇتى تەڭرىقۇت	丘浮尤テイ単于
غۇيەشى سۇقۇتى تەڭرىقۇت	湖邪尸逐侯テイ単于
مۇباراك شاھ	ムバーラク・シャー (チャガタイ家)
كۆنچەك	ゴンチェク
قوغشار تەڭرىقۇت	醢落尸逐テイ単于
تالىقۇ	ナリク
نۇر بەكرى	ヌル・ベクリ
بىنەپشە رەڭ	紫
سەيپىدىن ئەزىزى	セイプディン・エズィズィ
Ördek	カモ
قېلىپ:Tl	Template:Tl
قېلىپ:Userbox	Template:Userbox
Wikipedia:Administrators	Wikipedia:管理者
تۈر:جۇڭخۇا مىللەتلىرى	Category:中華人民共和国の民族
مىسىر	エジプト
قېلىپ:Bot	Template:Bot
كانادا	カナダ
Wikipedia:ھەققىدە	Wikipedia:ウィキペディアについて
قېلىپ:Flagicon	Template:Flagicon
قېلىپ:Documentation	Template:Documentation
Sung Jae-gi	成在基
قېلىپ:Softredirect	Template:Softredirect
قېلىپ:Delete	Template:即時削除
تۈر:تىل	Category:諸言語
Wikipedia:General disclaimer	Wikipedia:免責事項
قېلىپ:Navbox	Template:Navbox
ئورقۇن-يېنسەي يېزىقى	突厥文字
ئالاتاۋ ئېغىزى	阿拉山口市
قېلىپ:!	Template:!
قېلىپ:Tnavbar	Template:Tnavbar
قېلىپ:Babel	Template:Babel
قېلىپ:Commons	Template:Commons
قېلىپ:Reflist	Template:Reflist
قېلىپ:Stub	Template:Stub
قېلىپ:User az	Template:User az
قېلىپ:User de	Template:User de
قېلىپ:User de-1	Template:User de-1
قېلىپ:User es	Template:User es
قېلىپ:User de-3	Template:User de-3
قېلىپ:User en-3	Template:User en-3
قېلىپ:User en-1	Template:User en-1
قېلىپ:User en-2	Template:User en-2
قېلىپ:User en-4	Template:User en-4
قېلىپ:User en	Template:User en
قېلىپ:User de-2	Template:User de-2
قېلىپ:User es-1	Template:User es-1
قېلىپ:User fr-1	Template:User fr-1
قېلىپ:User ja-4	Template:User ja-4
قېلىپ:User sk	Template:User sk
قېلىپ:User tr-2	Template:User tr-2
قېلىپ:User tr	Template:User tr
قېلىپ:User ja	Template:User ja
قېلىپ:User ja-1	Template:User ja-1
قېلىپ:User fr	Template:User fr
قېلىپ:Location map/Info	Template:Location map/Info
قېلىپ:Mod	Template:Mod
قېلىپ:Welcome	Template:Welcome
تۈر:كىشلىك ئالاقە	Category:コミュニケーション
تۈر:User fr-1	Category:User fr-1
قېلىپ:Country showdata	Template:Country showdata
قېلىپ:Category handler	Template:Category handler
قېلىپ:ئافرىقا	Template:アフリカ
قېلىپ:Country data NEP	Template:Country data Nepal
قېلىپ:Documentation/docname	Template:Documentation/docname
تۈر:User en-4	Category:User en-4
تۈر:User en	Category:User en
تۈر:User zh	Category:User zh
تۈر:User zh-N	Category:User zh-N
تۈر:User en-2	Category:User en-2
قېلىپ:Infobox	Template:Infobox
قېلىپ:ئىراننىڭ ۋىلايەتلىرى	Template:イランの地方行政区画
قېلىپ:User zh	Template:User zh
قېلىپ:Navbox/core	Template:Navbox/core
قېلىپ:Legend	Template:Legend
قېلىپ:Ombox	Template:Ombox
قېلىپ:Country data	Template:Country data
قېلىپ:Pp-template	Template:Pp-template
قېلىپ:User ru	Template:User ru
تۈر:دۆلەت	Category:国家
قېلىپ:IPA	Template:IPA2
قېلىپ:ئىنجىل	Template:新約聖書
قېلىپ:ئوكيانىيە	Template:オセアニア
قېلىپ:جۇڭخۇا خەلق جۇمھۇرىيىتى	Template:中華人民共和国の行政区画
شىنجاڭ تىببى ئۇنىۋېرسىتېتى	新疆医科大学
قېلىپ:Provinces of Uzbekistan	Template:ウズベキスタンの地方行政区画
قېلىپ:ياپونىيە	Template:日本の都道府県
تۈر:User ja-N	Category:User ja-N
تۈر:سانائەت	Category:産業
قېلىپ:Tick	Template:レ
قېلىپ:رۇسىيە	Template:ロシア連邦の地方区分
قېلىپ:Infobox person	Template:Infobox 人物
قېلىپ:ياۋروپا	Template:ヨーロッパ
تۈر:User az	Category:User az
تۈر:User sk	Category:User sk
تۈر:User fr	Category:User fr
تۈر:User ja	Category:User ja
تۈر:User mn	Category:User mn
تۈر:User az-3	Category:User az-3
تۈر:User fr-3	Category:User fr-3
تۈر:User ja-3	Category:User ja-3
تۈر:User tr-3	Category:User tr-3
تۈر:User tr-1	Category:User tr-1
تۈر:User fr-4	Category:User fr-4
تۈر:User fr-2	Category:User fr-2
تۈر:User ja-2	Category:User ja-2
تۈر:User tr-2	Category:User tr-2
تۈر:User ko-N	Category:User ko-N
تۈر:User fr-N	Category:User fr-N
تۈر:User ru-N	Category:User ru-N
تۈر:User fr-5	Category:User fr-5
تۈر:User az-1	Category:User az-1
تۈر:User az-2	Category:User az-2
تۈر:User az-4	Category:User az-4
تۈر:User az-N	Category:User az-N
تۈر:User sk-N	Category:User sk-N
تۈر:User de	Category:User de
تۈر:User de-2	Category:User de-2
تۈر:User de-3	Category:User de-3
تۈر:User de-4	Category:User de-4
تۈر:User de-N	Category:User de-N
شىراز	シーラーズ
تۈر:User en-3	Category:User en-3
تۈر:User en-N	Category:User en-N
تۈر:User es	Category:User es
تۈر:User es-1	Category:User es-1
تۈر:User es-N	Category:User es-N
تۈر:User ja-1	Category:User ja-1
تۈر:User kk	Category:User kk
تۈر:User kk-N	Category:User kk-N
تۈر:User ko	Category:User ko
تۈر:User ko-3	Category:User ko-3
تۈر:User ru-1	Category:User ru-1
تۈر:User mn-1	Category:User mn-1
قېلىپ:Table Greekletters	Template:ギリシア文字
تۈر:ئىقتىساد	Category:経済
باشقۇرغۇچى مەشغۇلات قوللانمىسى	Help:管理者マニュアル
تۈر:User zh-min-nan	Category:User zh-min-nan
تۈر:User zh-min-nan-3	Category:User zh-min-nan-3
قېلىپ:Sockpuppet	Template:Sockpuppet
قېلىپ:User ru-2	Template:User ru-2
تۈر:User ru	Category:User ru
تۈر:User tr	Category:User tr
تۈر:User tr-N	Category:User tr-N
ۋىكىپېدىيە:ھۆججەت ئىشلىتىش پىرىنسىپى	Wikipedia:画像利用の方針
گاۋشەن مىللىتى	高山族
قېلىپ:Infobox City Japan	Template:日本の市
تۈر:ۋىتامىنلار	Category:ビタミン
قېلىپ:User ru-1	Template:User ru-1
قېلىپ:User tr-1	Template:User tr-1
قېلىپ:User tr-3	Template:User tr-3
قېلىپ:User zh-1	Template:User zh-1
قېلىپ:User zh-2	Template:User zh-2
قېلىپ:User zh-3	Template:User zh-3
قېلىپ:User zh-4	Template:User zh-4
تۈر:User zh-1	Category:User zh-1
تۈر:User zh-4	Category:User zh-4
تۈر:User zh-3	Category:User zh-3
تۈر:User zh-2	Category:User zh-2
تۈر:خىمىيىۋى ئېلېمېنت	Category:元素
تۈر:لېكسىكولوگىيە	Category:語彙論
تۈر:ئۆزبېكىستان	Category:ウズベキスタン
تۈر:جەمئىيەت مەسلىسى	Category:社会問題
تۈر:ئاتوم يادرو فىزىكىسى	Category:原子核物理学
سەۋزە	ニンジン
تۈر:جۇڭخۇا خەلق جۇمھۇرىيىتى	Category:中華人民共和国
تۈر:ئېتمولوگىيە	Category:語源学
قېلىپ:جۇڭگودىكى مىللەتلەر	Template:中華民族
قېلىپ:User mn-1	Template:User mn-1
قېلىپ:UF-hcard-geo	Template:UF-hcard-geo
تۈر:بىيولوگ	Category:生物学者
تراگۇلۇس بۇغىسى	マメジカ
تۈر:خاس ئات ئىلمى	Category:固有名詞学
تۈر:مەسلە	Category:問題
تۈر:User en-1	Category:User en-1
تۈر:User de-1	Category:User de-1
قېلىپ:User zh-min-nan-3	Template:User zh-min-nan-3
قېلىپ:شىنجاڭ	Template:新疆ウイグル自治区の行政区画
تاش	ロッシュ
خوتەن شەھىرى	ホータン市
ئالاھىدە:RecentChanges	特別:最近の更新
تۈر:User ja-4	Category:User ja-4
خارۇكو ئوبوكاتا	小保方晴子
غاز	雁
