非洲	アフリカ
日本	日本
南美洲	南アメリカ
挪威	ノルウェー
英格兰	イングランド
苏格兰	スコットランド
匈牙利	ハンガリー
西班牙	スペイン
美国	アメリカ合衆国
比利时	ベルギー
卢森堡	ルクセンブルク
地球	地球
人	ヒト
欢喜	幸福
芬兰	フィンランド
瑞典	スウェーデン
波兰	ポーランド
立陶宛	リトアニア
意大利	イタリア
瑞士	スイス
奥地利	オーストリア
希腊	ギリシャ
土耳其	トルコ
啤酒	ビール
葡萄牙	ポルトガル
欧洲	ヨーロッパ
亚洲	アジア
维基百科	ウィキペディア
尼德兰	オランダ
PHP	PHP: Hypertext Preprocessor
纽约市	ニューヨーク
旧金山	サンフランシスコ
洛杉矶	ロサンゼルス
计算机	コンピュータ
办合纳	ベルン
极乃伐	ジュネーヴ
苏黎世	チューリッヒ
巴拉克·奥巴马	バラク・オバマ
乌拉圭	ウルグアイ
白才尔	バーゼル
打印机	プリンター
伦敦	ロンドン
开罗	カイロ
苹果	リンゴ
墨西哥	メキシコ
大西洋	大西洋
太平洋	太平洋
加利福尼亚	カリフォルニア州
波士顿	ボストン
礼拜一	月曜日
火星	火星
肯尼亚	ケニア
礼拜两	火曜日
礼拜三	水曜日
礼拜四	木曜日
礼拜五	金曜日
礼拜六	土曜日
礼拜天	日曜日
法国	フランス
世界语	エスペラント
狗	イヌ
英国	イギリス
貓	ネコ
中华人民共和国	中華人民共和国
法文	フランス語
鱼	魚類
巴西	ブラジル
俄罗斯	ロシア
大海	海
圓周率	円周率
Π	Π
聖保羅	サンパウロ
该办克	ケベック州
德国	ドイツ
白俄罗斯	ベラルーシ
德语	ドイツ語
冰岛	アイスランド
愛沙尼亞	エストニア
土星	土星
巧克力	チョコレート
飞机	飛行機
打仗	戦争
拉脱维亚	ラトビア
乌克兰	ウクライナ
捷克	チェコ
斯洛伐克	スロバキア
斯洛文尼亚	スロベニア
摩尔多瓦	モルドバ
罗马尼亚	ルーマニア
保加利亚	ブルガリア
罗马	ローマ
马其顿	マケドニア共和国
阿爾巴尼亞	アルバニア
格陵兰	グリーンランド
克罗地亚	クロアチア
波黑	ボスニア・ヘルツェゴビナ
阿塞拜疆	アゼルバイジャン
安道尔	アンドラ
塞浦路斯	キプロス
格鲁吉亚	グルジア
哈萨克斯坦	カザフスタン
马耳他	マルタ
摩纳哥	モナコ
黑山共和国	モンテネグロ
梵蒂冈	バチカン
圣马力诺	サンマリノ
布鲁塞尔	ブリュッセル市
古巴	キューバ
大众汽车	フォルクスワーゲン
Java	Java
印度尼西亚	インドネシア
南非	南アフリカ共和国
阿尔及利亚	アルジェリア
乌兹别克斯坦	ウズベキスタン
欧罗维竞唱歌比赛	ユーロビジョン・ソング・コンテスト
水	水
木	木材
电视机	テレビ
冰岛文	アイスランド語
智利	チリ
耶稣	イエス・キリスト
語言	言語
英语维基百科	英語版ウィキペディア
尼古拉·萨科齐	ニコラ・サルコジ
新加坡	シンガポール
科学	科学
自由軟件	フリーソフトウェア
列支敦士登	リヒテンシュタイン
希特拉	アドルフ・ヒトラー
WikiLeaks	ウィキリークス
第二次世界大战	第二次世界大戦
科隆	ケルン
Linux	Linux
数学	数学
拉丁文	ラテン語
巴林	バーレーン
亚美尼亚	アルメニア
塞尔维亚	セルビア
月球	月
澳大利亚	オーストラリア
物理学	物理学
阿根廷	アルゼンチン
秘鲁	ペルー
朝鲜民主主义人民共和国	朝鮮民主主義人民共和国
柬埔寨	カンボジア
恐龙	恐竜
回教	イスラム教
里昂	リヨン
欧洲联盟	欧州連合
女性	女性
诗	詩
米蘭	ミラノ
屁眼	肛門
古高尔	グーゴル
珠穆朗玛峰	エベレスト
城市	都市
巴斯德	ルイ・パスツール
大洋洲	オセアニア
太阳系	太陽系
氢	水素
维基共享	ウィキメディア・コモンズ
揚聲器	スピーカー
东帝汶	東ティモール
维嘞合朋纳	ヴィルールバンヌ
学纳河	ローヌ川
迪拜	ドバイ
哥白尼	ニコラウス・コペルニクス
碳	炭素
音乐	音楽
圣皮得斯堡	サンクトペテルブルク
北	北
新西兰	ニュージーランド
南	南
印度	インド
西	西
氯气	塩素
铅	鉛
蒙古国	モンゴル国
委内瑞拉	ベネズエラ
国际象棋	チェス
缅因	メイン州
苏里南	スリナム
巴拉圭	パラグアイ
圭亚那	ガイアナ
艺术	芸術
厄瓜多尔	エクアドル
哥伦比亚	コロンビア
佛教	仏教
玻利维亚	ボリビア
特里尼达搭仔多巴哥	トリニダード・トバゴ
新罕布什爾	ニューハンプシャー州
马萨诸塞	マサチューセッツ州
康涅狄格	コネチカット州
鸡	ニワトリ
澤西島	ジャージー
猪猡	ブタ
伊朗	イラン
伊拉克	イラク
阿拉斯加	アラスカ州
以色列	イスラエル
巴拿马	パナマ
也門	イエメン
约旦	ヨルダン
佛罗里达州	フロリダ州
吉尔吉斯斯坦	キルギス
科威特	クウェート
老挝	ラオス
黎巴嫩	レバノン
俄勒冈	オレゴン州
马尔代芙	モルディブ
马来西亚	マレーシア
缅甸	ミャンマー
尼泊尔	ネパール
阿曼	オマーン
巴基斯坦	パキスタン
卡塔尔	カタール
沙特阿拉伯	サウジアラビア
斯里兰卡	スリランカ
史太林	ヨシフ・スターリン
叙利亚	シリア
塔吉克斯坦	タジキスタン
口袋妖怪	ポケットモンスター
中华民国	中華民国
泰国	タイ王国
火车	列車
土库曼斯坦	トルクメニスタン
阿拉伯联合酋长国	アラブ首長国連邦
越南	ベトナム
新西伯利亚	ノヴォシビルスク
大韩民国	大韓民国
阿富汗	アフガニスタン
金	金
喀山	カザン
孟加拉	バングラデシュ
马里	マリ共和国
安哥拉	アンゴラ
不丹	ブータン
文莱	ブルネイ
菲律宾	フィリピン
牛顿	アイザック・ニュートン
OpenStreetMap	オープンストリートマップ
量子力学	量子力学
突尼斯	チュニジア
赞比亚	ザンビア
津巴布韦	ジンバブエ
北京	北京市
贝宁	ベナン
博茨瓦纳	ボツワナ
布隆迪	ブルンジ
刚果共和国	コンゴ共和国
刚果民主共和国	コンゴ民主共和国
甘地	マハトマ・ガンディー
连环画	漫画
冈比亚	ガンビア
科特迪瓦	コートジボワール
喀麦隆	カメルーン
尼日利亚	ナイジェリア
索马里	ソマリア
铌	ニオブ
凱撒	ガイウス・ユリウス・カエサル
苏丹	スーダン
汉堡	ハンブルク
联合国	国際連合
唐担	ダンテ・アリギエーリ
艾哈迈德堡	アフマダーバード
锡	スズ
克林顿总统	ビル・クリントン
孟买	ムンバイ
波多黎各	プエルトリコ
卡纳塔克邦	カルナータカ州
列农	ジョン・レノン
爱达荷州	アイダホ州
华盛顿州	ワシントン州
科索沃	コソボ
潘基文	潘基文
Kofi Annan	コフィー・アナン
分类:页面分类	Category:主要カテゴリ
多特蒙德	ドルトムント
冬天	冬
西班牙语	スペイン語
匹兹堡	ピッツバーグ
费城	フィラデルフィア
金奈	チェンナイ
班加罗尔	バンガロール
钞票	貨幣
纽约州	ニューヨーク州
罗德岛	ロードアイランド州
昆虫	昆虫
宾夕法尼亚	ペンシルベニア州
Uetersen	ユーテルゼン
奧古斯都	アウグストゥス
微软视窗	Microsoft Windows
直布罗陀	ジブラルタル
布宜诺斯艾利斯	ブエノスアイレス
东京都	東京都
爱荷华州	アイオワ州
里昂地铁	メトロ (リヨン)
印地语	ヒンディー語
艾迪托·比娅呋	エディット・ピアフ
因斯孛鲁克	インスブルック
都柏林	ダブリン
法兰克福	フランクフルト・アム・マイン
天主教	カトリシズム
圣经	聖書
金边	プノンペン
胡志明市	ホーチミン市
河內市	ハノイ
真耶稣教会	真イエス教会
英语	英語
曼谷	バンコク
臺北市	台北市
同海市	ドンホイ
Końskowola	コィンスコヴォラ
达累斯萨拉姆	ダルエスサラーム
Al-Khartoum	ハルツーム
1月11号	1月11日
明斯克	ミンスク
微软公司	マイクロソフト
库鲁夫	クルフ
化学	化学
2月19号	2月19日
Visual Basic	Microsoft Visual Basic
本笃十六世	ベネディクト16世 (ローマ教皇)
12月25号	12月25日
8月4号	8月4日
8月31号	8月31日
迈克尔·杰克逊	マイケル・ジャクソン
巴西利亞	ブラジリア
大里昂	リヨン都市共同体
圣地牙哥	サンティアゴ (チリ)
坎培拉	キャンベラ
悉尼	シドニー
墨尔本	メルボルン
木卫三	ガニメデ (衛星)
珀斯	パース (西オーストラリア州)
西澳大利亚州	西オーストラリア州
北领地 (澳大利亚)	ノーザンテリトリー
苏门答腊岛	スマトラ島
突尼斯市	チュニス
德黑兰	テヘラン
亚的斯亚贝巴	アディスアベバ
安卡拉	アンカラ
贝尔格莱德	ベオグラード
分类:维基百科模板	Category:ウィキペディアのテンプレート
爪哇岛	ジャワ島
法属圭亚娜	フランス領ギアナ
安曼	アンマン
贝鲁特	ベイルート
分类:国家模板	Category:国関連のテンプレート
内罗毕	ナイロビ
分类:地理模板	Category:地理関連のテンプレート
学堂	学校
大学	大学
Wikipedia:沙盘	Wikipedia:サンドボックス
屋	家屋
卡尔梅克共和国	カルムイク共和国
地图	地図
奥萨斯库	オザスコ (サンパウロ州)
同海机场	ドンホイ空港
世界言话排名	ネイティブスピーカーの数が多い言語の一覧
分类:日本历史	Category:日本の歴史
孔子	孔子
分类:数学	Category:数学
法罗群岛	フェロー諸島
分类:印度历史	Category:インドの歴史
分类:泰国历史	Category:タイの歴史
巴厘岛	バリ島
分类:缅甸历史	Category:ミャンマーの歴史
欧元	ユーロ
美元	アメリカ合衆国ドル
地中海	地中海
威尼斯共和国	ヴェネツィア共和国
杭州市	杭州市
基督教	キリスト教
模板:亚洲行政区划	Template:アジア
模板:Support	Template:賛成
金国	金 (王朝)
洲	大陸
模板:ALA	Template:ALA
阿德来得	アデレード
首都	首都
葡萄牙语	ポルトガル語
模板:Portal	Template:ウィキポータルリンク
公元1949年	1949年
阿嘞玛桑	アルマサン
黄现璠	黄現ハン
日语	日本語
荧光屏	ディスプレイ (コンピュータ)
百科全书	百科事典
封面	メインページ
路由器	ルーター
棒球	野球
奧林匹克运动会	近代オリンピック
长江	長江
里海	カスピ海
拉斐尔	ラファエロ・サンティ
电车	路面電車
加泰罗尼亚	カタルーニャ州
毛泽东	毛沢東
西安	西安市
拉萨市	ラサ市
性行为	性行為
加夫列尔·加西亚·马尔克斯	ガブリエル・ガルシア＝マルケス
分类:快速删除候选	Category:即時削除対象のページ
莎里 嘛克嘞朗	サリー・ピアソン
马可·波罗	マルコ・ポーロ
共产主义	共産主義
1368年	1368年
國家	国
Joe Biden	ジョー・バイデン
希拉里·克林顿	ヒラリー・クリントン
Yelena Isinbayeva	エレーナ・イシンバエワ
大英博物馆	大英博物館
蒙彼利埃	モンペリエ
分类:天文学	Category:天文学
汉堡包	ハンバーガー
班合比让	ペルピニャン
标致汽车	プジョー
李白	李白
图书馆	図書館
世界银行	世界銀行
汉武帝	武帝 (漢)
女权主义	フェミニズム
元朝	元 (王朝)
库克船长	ジェームズ・クック
郑和	鄭和
黃河	黄河
蚂蚁	アリ
宋朝	宋 (王朝)
宋高宗	高宗 (宋)
落苏	ナス
龙	ドラゴン
姆妈	母親
隆波岛	ロンボク島
小人	子供
俄语	ロシア語
人家	家庭
普京	ウラジーミル・プーチン
东南亚国家联盟	東南アジア諸国連合
面包	パン
国际货币基金组织	国際通貨基金
联合国教育科学文化组织	国際連合教育科学文化機関
联合国卫生组织	世界保健機関
漢語	中国語
雨	雨
全球暖化	地球温暖化
纳尔逊·曼德拉	ネルソン・マンデラ
马丁·路德·金	マーティン・ルーサー・キング・ジュニア
蛋白质	タンパク質
天灾	自然災害
海啸	津波
云	雲
电视	テレビ受像機
几何学	幾何学
日圆	円 (通貨)
单词	語
漢字	漢字
希腊字母	ギリシア文字
諺文	ハングル
分类:法国	Category:フランス
分类:音乐	Category:音楽
红楼梦	紅楼夢
漫画	日本の漫画
狐狸	キツネ
哈利波特	ハリー・ポッターシリーズ
小提琴	ヴァイオリン
肛交	アナルセックス
教育	教育
男性	男性
婚姻	結婚
法语维基百科	フランス語版ウィキペディア
咖啡	コーヒー
果汁	ジュース
山	山
第29届奧林匹克运动会	北京オリンピック
孙中山	孫文
香港	香港
首尔	ソウル特別市
上海	上海市
伦敦 海斯楼 飞机场	ロンドン・ヒースロー空港
清朝	清
越南战争	ベトナム戦争
巴斯克语	バスク語
阿拉贡语	アラゴン語
瓦伦西亚	バレンシア (スペイン)
玛丽咏·高帝娅	マリオン・コティヤール
麦克斯韦	ジェームズ・クラーク・マクスウェル
原子	原子
光	光
罗鲍斯	ダイロン・ロブレス
韩语	朝鮮語
官話	官話
高棉文	クメール語
弗洛伊德	ジークムント・フロイト
泰语	タイ語
马来语	マレー語
蒙古语	モンゴル語
犹太教	ユダヤ教
万象	ヴィエンチャン
莫白桑	ギ・ド・モーパッサン
司马迁	司馬遷
朱熹	朱子
廷巴克图	トンブクトゥ
伦理学	倫理学
沙·卢克·康	シャー・ルク・カーン
什叶派	シーア派
道教	道教
子宫	子宮
颈	首
富克朗特群岛	フォークランド諸島
马恩岛	マン島
戴安娜王妃	ダイアナ (プリンセス・オブ・ウェールズ)
唐玄宗	玄宗 (唐)
Α	Α
Ω	Ω
Μ	Μ
明朝	明
朱元璋	朱元璋
Φ	Φ
朱由检	崇禎帝
Laura Robson	ローラ・ロブソン
2008年欧罗维竞唱歌比赛	ユーロビジョン・ソング・コンテスト2008
强·马凯恩	ジョン・マケイン
金正日	金正日
元素周期表	周期表
罗別脫 姆格比	ロバート・ムガベ
自杀	自殺
爬蟲類	爬虫類
Λ	Λ
伍老虎	タイガー・ウッズ
洋山芋	ジャガイモ
三宝垄	スマラン
报纸	新聞
电话	電話機
?	疑問符
美国空军	アメリカ空軍
菲德尔·卡斯特罗	フィデル・カストロ
元素单子	元素
广域网	Wide Area Network
围棋	囲碁
电影	映画
气体	気体
液体	液体
固体	固体
脚踏车	自転車
农业	農業
温度	温度
面积	面積
数	数
玛丽亚·莎拉波娃	マリア・シャラポワ
重慶	重慶市
天津市	天津市
武汉	武漢市
世界地理索引	国の一覧
玫瑰人生 (歌)	ラ・ヴィ・アン・ローズ
担桑身	妊娠
Google地图	Google マップ
癌	悪性腫瘍
残疾人	障害者
抗生素	抗生物質
青霉素	ペニシリン
肺炎	肺炎
克来普	クレープ
麻将	麻雀
运河	運河
坝	ダム
牛顿 (单位)	ニュートン
世界报 (法国)	ルモンド
万里长城	万里の長城
可再生能源	再生可能エネルギー
电	電気
核武器	核兵器
Joomla!	Joomla!
吉卜赛语	ロマ語
壮语	チワン語
自由人报 (法国)	リベラシオン
安吉丽娜	アンジェリーナ・ジョリー
阿拉伯语	アラビア語
马多符	バーナード・L・マドフ
扬马延岛	ヤンマイエン島
弗	ドル
科西嘉岛	コルシカ島
奥克语	オック語
克里斯蒂娜 艾伐脱	クリス・エバート
李明博	李明博
Β	Β
Γ	Γ
Δ	Δ
Ε	Ε
Ζ	Ζ
Η	Η
Θ	Θ
Ι	Ι
Κ	Κ
Ν	Ν
Ξ	Ξ
Ο	Ο
Ρ	Ρ
Σ	Σ
Τ	Τ
Υ	Υ
Χ	Χ
Ψ	Ψ
复活节岛	イースター島
澳门	マカオ
联想计算机公司	レノボ
梁振英	梁振英
董建华	董建華
胡锦涛	胡錦濤
习近平	習近平
深圳市	深セン市
廣東省	広東省
广西壮族自治区	広西チワン族自治区
国际金融中心 (香港)	国際金融中心 (香港)
施蒂文 呼克	スティーブン・フッカー
南澳大学	南オーストラリア大学
鹿儿岛县	鹿児島県
C语言	C言語
手铐	手錠
艾米·麦克唐纳 (歌手)	エイミー・マクドナルド
Wikipedia:Featured articles	Wikipedia:秀逸な記事
模板:Link FA	Template:Link FA
Wikipedia:红茶坊	Wikipedia:井戸端
釜山广域市	釜山広域市
佛蒙特	バーモント州
广州	広州市
蔣中正	蒋介石
江泽民	江沢民
温家宝	温家宝
南京市	南京市
刘德华	アンディ・ラウ
张学友	ジャッキー・チュン
郭富城	アーロン・クオック
同济大学	同済大学
首都圈电铁	首都圏電鉄
北京大学	北京大学
清華大學	清華大学
江苏省	江蘇省
浙江省	浙江省
邓小平	トウ小平
琶兰那克	パラニャーケ
菲律宾比索	フィリピン・ペソ
西藏	チベット自治区
圆	円 (数学)
同性婚姻	同性結婚
Francesc Fàbregas	セスク・ファブレガス
手机	携帯電話
太平山 (香港)	ヴィクトリア・ピーク
欧洲杯足球赛	UEFAチャンピオンズリーグ
马来亚半岛	マレー半島
平壤市	平壌
奥斯卡奖	アカデミー賞
各经济实体国内生产总值列表	国の国内総生産順リスト (為替レート)
司徒华	司徒華
黑龍江省	黒竜江省
芽庄市	ニャチャン
教皇	教皇
波多黎各独立党	プエルトリコ独立党
钱塘江	銭塘江
四川省	四川省
蔡元培	蔡元培
圣诞	クリスマス
闰年	閏年
ب	ب
大田广域市	大田広域市
大邱广域市	大邱広域市
仁川国际机场	仁川国際空港
仁川广域市	仁川広域市
京畿道	京畿道
计算机科学	計算機科学
阿鲁巴	アルバ
国际音标	国際音声記号
河北省	河北省
GNU自由文档许可证	GNU Free Documentation License
陈水扁	陳水扁
台湾	台湾
纽约	ニューヨーク (曖昧さ回避)
2012年欧洲足球冠军赛	UEFA EURO 2012
路由	ルーティング
人口密度	人口密度
爱尔兰	アイルランド島
鲁迅	魯迅
有利大楼	旧ユニオン・アシュランス・カンパニーズビル
湖	湖
黄瓜	キュウリ
南奥赛西亚	南オセチア
阿什哈巴德	アシガバート
岛屿	島
马赛	マルセイユ
风牙己榜国家公园	フォンニャ＝ケバン国立公園
广平省	クアンビン省
赤道	赤道
字典	辞典
北塞浦路斯	北キプロス・トルコ共和国
死海	死海
英镑	スターリング・ポンド
金兰国际机场	カムラン国際空港
荷属安地列斯	オランダ領アンティル
根西岛	ガーンジー
斯瓦尔巴群岛	スヴァールバル諸島
Benetice	ベネティツェ (スヴィエトラー・ナト・サーザヴォウ)
摄氏温标	セルシウス度
大叻市	ダラット
岘港市	ダナン
Washington	ワシントン
甴巴子	ゴキブリ
鱷魚	ワニ
中国工商银行	中国工商銀行
朝鮮正祖	正祖
人造卫星	人工衛星
太原省 (越南)	タイグエン省
杀人鲸	シャチ
印科软件	インフォシス
苏岩礁	蘇岩礁
日本海	日本海
东亚	東アジア
北亚	北アジア
南欧	南ヨーロッパ
东欧	東ヨーロッパ
北欧	北ヨーロッパ
西欧	西ヨーロッパ
中欧	中央ヨーロッパ
辛基得语	トリンギット語
琉球国	琉球王国
扶余国	夫余
县	カウンティ
氨基糖苷类抗生素	アミノグリコシド系抗生物質
伊斯兰历	ヒジュラ暦
柳京饭店	柳京ホテル
霍顿汽车	ホールデン (自動車)
市长	市町村長
中文维基百科	中国語版ウィキペディア
总统	大統領
满洲国	満州国
安娜·伊凡诺维琪	アナ・イバノビッチ
圣诞岛	クリスマス島 (オーストラリア)
黄宗羲	黄宗羲
臺灣省	台湾省
拳击	ボクシング
樟宜国际机场	シンガポール・チャンギ国際空港
大西洋处女	ヴァージン・アトランティック航空
快达航空	カンタス航空
国立台湾大学	国立台湾大学
斑马	シマウマ
同奈省	ドンナイ省
广义省	クアンガイ省
金瓯省	カマウ省
广南省 (越南)	クアンナム省
槟椥省	ベンチェ省
庆和省	カインホア省
客家语	客家語
北宁省	バクニン省
优八克	国際純正・応用化学連合
赣语	カン語
海地克里奥耳语	ハイチ語
大熊猫	ジャイアントパンダ
孤立語言	孤立した言語
卡纳达语	カンナダ語
杜甫	杜甫
瓦尔帕莱索	バルパライソ
演员	俳優
分类:程序编制言话	Category:プログラミング言語
瓦哈卡	オアハカ州
侗台语	タイ・カダイ語族
白脱	バター
尼亚加拉瀑布	ナイアガラの滝
吴语	呉語
塔斯马尼亚	タスマニア州
贝拉齐尔‧布托	ベーナズィール・ブットー
费利佩二世 (西班牙)	フェリペ2世 (スペイン王)
牛津大学	オックスフォード大学
基地 (恐怖组织)	アルカーイダ
英吉利海峡	イギリス海峡
柴尔兹孛格	ザルツブルク
秦国	秦
半岛	半島
新疆維吾爾自治區	新疆ウイグル自治区
布里司班	ブリスベン
东正教	正教会
各国首都列表	首都の一覧
平面镜	鏡
孛拉特 皮此	ブラッド・ピット
欧洲足球联合会	欧州サッカー連盟
美国个州	アメリカ合衆国の州
议会	議会
大阪市	大阪市
集韵	集韻
剑桥大学	ケンブリッジ大学
牙膏	歯磨剤
通货膨胀	インフレーション
艾美 羅森	エミー・ロッサム
竹	竹
刚果	コンゴ (曖昧さ回避)
马失拉地	マセラティ
科科斯群岛	ココス諸島
昆士兰州	クイーンズランド州
明尼阿波利斯	ミネアポリス
顺化市	フエ
马拉雅南语	マラヤーラム語
逻辑语	ロジバン
北江省	バクザン省
耶稣会	イエズス会
承天顺化省	トゥアティエン＝フエ省
北𣴓省	バックカン省
阿伯丁	アバディーン
莱州省	ライチャウ省
河南省 (越南)	ハナム省
上海浦东国际机场	上海浦東国際空港
政治學	政治学
闽东语	ビン東語
闽南语	ビン南語
安江省	アンザン省
茶荣省	チャーヴィン省
Tycho Brahe	ティコ・ブラーエ
薄辽省	バクリエウ省
嘉莱省	ザライ省
平福省	ビンフオック省
同塔省	ドンタップ省
约旦河西岸	ヨルダン川西岸地区
河江省	ハザン省
维克多利亚州	ビクトリア州
多乐省	ダクラク省
平定省	ビンディン省
上海言话	上海語
得农省	ダクノン省
水晶之夜	水晶の夜
潮州话	潮州語
台语	台湾語
门	扉
猪流感	豚インフルエンザ
高平省	カオバン省
平阳省	ビンズオン省
平顺省	ビントゥアン省
巴地头顿省	バリア＝ブンタウ省
奠边省	ディエンビエン省
三船敏郎	三船敏郎
印度电影观众奖	フィルムフェア賞
AK-47	AK-47
八国集团	主要国首脳会議
孙武	孫武
国际商用机器公司	IBM
互聯網電影數據庫	インターネット・ムービー・データベース
贝克特	サミュエル・ベケット
达赖喇嘛	ダライ・ラマ
邮政编码	郵便番号
Nicole Kidman	ニコール・キッドマン
联合国安理会	国際連合安全保障理事会
洋火棒儿	マッチ
雹	雹
南海	南シナ海
肯波拉圣吉奥瓦尼	カンポラ・サン・ジョヴァンニ
朝鮮世宗	世宗 (朝鮮王)
奥克兰格兰玛学校	オークランド・グラマー・スクール
电冰箱	冷蔵庫
黄海	黄海
大仲马	アレクサンドル・デュマ・ペール
孟加拉湾	ベンガル湾
哈马斯	ハマース
阿斯旺水坝	アスワン・ハイ・ダム
人民币	人民元
富士山	富士山
小鼠	ハツカネズミ属
索契	ソチ
迈克尔·菲尔普斯	マイケル・フェルプス
卡地马党	カディマ党
加沙地带	ガザ地区
霍巴特	ホバート
金草莓奖	ゴールデンラズベリー賞
律师	弁護士
相扑	相撲
希斯·莱杰	ヒース・レジャー
安徽省	安徽省
江原道	江原道 (朝鮮八道)
内蒙古自治区	内モンゴル自治区
金日成	金日成
全罗北道	全羅北道
济州特别自治道	済州特別自治道
郁陵岛	鬱陵島
湄公河	メコン川
索尼	ソニー
巴別塔	バベルの塔
力学	力学
南半球	南半球
蔚山广域市	蔚山広域市
光州广域市	光州広域市
温室效应	温室効果
Julia Gillard	ジュリア・ギラード
华国锋	華国鋒
福建省	福建省
克拉耿富合脱	クラーゲンフルト
小熊猫	レッサーパンダ
大溪地	タヒチ島
安东市	安東市
海南省	海南省
汉语拼音	ピン音
远东	極東
西班牙国家足球队	サッカースペイン代表
华氏温标	華氏
海峡群岛	チャンネル諸島
甘肃省	甘粛省
苏州市	蘇州市
无锡市	無錫市
湖州市	湖州市
绍兴市	紹興市
汉族	漢民族
昆山	崑山市
宁波市	寧波市
ETA (民族组织)	バスク祖国と自由
隆城国际机场	ロンタイン国際空港
数据	データ
迪马 皮郎	ジーマ・ビラーン
记者	記者
基本粒子	素粒子
陆克文	ケビン・ラッド
沙菲娅 劳塔露	ソフィーヤ・ロタール
些拉·班琳	サラ・ペイリン
云南省	雲南省
苏丹 (称谓)	スルターン
德国国家足球队	サッカードイツ代表
国立虎尾科技大学	国立虎尾科技大学
山东省	山東省
福楼拜	ギュスターヴ・フローベール
英属印度洋领地	イギリス領インド洋地域
地质年代	地質時代
河南省	河南省
乃堂雅虎	ベンヤミン・ネタニヤフ
护照	パスポート
遼寧省	遼寧省
件西卡 阿尔白	ジェシカ・アルバ
桑•班	ショーン・ペン
GNOME	GNOME
台湾桃园国际机场	台湾桃園国際空港
色子	サイコロ
吉林省	吉林省
东海	東シナ海
2008年美国总统选举	2008年アメリカ合衆国大統領選挙
苏州地铁1号线	蘇州軌道交通1号線
沙吞区	サートーン区
阿南德	ヴィスワナータン・アーナンド
湖南省	湖南省
水族馆	アクアリウム
青海省	青海省
柏威夏寺	プレアヴィヒア寺院
豪納省	ローヌ県
金一葉	金一葉
陸龜	リクガメ科
話筒	マイクロフォン
山西省	山西省
魔方	ルービックキューブ
尼德兰国家足球队	サッカーオランダ代表
谜子	なぞなぞ
艾西瓦娅·巴克罕	アイシュワリヤー・ラーイ
贵州省	貴州省
Warren Buffett	ウォーレン・バフェット
蹔𧉆	コオロギ
纸币	紙幣
加沙城	ガザ
白斯克	バスク地方
安达曼海	アンダマン海
胡适	胡適
穆斯林	ムスリム
孛路內 (Blu-Ray)	Blu-ray Disc
法国国家足球队	サッカーフランス代表
后现代	ポストモダン
宮城县	宮城県
帕荔斯 希尔顿	パリス・ヒルトン
陕西省	陝西省
模板:Commonscat	Template:Commonscat
岩手县	岩手県
死人	死体
莱纳斯·鲍林	ライナス・ポーリング
Patrick Swayze	パトリック・スウェイジ
嫦娥1号	嫦娥1号
刘裕	劉裕
純合子	ホモ接合型
水彩画	水彩
李舜臣	李舜臣
香港政区	香港の行政区画
南洞区	南洞区
富平区	富平区
巴黎地铁	メトロ (パリ)
陈方安生	陳方安生
清迈	テーサバーンナコーン・チエンマイ
珍珠港事件	真珠湾攻撃
分类:化学模板	Category:化学関連のテンプレート
模板:Taxobox	Template:生物分類表
松下电器	パナソニック
丰田汽车	トヨタ自動車
田鸡	カエル
艾奇亚	イケア
火车站	鉄道駅
洛东江	洛東江
模板:中国历史	Template:中国の歴史
金正恩	金正恩
豪萨语	ハウサ語
闽语	ビン語
莆仙语	ホ仙語
徐汇区	徐匯区
江西省	江西省
台湾省 (中华人民共和国)	台湾省 (中華人民共和国)
纳姆耶尔·旺楚克 (不丹国王)	ジグミ・ケサル・ナムゲル・ワンチュク
阮明哲	グエン・ミン・チェット
宁夏回族自治区	寧夏回族自治区
拿督阿都拉萨	ナジブ・ラザク
吉格梅·廷礼	ジグメ・ティンレー
约翰·菲利普·凯伊	ジョン・キー
宿迁市	宿遷市
扬州市	揚州市
泰州	泰州市
南通	南通市
镇江市	鎮江市
常州市	常州市
嘉兴市	嘉興市
金华市	金華市
衢州	衢州市
台州市	台州市
舟山市	舟山市
迪斯科	ディスコ (音楽)
沧浪区	滄浪区
阉	去勢
老虫	ネズミ上科
以色列国防军	イスラエル国防軍
寿春机场	タインホア空港
嘟嘟車	三輪タクシー
海蒂·克鲁姆	ハイディ・クルム
拉吉倪甘斯	ラジニカーント
阿拉伯文数字	インド数字
空军	空軍
周庄镇 (昆山)	周荘鎮
大名	大名
太仓	太倉市
劳莱士表	ロレックス
数码照相机	デジタルカメラ
数词	数詞
哈里发	カリフ
汇率	為替レート
青森县	青森県
福岛县	福島県
梁思成	梁思成
青蛙	アカガエル属
海防市	ハイフォン
斯堪的纳维亚半岛	スカンディナヴィア半島
里尔克	ライナー・マリア・リルケ
排列组合	組合せ数学
鲍林标度	電気陰性度
街道	ストリート
Wikipedia:新闻发布	Wikipedia:発表
机器翻译	機械翻訳
阿根廷国家足球队	サッカーアルゼンチン代表
面向对象程式编制	オブジェクト指向プログラミング
千叶县	千葉県
定积分	積分法
故宫	紫禁城
泰米尔猛虎解放组织	タミル・イーラム解放のトラ
印度卢比	インド・ルピー
Microsoft Outlook	Microsoft Outlook
早饭	朝食
自动银行出纳机	現金自動預け払い機
秋田县	秋田県
乌克兰元	フリヴニャ
Ségolène Royal	セゴレーヌ・ロワイヤル
通用汽车	ゼネラルモーターズ
差头	タクシー
乌赛	地域
滇池	テン池
尼扎·拉言	ニザール・ラヤーン
拿塔莎 康埔西	オーストリア少女監禁事件
新浪微博	新浪微博
模板:Cite book	Template:Cite book
香农 (计算数学家)	クロード・シャノン
宝莱坞	ボリウッド
三角函数	三角関数
2009年甲型H1N1流感疫情	2009年新型インフルエンザの世界的流行
草	雑草
文瑾莹	ムン・グニョン
2004年欧洲足球冠军赛	UEFA EURO 2004
严重急性呼吸道综合症	重症急性呼吸器症候群
Flickr	Flickr
John C. Mather	ジョン・C・マザー
索尔·珀尔马特	ソール・パールマッター
希腊数字	ギリシアの数字
人民力量党 (泰国)	人民の力党
俞正声	兪正声
克里米亚鞑靼人	クリミア・タタール人
伊斯兰圣战组织 (巴勒斯坦)	イスラーム聖戦 (パレスチナ)
2011年亚洲杯足球比赛入围赛	AFCアジアカップ2011 (予選)
爱媛县	愛媛県
圣灰星期三	灰の水曜日
邻舍	町字
沙地	ステップ (植生)
鸡窠生凤凰 (电影)	スラムドッグ$ミリオネア
浦东新区	浦東新区
天坛	天壇
外滩	外灘
山形县	山形県
基呒湖	キブ湖
东野圭吾	東野圭吾
电子工程	電子工学
台湾海峡	台湾海峡
神奈川县	神奈川県
中国地区	中国地方
长野县	長野県
埼玉县	埼玉県
英属印度	イギリス領インド帝国
法国高速铁路	TGV
Ϝ	Ϝ
群马县	群馬県
Ϙ	Ϙ
Hugh Jackman	ヒュー・ジャックマン
兵库县	兵庫県
2004年东南亚大地震搭海啸	スマトラ島沖地震 (2004年)
李准基	イ・ジュンギ
安娜·库妮可娃	アンナ・クルニコワ
天线	アンテナ
泰国湾	タイランド湾
2000年欧洲足球冠军赛	UEFA EURO 2000
Ϛ	Ϛ
兵房	バラック
石川县	石川県
妓院	売春宿
国际单位制词头	SI接頭辞
静冈县	静岡県
对话	問答法
Ͳ	サンピ
农民	農家
葡蛮郎	ブーメラン
渧拉米酥	ティラミス
Ϻ	Ϻ
毛巾	タオル
钱包	財布
春节	春節
麻生太郎	麻生太郎
无产阶级	プロレタリアート
弥撒	ミサ
Naomi Watts	ナオミ・ワッツ
座头鲸	ザトウクジラ
冈山县	岡山県
赌场	カジノ
撒旦教	サタニズム
沙道镇 (泰国)	サダオ郡
彰化县	彰化県
农历	中国暦
克罗地亚国家足球队	サッカークロアチア代表
巴尔喀什湖	バルハシ湖
丹尼·波尔	ダニー・ボイル
泰国旗	タイの国旗
希腊国家足球队	サッカーギリシャ代表
峨眉山	峨眉山
Zip	ZIP (ファイルフォーマット)
冰壶	カーリング
巴拉同 斯里恰乓	パラドーン・スリチャパン
台风	台風
台南市	台南市
太湖	太湖
研究生	大学院生
加蒂诺市 (魁北克)	ガティノー
针	針
加合拉·孛何妮	カーラ・ブルーニ
北仑区	北侖区
欧楂	セイヨウカリン
袁枚	袁枚
卡哟儿	カジョール
魔幻现实主义	マジックリアリズム
潘玉良	潘玉良
勒	頭絡
义和团	義和団の乱
李芙妮	ツィッピー・リヴニ
列宁搿拉德围城搭仔保卫战	レニングラード包囲戦
1988年欧洲足球冠军赛	UEFA欧州選手権1988
皇家夜总会 (电影)	007 カジノ・ロワイヤル
薯条	フライドポテト
吉赛尔·邦臣	ジゼル・ブンチェン
塔塔拿挪	タタ・ナノ
特强气旋风暴纳尔吉斯	サイクロン・ナルギス
2008年希腊街头骚乱	2008年ギリシャの暴動
半岛战争	半島戦争
日本杯	ジャパンカップ
利奧波德咖啡馆	レオポルド・カフェ
锅	鍋
Bipasha Basu	ビパシャ・バスー
英国电视电影艺术学院奖	英国映画テレビ芸術アカデミー
毛纳洛火山	マウナ・ロア山
荷兰东印度公司	オランダ東インド会社
富牌国际机场	フバイ国際空港
铁路轨道	線路 (鉄道)
斷背山	ブロークバック・マウンテン
雀巢公司	ネスレ
环球小姐	ミス・ユニバース
ADSL	ADSL
1992年欧洲足球冠军赛	UEFA EURO '92
奥斯区亚国家足球队	サッカーオーストリア代表
伦敦德里城	ロンドンデリー
新干线	新幹線
达新	タクシン・チナワット
Olga Kurylenko	オルガ・キュリレンコ
瑞士国家足球队	サッカースイス代表
莲姜国际机场	リエンケオン国際空港
金泳三	金泳三
星海爭霸	スタークラフト
波兰国家足球队	サッカーポーランド代表
瑞穗银行	みずほフィナンシャルグループ
姑蘇區	姑蘇区
环球影视城	ユニバーサル・ピクチャーズ
罗马尼亚国家足球队	サッカールーマニア代表
唐宁街10号	ダウニング街10番地
小仲马	アレクサンドル・デュマ・フィス
芹苴机场	カントー空港
罗杰·科恩伯格	ロジャー・コーンバーグ
2008年末─2009年初加沙地带大规模军事行动	ガザ紛争 (2008年-2009年)
利息	利子
直接民主制	直接民主制
橡胶擦子	消しゴム
幽老猫	かくれんぼ
ا	ا
ت	ت
ث	ث
ج	ج
萨丽	サリー (民族衣装)
1960年欧洲足球国家杯	1960 欧州ネイションズカップ
几何原本	ユークリッド原論
خ	خ
د	د
数码信号处理	デジタル信号処理
ر	ر
解热镇痛药	鎮痛剤
木版画	木版画
世界小姐	ミス・ワールド
长沙市	長沙市
阿披实	アピシット・ウェーチャチーワ
越南国家航空公司	ベトナム航空
伦敦政治经济学院	ロンドン・スクール・オブ・エコノミクス
油画	油彩
Portal:历史	Portal:歴史
泥石流	土砂災害
洲际弹道飞弹	大陸間弾道ミサイル
遗传转录	転写 (生物学)
繁体字	繁体字
宦官	宦官
虱误	バグ
阿歷克山德拉·柯倫泰	アレクサンドラ・コロンタイ
George F. Smoot	ジョージ・スムート
Ϸ	Ϸ
锡克金庙	ハリマンディル・サーヒブ
酋长航空公司	エミレーツ航空
1996年欧洲足球冠军赛	UEFA EURO '96
消费者物价指数	消費者物価指数
国际足球联合会世界排名表	FIFAランキング
卡本塔里亚湾	カーペンタリア湾
超级市场	スーパーマーケット
章子怡	章子怡
Heineken	ハイネケン
威尔士国家足球队	サッカーウェールズ代表
千分比	パーミル
高雄市	高雄市
病人	患者
1980年欧洲足球冠军赛	UEFA欧州選手権1980
1968年欧洲足球冠军赛	UEFA欧州選手権1968
1964年欧洲足球国家杯	1964 欧州ネイションズカップ
印第安纳琼斯 —— 水晶骷髅王国	インディ・ジョーンズ/クリスタル・スカルの王国
1972年欧洲足球冠军赛	UEFA欧州選手権1972
Bayes定理	ベイズの定理
美人魚	人魚
普吉府	プーケット県
1984年欧洲足球冠军赛	UEFA欧州選手権1984
亚历山大	アレクサンドリア (曖昧さ回避)
昆明	昆明市
老呒所依	ノーカントリー
东京铁塔	東京タワー
兰州市	蘭州市
佛來崮	ル・ピュイ＝アン＝ヴレ
头趟公开募股	株式公開
羅迪尼亞	ロディニア大陸
欧里维娅	オリビア・ニュートン＝ジョン
Knol	Knol
Ͱ	ヘータ
法国航空447号班机	エールフランス447便墜落事故
共享软件	シェアウェア
简化字	簡体字
Mike Myers	マイク・マイヤーズ
薄拉特 (电影)	ボラット 栄光ナル国家カザフスタンのためのアメリカ文化学習
張勉	張勉
耳機	ヘッドフォン
利库德党	リクード
洛阳	洛陽市
淞河	ソーヌ川
白鳍豚	ヨウスコウカワイルカ
1976年欧洲足球冠军赛	UEFA欧州選手権1976
平昌郡	平昌郡
藤球	セパタクロー
亚洲开发银行	アジア開発銀行
奖学金	奨学金
矮马	ポニー
匈奴编年史	匈奴
孟子	孟子
帝国理工	インペリアル・カレッジ・ロンドン
曾国藩	曽国藩
卫生	公衆衛生
桂林	桂林市
雪兰莪州	セランゴール州
海口市	海口市
海拔	高度
挪威广播公司	ノルウェー放送協会
中原地区	中原
第一趟鸦片战争	阿片戦争
声调	声調
基督山伯爵	モンテ・クリスト伯
玛丽女王2号	クイーン・メリー2
法国总统	共和国大統領 (フランス)
尹潽善	尹ボ善
伊顿公学	イートン・カレッジ
越盾	ドン (通貨)
解剖学治疗学及化学分类系统	解剖治療化学分類法
尹致昊	尹致昊
终结者3	ターミネーター3
北卡罗莱纳大学教堂山分校	ノースカロライナ大学チャペルヒル校
我有一只梦	I Have a Dream
上海世博会	上海国際博覧会
梦工厂	ドリームワークス
谢列梅捷沃国际机场	シェレメーチエヴォ国際空港
麵	麺
瑞联银行	UBS
观世音	聖観音
新曼谷国际机场	スワンナプーム国際空港
闸北区	閘北区
张爱玲	張愛玲
章太炎	章炳麟
张道陵	張陵
张居正	張居正
张家港	張家港市
浙江大学	浙江大学
郑洁	鄭潔
镇海区	鎮海区 (寧波市)
月饼	月餅
周迅	周迅
朱家角	朱家角鎮
诸暨	諸曁市
株洲市	株洲市
澎湖县	澎湖県
壯學	チワン学
中国人民解放军	中国人民解放軍
辛格·旺楚克 (不丹国王)	ジグミ・シンゲ・ワンチュク
利尿药	利尿薬
毕升	畢昇
巴黎大区高速铁路C线	RER C線
精神疾病诊断搭仔统计手冊	精神障害の診断と統計マニュアル
米尔克 (电影)	ミルク (映画)
高棉帝国	クメール王朝
狙击手	狙撃手
鼻衄	鼻血
开脱•文斯莱脱	ケイト・ウィンスレット
平均	平均
李商隐	李商隠
曹操	曹操
火山湖	火山湖
水粉画	ガッシュ
拨人忽视个真相	不都合な真実
Isaac Hayes	アイザック・ヘイズ
春武里府	チョンブリー県
武夷山	武夷山
塔麻可吉电子小鸡	たまごっち
泰王国国歌	タイの国歌
二氧化氮	二酸化窒素
冬至	冬至
风月俏佳人	プリティ・ウーマン
新台币	ニュー台湾ドル
混成词	かばん語
法国省份一览表	フランスの州 (フランス革命以前)
BOINC	Berkeley Open Infrastructure for Network Computing
袁世凯	袁世凱
袋鼠岛	カンガルー島
泰拉 蕾	タラ・リード
氯化氢	塩化水素
刘翔	劉翔
蒙古人民共和国	モンゴル人民共和国
DTD	Document Type Definition
开脱•末斯	ケイト・モス
娜塔莎·李察遜	ナターシャ・リチャードソン
三聚氰胺	メラミン
高隆皮亚国家足球队	サッカーコロンビア代表
莫尼卡-莱温斯基	モニカ・ルインスキー
雷曼兄弟公司	リーマン・ブラザーズ
大使馆	在外公館
金奎植	金奎植
IPod Shuffle	IPod shuffle
泼水节	ソンクラーン
7-Zip	7-Zip
Julius Pokorny	ユリウス・ポコルニー
南沙群岛	南沙諸島
湘潭市	湘潭市
费加罗报 (法国)	フィガロ (新聞)
汽车旅馆	モーテル
垃圾桶	ごみ箱
金刚 (电影)	キングコング
泻药	瀉下薬
海龜	ウミガメ
老鼠会	ポンジ・スキーム
赌城风云 (电影)	カジノ (映画)
化学品登记、评估、准许搭限制法规	REACH
学科	学問の一覧
ش	ش
性用品商店	アダルトグッズショップ
ISO/IEC 8859	ISO/IEC 8859
关公	関羽
ف	ف
龟	カメ
东方明珠	東方明珠電視塔
国际足联世界冠军俱乐部杯赛	FIFAクラブワールドカップ
卢旺达旅馆	ホテル・ルワンダ
重见日头 (1996年电影)	デイライト (映画)
苹果 (消歧义)	アップル
Isla Fisher	アイラ・フィッシャー
石泰凡妮 莱斯	ステファニー・ライス
印度空间研究组织	インド宇宙研究機関
酱油	醤油
新山	ジョホールバル
Euro	ユーロ (曖昧さ回避)
MT	MT
泰-老友谊大桥二号桥	第2タイ＝ラオス友好橋
国富论	諸国民の富の性質と原因の研究
清迈府	チエンマイ県
蔡英文	蔡英文
宋卡府	ソンクラー県
平年	平年
玫瑰人生 (2007年电影)	エディット・ピアフ〜愛の讃歌〜
沙吞府	サトゥーン県
泰文字母表	タイ文字
清莱府	チエンラーイ県
拉廊府	ラノーン県
披集府	ピチット県
We Are the Champions	伝説のチャンピオン
九龙	九龍
末尔悬岩	モハーの断崖
IT狂人	ハイっ、こちらIT課!
北榄坡府	ナコーンサワン県
碧差汶府	ペッチャブーン県
普吉国际机场	プーケット国際空港
抗心律失常药	抗不整脈薬
2008年欧洲足球冠军赛	UEFA EURO 2008
五代十国	五代十国時代
森理世	森理世
QED	QED
索马里内战	ソマリア内戦
沙马	サマック・スントラウェート
金砖国家	BRICs
安纳乍能府	アムナートチャルーン県
董里府	トラン県
博他仑府	パッタルン県
血色将至	ゼア・ウィル・ビー・ブラッド
乌泰他尼府	ウタイターニー県
新北市	新北市
臺中市	台中市
和谐社会	和諧社会
新竹市	新竹市
王力宏	ワン・リーホン
鹅	ガチョウ
年号	元号
高丽航空	高麗航空
环球银行金融电信协会	国際銀行間通信協会
Motorola	モトローラ
赛义巴巴	シルディ・サイ・ババ
欧洲足球冠军赛	UEFA欧州選手権
汽水	炭酸水
三沙市	三沙市
保合多伽勒国家足球队	サッカーポルトガル代表
车路	公道
苏梅岛	サムイ島
爱尔兰镑	アイルランド・ポンド
陈冯富珍	陳馮富珍
中岛美嘉	中島美嘉
Lauren Jackson	ローレン・ジャクソン
安娜 米亚里斯	アンナ・メアーズ
Prapawadee Jaroenrattanatarakoon	プラパワデ・ジャロエンラタナタラコン
邓亚萍	トウ亞萍
里斯班斯 齐凯脱	リスベス・トリケット
石泰凡妮 孛朗	ステファニー・ブラウン・トラフトン
陈冲	陳冲
林心如	林心如
张柏芝	セシリア・チャン
Pamela Jelimo	パメラ・ジェリモ
挪威公主阿斯特丽德	アストリッド (ノルウェー王女)
莱索尔 强斯	リーゼル・ジョーンズ
汤唯	湯唯
陈慧琳	陳慧琳
郭晶晶	郭晶晶
陈燮霞	陳燮霞
头孢菌素	セファロスポリン
沙没巴干府	サムットプラーカーン県
呵叻府	ナコーンラーチャシーマー県
藏羚羊	チルー
生个利亚酒	サングリア
浮罗交怡	ランカウイ島
攀牙府	パンガー県
馅饼统计图	円グラフ
抗酸剂	制酸薬
早稻田大学	早稲田大学
吴 (三国)	呉 (三国)
氯霉素	クロラムフェニコール
猜也贲府	チャイヤプーム県
泰华农民银行	カシコーン銀行
计程车3	TAXi3
英特尔砂桥	Sandy Bridgeマイクロアーキテクチャ
马肖·米切姆	マシュー・ミッチャム
耶莲娜	エレナ・ドキッチ
海宁市	海寧市
硫酸镁	硫酸マグネシウム
拉喇·杜打	ララ・ダッタ
汽车租赁	レンタカー
ک	ك
ل	ل
م	م
ن	ن
澳大利亚搭新西兰军团纪念日	ANZACの日
ANZ大球场	スタジアム・オーストラリア
杨玉环	楊貴妃
素拉育	スラユット・チュラーノン
颂猜·旺沙瓦	ソムチャーイ・ウォンサワット
地帕·漫它	ディーパ・メータ
拍凤裕庭 (泰国将军)	プラヤー・パホンポンパユハセーナー
奥特莱•导都	オドレイ・トトゥ
Β－内酰胺类抗生素	Β-ラクタム系抗生物質
金城武	金城武
周星驰	周星馳
WHO	Who (UNIX)
多尼尔228	ドルニエ 228
孙权	孫権
蒋经国	蒋経国
墨尔本胜利	メルボルン・ビクトリーFC
纳维语	ナヴィ語
Al Burj大厦 (迪拜)	アル・ブルジュ
神舟七号飞船	神舟7号
鬼勒耳朵边头讲	ゴースト 〜天国からのささやき
Grant George Hackett	グラント・ハケット
松浦晃一郎	松浦晃一郎
茄特 艾勒麦勒	ガッド・エルマレ
韩愈	韓愈
梁朝伟	梁朝偉
澳大利亚总理	オーストラリアの首相
王安石	王安石
投资银行	投資銀行
徐載弼	徐載弼
巴真府	プラーチーンブリー県
水晶棺材 (传说)	ガラスの棺
精工表	セイコーホールディングス
杭州灣大橋	杭州湾海上大橋
武里喃府	ブリーラム県
坤敬府	コーンケン県
德国无线通信	T-モバイル
廊开府	ノーンカーイ県
日本中央银行	日本銀行
Raja Ravi Varma	ラヴィ・ヴァルマ
李自成	李自成
哈桑式火箭弹	カッサームロケット
林语堂	林語堂
朴憲永	朴憲永
金枓捧	金ドゥ奉
龙仔厝府	サムットサーコーン県
信武里府	シンブリー県
包拯	包拯
大雪	大雪
武昌起义	武昌起義
镐立 (泰国)	カオラック (タイ)
同心隆安足球俱乐部	ドンタム・ロンアンFC
Ad-hoc On-demand Distance Vector	AODV
VOC	VOC
阿德来德联队	アデレード・ユナイテッドFC
芜湖市	蕪湖市
安庆市	安慶市
亳州市	亳州市
上饶	上饒市
冯玉祥	馮玉祥
佛历	仏滅紀元
银河处女	ヴァージン・ギャラクティック
2007年加沙地带争夺战	ガザの戦闘 (2007年)
新兴工业国家	新興工業経済地域
崇明岛	崇明島
李鸿章	李鴻章
中秋节	月見
元均	元均
浅野忠信	浅野忠信
炳·廷素拉暖	プレーム・ティンスーラーノン
陈冠希	陳冠希
以蒙 苏里房	イーモン・サリバン
雷锋	雷鋒
梁启超	梁啓超
多尔衮	ドルゴン
素可泰府	スコータイ県
彭德怀	彭徳懐
依善	イーサーン
紫峰大厦	紫峰タワー
姚文元	姚文元
海上花 (电影)	フラワーズ・オブ・シャンハイ
宁国	寧国市
悉尼晨锋报	シドニー・モーニング・ヘラルド
The quick brown fox jumps over the lazy dog	The quick brown fox jumps over the lazy dog
TCL	TCL
静安寺	静安寺
金牌	金メダル
亚洲航空	エアアジア
台南	台南
秋叶原	秋葉原
徐光启	徐光啓
强心苷	強心配糖体
SDS	ラウリル硫酸ナトリウム
四环素类抗生素	テトラサイクリン系抗生物質
大环内酯类抗生素	マクロライド系抗生物質
恒生指数	香港ハンセン株価指数
喹诺酮	キノロン
靖江	靖江市
新苏格兰银行	スコシアバンク
Моа	モア
掸邦	シャン州
1976年河北唐山大地震	唐山地震
上海地铁	上海軌道交通
以色列空军	イスラエル航空宇宙軍
玩转身前事	最高の人生の見つけ方
秋瑾	秋瑾
崇礼门	崇礼門
保琳汉生	ポーリン・ハンソン
伍丽群	メリッサ・ウー
許貞淑	許貞淑
嫦娥	嫦娥
羅蕙錫	羅ケイ錫
钟欣桐	ジリアン・チョン
吴三桂	呉三桂
孙休	孫休
許政	許政
孙皓	孫皓
孙亮	孫亮
宋吉 (拳手)	ソムジット・ジョンジョーホー
韩寒	韓寒
滑水	水上スキー
泰国人	タイ人
亚罗士打	アロースター
挽腊茫郡	バーンラムン郡
湄赛边关	メーサーイ郡
國際馬術聯合會	国際馬術連盟
世界佛教徒聯誼會	世界仏教徒連盟
新山一国际机场	タンソンニャット国際空港
宏碁电脑	エイサー (企業)
运动场	スタジアム
朝鲜半岛	朝鮮半島
圣保罗地铁	サンパウロ地下鉄
亚运会	アジア競技大会
捷克国家足球队	サッカーチェコ代表
朝鲜族	朝鮮民族
吕克·贝松	リュック・ベッソン
俞吉濬	兪吉濬
丁岩礁	丁岩礁
Tesco	テスコ (チェーンストア)
萨尔浒之战	サルフの戦い
傲游浏览器	Maxthon
供应链管理	サプライチェーン・マネジメント
金庾信	金ユ信
金明淳	金明淳
李爱情	イ・エジョン
长今之梦	少女チャングムの夢
武烈王	武烈王
文武王	文武王
金来沅	キム・レウォン
复旦大学	復旦大学
仁川地铁	仁川都市鉄道
李光洙	李光洙
朴重陽	朴重陽
六方会谈	六者会合
金润玉	金潤玉
奶粉	粉ミルク
班地戈 (维克多利亚)	ベンディゴ
朝鲜核问题	朝鮮民主主義人民共和国の大量破壊兵器
韩国放送公社	韓国放送公社
莎阿南	シャー・アラム
玉山	玉山 (台湾)
雜合子	ヘテロ接合型
西湖	西湖 (杭州市)
澳大利亚日	オーストラリアの日
大屿山	大嶼島
60秒惊天动地	60セカンズ
伊斯兰祈愿团	ジェマ・イスラミア
冈片山	グランピアンズ国立公園
中庸	中庸
饭	飯
德文语法	ドイツ語の文法
温岭	温嶺市
上海交通大學	上海交通大学
输入法	インプットメソッド
卡卡	カカ (サッカー選手)
南印度	南インド
2009年枪击斯里兰卡板球队事件	ラホールクリケットスリランカ代表襲撃事件
许冠杰	サミュエル・ホイ
柏林宣言	ベルリン宣言
安吉	安吉県
视力	視力
星期四岛	木曜島
陈英雄	トラン・アン・ユン
徐志摩	徐志摩
趙元任	趙元任
蒙古简介	モンゴル高原
沈约	沈約
IBM	IBM (曖昧さ回避)
巴彦淖尔	バヤンノール市
稷下學宮	稷下の学士
抗糖尿病药	経口血糖降下薬
抗高血压药	高血圧治療薬
抗真菌药	抗真菌薬
南京路	南京路 (上海)
意大利杂菜汤	ミネストローネ
算筹	算木
咳嗽药	鎮咳去痰薬
花岗岩岛 (澳大利亚)	グラニット島 (オーストラリア)
海峡两岸关系	両岸関係史
萧山	蕭山区
泰国旅游	タイの観光
琅琴表	ロンジン
醴陵市	醴陵市
奠边府战役	ディエンビエンフーの戦い
如东	如東県
正大集团	CPグループ
胡志明	ホーチミン
List of Thailand cities	タイの都市の一覧
法拉备拉矮马	ファラベラ
甲米机场	クラビー空港
水 (2005年电影)	とらわれの水
阿披叻	アピラック・コーサヨーティン
西非国家中央银行	西アフリカ諸国中央銀行
依夫城堡	シャトー・ディフ
皮蛋	皮蛋
庐山	廬山
首尔地下铁	ソウル地下鉄
必和必拓矿业公司	BHPビリトン
电脑语言	コンピュータ言語
世纪报	ジ・エイジ
霍元甲 (电影)	SPIRIT (2006年の映画)
饺子	餃子
乃米湖	ネミ湖
原子彈	原子爆弾
黄浦区	黄浦区
长宁区	長寧区
广州地铁	広州地下鉄
静安区	静安区
普陀区 (上海)	普陀区
虹口区	虹口区
杨浦区	楊浦区
闵行区	閔行区
宝山区 (上海)	宝山区 (上海市)
嘉定区	嘉定区
金山区 (上海市)	金山区 (上海市)
松江区	松江区
青浦区	青浦区
奉贤区	奉賢区
性旅游者	売春ツアー
教堂山 (北卡罗来纳州)	チャペルヒル (ノースカロライナ州)
启德机场	啓徳空港
昆剧	崑曲
意大利国家足球队	サッカーイタリア代表
国际先驱论坛报	インターナショナル・ニューヨーク・タイムズ
流亡政府	亡命政府
发声态	発声
海门市	海門市
日本色情业	日本のポルノ
中文数字大写	漢数字
南京大學	南京大学
輔仁大學	輔仁大学
鹰式教练机	BAe ホーク
快门	シャッター (カメラ)
白朗	ブラウプンクト
Shooting Dogs	ルワンダの涙
金刚	金剛杵
谥号	諡
吴佩孚	呉佩孚
徐温	徐温
吴敬梓	呉敬梓
四庫全書	四庫全書
李茂贞	李茂貞
杭州湾	杭州湾
刘心悠	アニー・リウ
刘濞	劉ビ
魏忠贤	魏忠賢
市区	都市的地域
小笼馒头	小籠包
张士诚	張士誠
网球王子	テニスの王子様
段祺瑞	段祺瑞
中国医药大学	中国医薬大学
中法战争	清仏戦争
梁咏琪	ジジ・リョン
台湾高速铁路	台湾高速鉄道
Twins	ツインズ (香港のアイドルユニット)
庙号	廟号
刘嘉玲	カリーナ・ラウ
言承旭	言承旭
台湾问题	台湾問題
汤恩伯	湯恩伯
清云科技大学	健行科技大学
东京爱情故事	東京ラブストーリー
张謇	張謇
王晶	バリー・ウォン
林妙可	林妙可
许雅涵	キャンディ・シュー
陈仪	陳儀
溫州話	温州語
启东	啓東市
奉化市	奉化市
西德	西ドイツ
油条	油条
蔡卓妍	シャーリーン・チョイ
陈良宇	陳良宇
亚洲国家列表	アジアの主権国家及び属領の一覧
春卷	春巻き
袁崇焕	袁崇煥
张献忠	張献忠
还珠格格	還珠格格
春晓气油田	白樺ガス田
卫诗	ジル・ビダル
王菀之	イヴァナ・ウォン
杨采妮	チャーリー・ヤン
台湾土地银行	台湾土地銀行
台湾个银行一览表	台湾の銀行の一覧
郑欣宜	ジョイス・チェン
林凤娇	林鳳嬌
攀牙湾	パンガー湾
陈叔宝	後主 (陳)
陈霸先	陳霸先
中华大学	中華大学
色，戒	ラスト、コーション
鲸体爆炸事件	鯨の爆発
中子彈	中性子爆弾
澳大利亚电信公司	テルストラ
金坛	金壇市
上海申花足球俱乐部	上海緑地申花足球倶楽部
俄罗斯国家足球队	サッカーロシア代表
计程车(1998年电影)	TAXi
XUL	XUL
蓝天处女	ヴァージン・オーストラリア
現代標準漢語	普通話
金边粉	パッタイ
薛福成	薛福成
圆仁	円仁
James Angleton	ジェームズ・アングルトン
中国国家图书馆	中国国家図書館
大漠孤雄 (电影)	モンゴル (映画)
墨尔本机场。	メルボルン空港 (オーストラリア)
TCL集团	TCL集団
西昌卫星发射中心	西昌衛星発射センター
镇	鎮
鲁国	魯
捧景配启 (拳手)	ポーン・キングピッチ
神户机场	神戸空港
巴黎大区高速铁路A线	RER A線
丢勒个犀牛	犀 (木版画)
泰国北部	タイ北部
凯山丰威汉市	カイソーン・ポムウィハーン郡
高分子化学	高分子化学
苏州码子	蘇州号碼
克里米亚共和国	クリミア自治共和国
计程车2	TAXi2
计程车4	TAXi4
医疗游客	医療観光
ISO/IEC 646	ISO/IEC 646
捷星航空	ジェットスター航空
素叻国际机场	スラートターニー空港
亭曼岛	ティオマン島
岘港国际机场	ダナン国際空港
百越	百越
西塘镇	西塘
大城银行 (泰国)	アユタヤ銀行
崇明县	崇明県
泰国外交部	外務省 (タイ)
国王岛	キング島
巴卡西半岛	バカシ半島
挽甲必区	バーンカピ区
盘谷银行	バンコク銀行
马来西亚国家银行	マレーシア国立銀行
爱尔兰银行	アイルランド銀行
泰国国家银行	タイ銀行
应召女郎	コールガール
北塘区	北塘区
赤壁(2008年电影)	レッドクリフ
黑人	黒人
普腾汽车	プロトン (自動車)
码头	埠頭
购物	買物
省会	省都
热干面	熱乾麺
富通银行	フォルティスグループ
崇祯	崇禎
秦淮河	秦淮河
越王勾践剑	越王勾践剣
远古侵略	プライミーバル
宰予	宰我
韶山市	韶山市
Schweppes	シュウェップス
东突厥斯坦	東トルキスタン
上海中学	上海中学
通假字	通仮字
內排国际机场	ノイバイ国際空港
普吉市	テーサバーンナコーン・プーケット
F-15雷暴式战斗机	F-15E (航空機)
抗病毒药	抗ウイルス薬
史弥远	史弥遠
國際語音學學會	国際音声学会
维基百科孵化器	ウィキメディア・インキュベーター
火锅	火鍋
银牌	銀メダル
干将莫邪	干将・莫耶
阿嘞白拿湖	アルバーノ湖
午马	午馬
性工作者	セックスワーカー
越捷航空	ベトジェットエア
巴乃到乃	パネットーネ
拉玛九世	ラーマ9世
外国口音综合症	外国語様アクセント症候群
嫦娥工程	嫦娥計画
东南亚国家杯足球比赛	東南アジアサッカー選手権
公主	プリンセス
滨湖区	浜湖区
苏丹航空公司	スーダン航空
南翔镇	南翔鎮
石头城	石頭城 (南京)
苏梅国际机场	サムイ空港
那空沙旺府教区	ナコーンサワン教区
阴蒂	陰核
三清山	三清山
铜牌	銅メダル
胡志明纪念堂	ホー・チ・ミン廟
喃字	チュノム
性奴隶	性的奴隷
粥	粥
2006年印度孟买火车大爆炸	ムンバイ列車爆破事件
钱元瓘	銭元カン
统万城	統万城
金瓯机场	カマウ空港
十国春秋	十国春秋
Debian自由软件指导方针	Debianフリーソフトウェアガイドライン
文艺春秋 (出版社)	文藝春秋
外蒙古	外蒙古
挥发性有机化合物	揮発性有機化合物
2009年以色列国会大选	第18回イスラエル議会総選挙
吴国	呉 (春秋)
合艾国际机场	ハートヤイ国際空港
南美洲国家列表	南アメリカの主権国家及び属領の一覧
苏州地铁	蘇州軌道交通
帮助:目录	Help:目次
Wikipedia:Tutorial	Wikipedia:ガイドブック
泰-老友谊大桥一号桥	タイ＝ラオス友好橋
澳洲电信大球场	ドックランズ・スタジアム
澎湖列岛	澎湖諸島
中国画	中国の絵画
申報	申報
奶茶	ミルクティー
龙游县	竜游県
澳大利亚国家气象局	オーストラリア気象局
支气管扩张剂	気管支拡張薬
京津城际铁路	京津都市間鉄道
琼语	海南語
弗林德斯岛 (塔斯曼尼亚)	フリンダース島
吴中区	呉中区
印度储备银行	インド準備銀行
泰国王家军队	タイ王国軍
河姆渡文化	河姆渡文化
曼谷大桥	クルンテープ橋
阿根廷，勿要为奴哭泣	アルゼンチンよ、泣かないで
福布斯	フォーブス (雑誌)
塔斯马尼亚州立大学	タスマニア大学
人妖打排球	アタック・ナンバーハーフ
泰京银行 (泰国)	クルンタイ銀行
星野亚希	ほしのあき
清莱国际机场	チェンライ国際空港
上海迪斯尼	上海ディズニーランド
陆上风帆	ランドセーリング
Joe Connor	ジョー・コナー
德天瀑布	徳天瀑布
石龙军路	ジャルンクルン通り
翁同龢	翁同ワ
上海道	滬海道
街道办事处	街道弁事所
相城区	相城区
港岛线	港島線
宁波地铁	寧波軌道交通
草原	草原
金球奖	ゴールデングローブ賞
宜兴市	宜興市
常熟	常熟市
江阴	江陰市
卢湾区	盧湾区
1983年澳大利亚个圣灰星期三大火	1983年オーストラリア森林火災
乍都节区	チャトゥチャック区
许怀欣	ライアン・ホイ
琼山	瓊山区
天长	天長市
如皋市	如皋市
江山市	江山市
浏阳市	瀏陽市
海曙区	海曙区
新昌	新昌県
吴兴区	呉興区
新都区	新都区
阿拉善右旗	アルシャー右旗
蛟	蛟
仓颉码	倉頡輸入法
香港航空	香港航空
钱俶	銭弘俶
豪格	ホーゲ
子贡	子貢
苏州新区	蘇州高新技術産業開発区
龚自珍	キョウ自珍
橋玄	橋玄
中毒债务	ハイイールド債
苏州地铁2号线	蘇州軌道交通2号線
常山县	常山県
后金	後金
宋国	宋 (春秋)
清迈国际机场	チェンマイ国際空港
泰鸟航空公司	ノックエア
O'Reilly Media	オライリーメディア
后羿	ゲイ (中国神話)
颂圣歌	タイの王室歌
泰国民族党	国民党 (タイ)
龙井茶	龍井茶
泰国南部	タイ南部
清迈大学	チエンマイ大学
越南南方共和国	南ベトナム共和国
西汉	前漢
中国国家博物馆	中国国家博物館
东林党	東林党
钱镠	銭鏐
崇安区	崇安区
崇川区	崇川区
Club Méd	地中海クラブ
入唐求法巡礼行记	入唐求法巡礼行記
河西省	ハタイ省
崇德	崇徳
AV女优	AV女優
手写体	筆記体
宋慧教	ソン・ヘギョ
海南岛	海南島
人民民主联盟 (泰国)	民主市民連合
武汉大学	武漢大学
熊田曜子	熊田曜子
黃大仙祠 (香港)	黄大仙祠 (香港)
韓國 (消歧義)	韓国 (曖昧さ回避)
迪拜大商场	ドバイ・モール
婚礼歌手	ウェディング・シンガー
文蛤	ハマグリ
异食癖	異食症
本田爵士 (汽车)	ホンダ・フィット
盛宣怀	盛宣懐
天聪	天聡
越国	越
桓玄	桓玄
Cowra (新南威尔士)	カウラ
为泰党 (泰国)	タイ貢献党
巩金瓯	鞏金甌
澳大利亚邮政局	オーストラリア郵便公社
大中华地区	中華圏
科廷科技大学	カーティン大学
中华人民共和国国庆节	国慶節
天台山 (浙江)	天台山
南宋	南宋
子思	子思
孛相	遊び
佛统大塔寺	ワット・プラパトムチェーディー
1931年个江淮大水	1931年中国大洪水
陕西历史博物馆	陝西省歴史博物館
还剑湖	ホアンキエム湖
愛科蘭舞	ふたりはプリキュア
泾县	ケイ県
惠山区	恵山区
阿含经	阿含経
西施	西施
岱山县	岱山県
当涂县	当塗県
侬	あなた
言話	話
梅林	魔術師 MERLIN
泰国民主党	民主党 (タイ)
白露	白露
东亚运动会	東アジア競技大会
法师旅馆 (日本)	法師 (旅館)
吴越国	呉越
爱田由	あいだゆあ
越剧	越劇
荃湾线	セン湾線
长江三角洲	長江デルタ
杭州萧山国际机场	杭州蕭山国際空港
繁昌县	繁昌県
射雕英雄传	射雕英雄伝
Ams tram gram	どちらにしようかな
全椒县	全椒県
郎溪	郎渓県
广德	広徳県
南明	南明
无为县	無為県
饭岛爱	飯島愛
良渚文化	良渚文化
湘乡市	湘郷市
金山区	金山区
泰国个佛教	タイの仏教
泰国国立法政大学	タンマサート大学
定海区	定海区
廊曼区	ドーンムアン区
机场	空港
世界大桥长度排名	橋の一覧 (長さ順)
男妓	男娼
南汇区	南匯区
千字文	千字文
僚	呉王僚
勾践	勾践
伍子胥	伍子胥
夫差	夫差
朱温	朱全忠
牌九	牌九
阖闾	闔閭
土星运载火箭	サターンロケット
核放射事故	原子力事故の一覧
星	星
墨尔本杯	メルボルンカップ
果敢	コーカン
办酒窠	ままごと
泰叻报	タイ・ラット
京滨急行电铁	京浜急行電鉄
泰国人民反独裁民主联盟	反独裁民主戦線
寶貝計劃	プロジェクトBB
乔石	喬石
井冈山	井崗山
汉服	漢服
南潯區	南潯区
南湖区	南湖区
嵊泗縣	ジョウ泗県
衢江区	衢江区
衡山县	衡山県
中山陵	中山陵
我个父亲甘地	ガンジー、わが父
平江区	平江区
澳大利亚偶像唱歌比赛	オーストラリアンアイドル
金阊区	金ショウ区
上海大学	上海大学
通州市	通州区 (南通市)
港闸区	港閘区
素坤逸路21巷 (曼谷)	ソイ・カウボーイ
巴黎大区高速铁路B线	RER B線
马来亚银行	メイバンク
开县	開県
扬中市	揚中市
锡山区	錫山区
乌镇	烏鎮
松岭区	松嶺区
开化县	開化県
吴江区	呉江区
海安县	海安県
玉环县	玉環県
乌达抛飞机场 (泰国)	ウタパオ国際空港
柯城区	柯城区
路桥	路橋区
南长区	南長区
陈育嬬	陳冠希わいせつ写真流出事件
钟嘉欣	リンダ・チョン
宁乡县	寧郷県
范蠡	范レイ
湘潭县	湘潭県
Wikipedia:维基大典	漢文版ウィキペディア
荣毅仁	栄毅仁
空堤区 (曼谷)	クローントゥーイ区
分类:德国	Category:ドイツ
分类:意大利	Category:イタリア
分类:美国	Category:アメリカ合衆国
分类:俄罗斯	Category:ロシア
分类:英国	Category:イギリス
分类:西班牙	Category:スペイン
分类:中国	Category:中国
分类:日本	Category:日本
分类:澳大利亚	Category:オーストラリア
分类:墨西哥	Category:メキシコ
分类:印度	Category:インド
分类:阿根廷	Category:アルゼンチン
门牌号码	住居番号
泰国财政部	財務省 (タイ)
火•1996 (电影)	炎の二人
富国国际机场	フーコック国際空港
巴黎大区高速铁路D线	RER D線
水灯节 (东南亚)	ローイクラトン
苏勒当阿孛杜勒机场	スルタン・アブドゥル・アジズ・シャー空港
呵叻国际机场	ナコーンラーチャシーマー空港
毛东岛	モートン島
分类:印度尼西亚	Category:インドネシア
分类:乃特朗特	Category:オランダ
分类:新加坡	Category:シンガポール
分类:韩国	Category:大韓民国
分类:泰国	Category:タイ王国
分类:越南	Category:ベトナム
分类:哺乳动物	Category:哺乳類
分类:植物	Category:植物
分类:物理	Category:物理学
分类:生物学	Category:生物学
分类:化学	Category:化学
分类:历史	Category:歴史
分类:地理	Category:地理
分类:社会	Category:社会
分类:宗教	Category:宗教
分类:体育运动	Category:スポーツ
分类:科学	Category:科学
分类:电影	Category:映画
分类:建筑物	Category:建築物
澳洲人报	オーストラリアン
泰国银行	タイの銀行の一覧
Princes Highway	プリンセスハイウェイ
拉脱卜大学	ラ・トローブ大学
维曼默宫	ウィマーンメーク宮殿
中国宗教	中国の宗教
乡	郷
西芳寺	西芳寺
素岳寺	ワット・プラタートドーイステープ
姚华乐路	ヤワラー通り
军人银行 (泰国)	TMB銀行
先锋号潜水艇 (英国)	ヴァンガード (原子力潜水艦)
眼鏡娘	眼鏡キャラクター
韓國 (戰國)	韓 (戦国)
变调	連続変調
昂船洲大桥	ストーンカッターズ橋
IPCC第4趟评价报告书	IPCC第4次評価報告書
苏州中学	蘇州中学
弹跳城堡	インフレータブルバルーン
帕邢寺	ワット・プラシン
华欣	フワヒン郡
幸福航空	幸福航空
泰国寺庙列表	タイの王室仏教寺院一覧
制片公司	番組制作会社
涂改液	修正液
七阶魔方	V-Cube 7
一乡一制品计划	一村一製品運動
樟宜	チャンギ (シンガポール)
神舟十号	神舟10号
韦伯斯特大字典	ウェブスター辞典
西雾延岛	シブヤン島
囚犯	囚人
巴士底獄	バスティーユ牢獄
泰国足球联赛	タイ・プレミアリーグ
赵古泥	趙古泥
官恩娜	エラ・クーン
Mike Davis	マイク・デイヴィス
民武里区	ミンブリー区
乍都节公园	チャトチャック公園
泰国省府	モントン
皇汉	大漢民族主義
美马宽子	美馬寛子
清迈夜市	夜市
分类:消歧义	Category:曖昧さ回避
分类:佛教	Category:仏教
分类:基督教	Category:キリスト教
分类:伊斯兰教	Category:イスラム教
蓝星行动 (印度)	ブルースター作戦
邪恶圣经	姦淫聖書
华东师范大学	華東師範大学
岳麓书院	岳麓書院
泰国商业银行	サイアム商業銀行
渠	溝渠
拍凤裕庭公路	パホンヨーティン通り
运动员	アスリート
泰国各党派	タイの政党
表字	字
Poise	ポアズ
香港站	香港駅
印度语言及方言	インドの言語の話者数一覧
曼谷枪手 1	レイン (映画)
十月围城	孫文の義士団
吴	呉
担	担
汪明荃	リザ・ウォン
廣韻	広韻
女阴	外陰部
越南国家银行	ベトナム国立銀行
容祖儿	容祖兒
妙蛙花	フシギバナ
国民报 (泰国)	ネーション (タイの新聞)
吞武里区	トンブリー区
饭岛真理	飯島真理
六阶魔方	V-Cube 6
麦西·芒芝	マキシ・マウンズ
Bochotnica	ボホトニツァ
堤岸 (越南)	チョロン地区
泰国华人	タイの華人
風雲：雄霸天下 (1998年電影)	風雲 ストームライダーズ
背越式	背面跳び
2008年丹麦驻巴基斯坦大使馆爆炸	2008年デンマーク大使館爆発事件 (パキスタン)
隆宾尼拳场	ルンピニー・スタジアム
雅拉搿连 (维克多利亚)	ヤラ・グリン
2005年安曼炸弹爆炸	2005年アンマン自爆テロ
玛格达·苏邦斯基	マグダ・ズバンスキー
正一派	正一教
抗心绞痛药	狭心症治療薬
无锡地铁	無錫地下鉄
菲里白·哈米尔吞	フィリッパ・ハミルトン
非典型性肺炎	非定型肺炎
选美	ミス・コンテスト
渐雷兽 (史前动物)	ブロントプス
将军澳	将軍澳
止泻药	止瀉薬
春晚	中国中央電視台春節聯歓晩会
2009年澳大利亚个大洪水	2009年のオーストラリア
咸蛋	鹹蛋
∂	∂
分类:未完个文章	Category:スタブ
分类:维基百科分类	Category:カテゴリ関連
分类:维基百科管理	Category:プロジェクト関連文書
分类:文化	Category:文化
分类:大洲	Category:大陸
分类:地质学	Category:地質学
张格尔	ジャハーンギール・ホージャ
泰国每日新闻	デイリー・ニュース (タイの新聞)
Jumper (小说)	ジャンパー (小説)
马来西亚国际商业银行	CIMB
大众银行 (马来西亚)	パブリック銀行
方腊	方臘 (水滸伝)
濑户早妃	瀬戸早妃
Wikipedia:Selected anniversaries	Wikipedia:今日は何の日
Wikipedia:命名常规	Wikipedia:記事名の付け方
玫瑰人生 (日本乐队)	ラヴィアンローズ (バンド)
剃刀	剃刀
太古城	太古城
闽南语维基百科	ビン南語版ウィキペディア
海南鸡饭	海南鶏飯
关楚耀	ケルビン・クァン
淮海路	淮海路 (上海)
Portal:地理	Portal:地理学
九品芝麻官 (电影)	広州殺人事件
薛凱琪	フィオナ・シット
联合早报	聯合早報
史可法	史可法
TAFE	TAFE
胡温	胡温体制
粵汉铁路	粤漢線
三通	三通
春运	春運
屯门公路	屯門公路
祖逖	祖逖
可口可乐公司	ザ コカ・コーラ カンパニー
Wikipedia:HotCat	Wikipedia:HotCat
东南大学	東南大学
海上花列传	海上花列伝
分类:维基百科机器人	Category:Wikipedia bots
吴王夫差矛	呉王夫差矛
大阪	大阪 (曖昧さ回避)
Portal:艺术	Portal:美術
分类:美国人	Category:アメリカ合衆国の人物
分类:演员	Category:俳優
分类:英国人	Category:イギリスの人物
分类:法国人	Category:フランスの人物
模板:Tl	Template:Tl
模板:Userbox	Template:Userbox
模板:Wikipedialang	Template:メインページ/他言語版
模板:Itn	Template:最近の出来事
Wikipedia:问题	Wikipedia:利用案内
分类:自由软件	Category:フリーソフトウェア文化・運動
分类:国家	Category:国
Wikipedia:Changing username	Wikipedia:利用者名変更依頼
Wikipedia:管理员	Wikipedia:管理者
模板:Sport-stub	Template:Sports-stub
分类:人物	Category:人物
分类:职业	Category:職業
分类:各行各业个人	Category:職業別の人物
Wikipedia:机器人	Wikipedia:Bot
分类:货币	Category:貨幣
分类:工程學	Category:工学
Wikipedia:AutoWikiBrowser	Wikipedia:AutoWikiBrowser
分类:医学	Category:医学
分类:政治	Category:政治
分类:教育	Category:教育
分类:光学	Category:光学
分类:艺术	Category:芸術
埃及	エジプト
Wikipedia:手傀儡	Wikipedia:多重アカウント
Wikipedia:Categorization	Wikipedia:カテゴリの方針
模板:Bot	Template:Bot
加拿大	カナダ
分类:倍尔奇姆	Category:ベルギー
分类:捷克	Category:チェコ
Wikipedia:版权	Wikipedia:著作権
泰国农业部	農業・協同組合省 (タイ)
甲那金银行 (泰国)	キアットナーキン銀行
暹罗京都银行	サイアム・シティ銀行
Wikipedia:关于	Wikipedia:ウィキペディアについて
泰国伊斯兰银行	タイ国イスラーム銀行
细川澄元	細川澄元
文艺春秋 (杂志)	文藝春秋 (雑誌)
分类:电子游戏	Category:コンピュータゲーム
分类:游戏	Category:ゲーム
帮助:編輯摘要	Help:要約欄
Portal:科学	Portal:自然科学
模板:Flagicon	Template:Flagicon
分类:欧洲国家	Category:ヨーロッパの国
分类:欧洲	Category:ヨーロッパ
Wikipedia:Subpages	Help:サブページ
Wikipedia:近段辰光个事体	Portal:最近の出来事
模板:Documentation	Template:Documentation
Wikipedia:User access levels	Wikipedia:利用者
分类:已保护页面	Category:編集保護中の記事
Wikipedia:聊天频道	Wikipedia:チャット
分类:维基人	Category:ウィキペディアン
Wikipedia:社区门堂	Wikipedia:コミュニティ・ポータル
分类:User by languages	Category:言語別の利用者
帮助:用词指南	Wikipedia:言葉を濁さない
成在基	成在基
模板:Soft redirect	Template:Softredirect
模板:Delete	Template:即時削除
分类:维基百科版权	Category:ウィキペディアと著作権
分类:技术	Category:技術
朝海寺 (泰国)	ワット・プラタートチョーヘー
卫星天线	パラボラアンテナ
分类:言话	Category:諸言語
分类:历法	Category:暦法
分类:维基百科	Category:ウィキペディア
分类:各样言话个维基百科	Category:各言語のウィキペディア
分类:朆索引个页	Category:検索エンジンに収集されないページ
分类:有无用文件链接个页	Category:壊れたファイルへのリンクがあるページ
Wikipedia:模板消息	Wikipedia:Template メッセージの一覧
分类:現在正發生個事體	Category:最新の出来事
模板:-	Template:-
模板:Navbox	Template:Navbox
市辖区	市轄区
南京朝天宫	朝天宮
朝阳科技大学	朝陽科技大学
模板:Persondata	Template:Persondata
大卫琼斯百货公司	デビッド・ジョーンズ (百貨店)
星岛日报	星島日報
允常	允常
模板:Fact	Template:要出典
分类:重定向	Category:リダイレクト
分类:維基百科維護	Category:ウィキペディアのメンテナンス
钱弘倧	銭弘シュウ
分类:泰国网球运动员	Category:タイのテニス選手
寺	寺院
模板:Error	Template:Error
模板:!	Template:!
模板:((	Template:((
模板:))	Template:))
模板:!!	Template:!!
模板:=	Template:=
模板:Tnavbar	Template:Tnavbar
模板:Code	Template:Code
模板:0	Template:0
模板:Unicode	Template:Unicode
模板:Transclude	Template:Transclude
模板:Small	Template:Small
模板:Clear	Template:Clear
模板:Col-break	Template:Col-break
模板:Col-begin	Template:Col-begin
模板:Col-end	Template:Col-end
模板:Nowrap	Template:Nowrap
模板:Bots	Template:Bots
出埃及记 (香港电影)	出エジプト記 (映画)
Wikipedia:必有个页面	Wikipedia:すべての言語版にあるべき項目の一覧
分类:非洲	Category:アフリカ
分类:數字	Category:数
分类:书	Category:書物
模板:Wikisource	Template:Wikisource
模板:Babel	Template:Babel
模板:Commons	Template:Commons
模板:Link GA	Template:Link GA
模板:Reflist	Template:Reflist
模板:AFG	Template:AFG
Wikipedia:列明來源	Wikipedia:出典を明記する
模板:Stub	Template:Stub
模板:See also	Template:See also
模板:User de	Template:User de
模板:User de-1	Template:User de-1
模板:User es	Template:User es
模板:User de-3	Template:User de-3
模板:User en-3	Template:User en-3
模板:User en-1	Template:User en-1
模板:User en-2	Template:User en-2
模板:User en-4	Template:User en-4
模板:User en	Template:User en
模板:User de-2	Template:User de-2
模板:User es-1	Template:User es-1
模板:User fa	Template:User fa
模板:User fr-1	Template:User fr-1
分类:各国个文化	Category:各国の文化
分类:物质	Category:物質
模板:User ja-4	Template:User ja-4
模板:User sk	Template:User sk
模板:User fr-2	Template:User fr-2
模板:User ja	Template:User ja
模板:User ja-1	Template:User ja-1
模板:User it-1	Template:User it-1
模板:User fr	Template:User fr
模板:Unsigned	Template:Unsigned
模板:HRV	Template:HRV
分类:亚洲	Category:アジア
分类:智利	Category:チリ
分类:21世紀	Category:21世紀
分类:User uk	Category:User uk
分类:南美洲	Category:南アメリカ
分类:User uk-N	Category:User uk-N
模板:Intricate template	Template:複雑なテンプレート
分类:马来西亚	Category:マレーシア
分类:食物	Category:食品
分类:足球	Category:サッカー
模板:Mod	Template:Mod
模板:User uk	Template:User uk
模板:User es-2	Template:User es-2
模板:WikipediaSister	Template:WikipediaSister
模板:USA	Template:USA
分类:年历	Category:年鑑
分类:组织	Category:組織 (団体)
分类:语言学	Category:言語学
模板:ITA	Template:ITA
模板:GEO	Template:GEO
模板:BOL	Template:BOL
分类:鏈接模板	Category:リンク支援テンプレート
模板:MEX	Template:MEX
分类:User fr-1	Category:User fr-1
模板:Wikiquote	Template:Wikiquote
模板:Image label	Template:Image label
模板:Category handler	Template:Category handler
模板:Category other	Template:Category other
模板:Translated page	Template:翻訳告知
模板:MAR	Template:MAR
模板:Ja icon	Template:Ja icon
模板:Korea-stub	Template:Korea-stub
模板:PSE	Template:PSE
模板:Sidebar	Template:Sidebar
模板:Es icon	Template:Es icon
模板:Ambox	Template:Ambox
Wikipedia:Accuracy dispute	Wikipedia:正確性に疑問がある記事
模板:Update	Template:更新
模板:SVK	Template:SVK
模板:TWN	Template:TWN
模板:EGY	Template:EGY
模板:Quotation	Template:Quotation
模板:KGZ	Template:KGZ
模板:Infobox School	Template:Infobox school2
模板:ISR	Template:ISR
模板:Infobox Country	Template:基礎情報 国
模板:Column-count	Template:Column-count
模板:VEN	Template:VEN
模板:Airline infobox	Template:航空会社情報ボックス
模板:Wide image	Template:Wide image
模板:UKR	Template:UKR
模板:Px	Template:Px
模板:好哉	Template:済
模板:Documentation/docname	Template:Documentation/docname
模板:Audio	Template:Audio
模板:Flatlist	Template:Flatlist
模板:PHL	Template:PHL
模板:ROU	Template:ROU
模板:BHR	Template:BHR
分类:欧洲国家足球队	Category:ヨーロッパのサッカーナショナルチーム
模板:Endflatlist	Template:Endflatlist
模板:TUR	Template:TUR
模板:Expand section	Template:節スタブ
模板:Tmbox	Template:Tmbox
模板:清理	Template:Cleanup
模板:DJI	Template:DJI
模板:Infobox university	Template:Infobox University
模板:BRN	Template:BRN
模板:Wikibooks	Template:Wikibooks
模板:Hatnote	Template:Dablink
模板:S-after	Template:S-aft
分类:巴黎	Category:パリ
分类:User en-4	Category:User en-4
分类:User en	Category:User en
分类:User zh	Category:User zh
分类:User zh-N	Category:User zh-N
分类:User en-2	Category:User en-2
模板:Infobox	Template:Infobox
模板:Right TOC	Template:TOCright
模板:Main other	Template:Main other
模板:User zh	Template:User zh
模板:Template other	Template:Template other
模板:Legend	Template:Legend
模板:Cite web	Template:Cite web
模板:Youtube	Template:YouTube
模板:Current	Template:最新の出来事
分类:軍事裝備	Category:兵器
模板:Infobox WS	Template:Infobox WS
模板:Ombox	Template:Ombox
分类:女模特	Category:女性モデル
模板:IMDb title	Template:IMDb title
模板:国际足球	Template:国際サッカー
模板:User ru-4	Template:User ru-4
分类:饮食	Category:飲食
模板:Coor URL	Template:座標URL
模板:Wiktionary	Template:Wiktionary
模板:Mbox templates	Template:Mbox templates
模板:Multi-listen start	Template:Multi-listen start
模板:Languageicon	Template:Languageicon
分类:英国个博物馆	Category:イギリスの博物館
模板:大韩民国行政区划	Template:大韓民国の地方行政区画
分类:总统	Category:大統領
模板:User ru	Template:User ru
分类:20世紀	Category:20世紀
模板:IPA	Template:IPA2
分类:美洲	Category:アメリカ
模板:Otheruses	Template:Otheruses
韩邦庆	韓邦慶
分类:各国个人	Category:各国の人物
模板:User language-N	Template:User language
模板:Imbox	Template:Imbox
模板:Rellink	Template:Rellink
模板:MONTHNAME	Template:MONTHNAME
Wikipedia:GNU自由文档许可证文本	Wikipedia:Text of GNU Free Documentation License
模板:CPV	Template:CPV
模板:Death date and age	Template:死亡年月日と没年齢
模板:Infobox Model	Template:女性モデル
模板:MONTHNUMBER	Template:MONTHNUMBER
模板:(	Template:(
分类:人物小作品	Category:人物関連のスタブ項目
模板:Top icon	Template:Top icon
模板:Namespace detect	Template:Namespace detect
模板:)	Template:)
模板:Fmbox	Template:Fmbox
分类:作家	Category:作家
分类:軍事	Category:軍事
分类:大学	Category:大学
模板:Hidden begin	Template:Hidden begin
模板:MYS	Template:MYS
模板:TJK	Template:TJK
模板:Infobox Website	Template:Infobox Website
模板:Image label end	Template:Image label end
模板:Documentation subpage	Template:Documentation subpage
模板:Winners	Template:Winners
模板:Ref label	Template:Ref label
模板:GHA	Template:GHA
模板:GMB	Template:GMB
模板:IDN	Template:INA
模板:FRO	Template:FRO
模板:ZAF	Template:ZAF
模板:POL	Template:POL
模板:Oldid	Template:Revision
模板:URY	Template:URY
模板:CUB	Template:CUB
模板:CMR	Template:CMR
模板:BIH	Template:BIH
模板:FIN	Template:FIN
模板:Tlx	Template:Tlx
模板:CAN	Template:CAN
模板:Purge	Template:Purge
模板:Cc-by-3.0	Template:Cc-by-3.0
模板:DNK	Template:DNK
模板:Empty category	Template:Empty category
模板:Infobox Cyrillic	Template:キリル
模板:Dead link	Template:リンク切れ
分类:跨性别	Category:トランスジェンダー
模板:Provinces of China	Template:中華人民共和国の行政区画
模板:SAU	Template:KSA
模板:Userpage	Template:Userpage
模板:DEU	Template:DEU
模板:BEN	Template:BEN
模板:CIS	Template:独立国家共同体
模板:SWE	Template:SWE
模板:Note label	Template:Note label
模板:Food-stub	Template:Food-stub
分类:中国个建筑	Category:中国の建築
杨协成	ヨー・ヒャップセン
模板:User	Template:User
模板:YEM	Template:YEM
模板:Spoken Wikipedia	Template:Spoken Wikipedia
吴稚晖	呉敬恒
余祭	余祭
诸樊	諸樊
寿梦	寿夢
模板:Lorem ipsum	Template:Lorem ipsum
俚	俚族
沈嗣良	沈嗣良
甪直镇	ロク直鎮
美国内华达州卖淫业	ネバダ州における売春
模板:User language-4	Template:User language-4
分类:中学	Category:高等学校
模板:YearTOC	Template:年代ナビ
分类:越南机场	Category:ベトナムの空港
模板:Note	Template:Note
分类:公司	Category:企業
模板:Footballbox	Template:Footballbox
模板:Renameuser	Template:利用者名変更
模板:CIA World Factbook link	Template:CIA World Factbook link
模板:Image label small	Template:Image label small
模板:Infobox Language/pronunciation	Template:Infobox Language/pronunciation
模板:Iaaf name	Template:IAAF name
模板:欧洲和海	Template:ヨーロッパ地図
模板:User language-0	Template:User language-0
模板:瑞士城市	Template:Infobox Swiss town
模板:User fr-3	Template:User fr-3
模板:UEFA	Template:UEFA欧州選手権
模板:Infobox Military Unit	Template:軍隊資料
模板:IMDb name	Template:IMDb name
模板:Ar icon	Template:Ar icon
模板:ABW	Template:ABW
分类:突尼斯	Category:チュニジア
模板:Th	Template:Th icon
模板:S-title	Template:S-ttl
模板:Infobox Language/map	Template:Infobox Language/map
分类:泰国个寺庙	Category:タイの仏教施設
模板:JPN	Template:JPN
分类:韩国电视	Category:韓国のテレビ
模板:Japan	Template:日本の都道府県
模板:China-stub	Template:China-stub
模板:Cmbox	Template:Cmbox
模板:CSS IPA vowel chart	Template:IPA母音表
模板:PAN	Template:PAN
模板:SOM	Template:SOM
模板:SWZ	Template:SWZ
模板:Infobox Spacecraft	Template:宇宙機
模板:PAK	Template:PAK
模板:User nds-1	Template:User nds-1
模板:S-before	Template:S-bef
分类:日本行政区划	Category:日本の地方区分
模板:Mbox	Template:Mbox
模板:ISL	Template:ISL
模板:Oppose	Template:反対
模板:COL	Template:COL
模板:CCK	Template:CCK
模板:ERI	Template:ERI
模板:Pagetype	Template:Pagetype
模板:GAB	Template:GAB
模板:IRN	Template:IRN
模板:MLI	Template:MLI
模板:JOR	Template:JOR
模板:NPL	Template:NPL
模板:NAM	Template:NAM
模板:CAF	Template:CAF
模板:MKD	Template:MKD
模板:Exchange rate	Template:為替レート
模板:LKA	Template:LKA
模板:MWI	Template:MWI
模板:KAZ	Template:KAZ
模板:OMN	Template:OMN
模板:PER	Template:PER
模板:MOZ	Template:MOZ
模板:SUR	Template:SUR
模板:TRI	Template:TTO
模板:GUY	Template:GUY
模板:ETH	Template:ETH
模板:HKG	Template:HKG
模板:NGA	Template:NGA
模板:PRK	Template:PRK
模板:NIC	Template:NIC
模板:LBR	Template:LBR
模板:TKM	Template:TKM
模板:THA	Template:THA
模板:BFA	Template:BFA
模板:TCD	Template:TCD
模板:PRY	Template:PRY
模板:ECU	Template:ECU
模板:BTN	Template:BTN
模板:MDV	Template:MDV
模板:SLE	Template:SLE
模板:LTU	Template:LTU
模板:SGP	Template:SGP
模板:IND	Template:IND
模板:MAC	Template:MAC
模板:User ar-2	Template:User ar-2
模板:User fr-0	Template:User fr-0
东海气油田问题	東シナ海ガス田問題
日本皇民党	日本皇民党
柏拉图式性愛	プラトニック・セックス
白石安男	白石安男
世界日报 (泰国)	泰國世界日報
分类:User ja-N	Category:User ja-N
分类:用戶名字空間模板	Category:利用者ページ用テンプレート
余眛	余昧
九头鸟	鬼車
模板:CHE	Template:CHE
分类:社会阶层	Category:社会階級
分类:印度电影	Category:インドの映画
钱弘佐	銭弘佐
模板:URL	Template:URL
模板:Hidden end	Template:Hidden end
模板:Disambiguation	Template:Aimai
姑娘	クーニャン
分类:公共交通	Category:公共交通
分类:中东	Category:中東
模板:Select skin	Template:Selectskin
分类:报纸	Category:新聞
分类:运动场	Category:競技場
模板:Para	Template:Para
模板:Fb	Template:Fb
分类:維基百科元模板	Category:メタテンプレート
模板:LAO	Template:LAO
模板:User zh-min-nan-1	Template:User zh-min-nan-1
模板:ARE	Template:ARE
模板:GRC	Template:GRC
模板:PRT	Template:PRT
模板:BGD	Template:BGD
模板:BAR	Template:BRB
模板:User zh-yue-3	Template:User zh-yue-3
模板:AUS	Template:AUS
模板:User zh-yue-1	Template:User zh-yue-1
模板:CZE	Template:CZE
模板:AZE	Template:AZE
模板:Infobox Film	Template:Infobox Film
模板:英文名	Template:Lang-en
分类:语言标示模板	Category:言語学関連のテンプレート
分类:新加坡个机场	Category:シンガポールの空港
模板:Expand language	Template:Expand language
模板:WAD	Template:WAD
分类:內部鏈接模板	Category:内部リンク用テンプレート
模板:KHM	Template:KHM
模板:NLD	Template:NLD
模板:KWT	Template:KWT
江南贡院	江南貢院
模板:Resize	Template:Resize
模板:辅音	Template:子音
模板:VNM	Template:VNM
模板:LIE	Template:LIE
模板:SEN	Template:SEN
模板:NZL	Template:NZL
分类:广州	Category:広州
模板:MMR	Template:MMR
模板:KOR	Template:KOR
分类:各类电影	Category:映画のジャンル
模板:!(	Template:!(
分类:中国外交官	Category:中国の外交官
模板:NATO	Template:NATO
分类:生物	Category:生物
模板:De icon	Template:De icon
模板:SVN	Template:SVN
模板:LBN	Template:LBN
模板:GUF	Template:GUF
模板:GGY	Template:GGY
模板:FRA	Template:FRA
模板:Infobox Biography	Template:Infobox 人物
分类:蒙古	Category:モンゴル国
模板:InterWiki	Template:Wikipedia
分类:泰国个大学	Category:タイの大学
分类:澳大利亚个报纸	Category:オーストラリアの新聞
分类:历年个电影	Category:各年の映画
模板:Dated maintenance category	Template:DMC
模板:Chem-stub	Template:Chem-stub
模板:Thailand-stub	Template:Thailand-stub
模板:Britain-stub	Template:UK-stub
分类:1992年个歌曲	Category:1992年の楽曲
分类:姊妹计划链接模板	Category:インターウィキリンク用テンプレート
模板:User la-1	Template:User la-1
模板:APEC	Template:アジア太平洋経済協力
模板:歐洲行政區劃	Template:ヨーロッパ
分类:模板說明文檔	Category:テンプレート文書
分类:泰语	Category:タイ語
分类:User zh-yue	Category:User zh-yue
分类:User wuu	Category:User zh-wuu
分类:User sk	Category:User sk
分类:User fr	Category:User fr
分类:User ja	Category:User ja
分类:User la	Category:User la
分类:User fr-3	Category:User fr-3
分类:User fr-2	Category:User fr-2
分类:User ja-2	Category:User ja-2
分类:User la-2	Category:User la-2
分类:User wuu-N	Category:User zh-wuu-N
分类:User ko-N	Category:User ko-N
分类:User fr-N	Category:User fr-N
分类:User nl-N	Category:User nl-N
分类:User ru-N	Category:User ru-N
分类:泰国拳击运动员	Category:タイのボクサー
分类:政治经济学	Category:政治経済学
分类:曼谷	Category:バンコクの区
模板:User zh-yue	Template:User zh-yue
分类:文字	Category:文字
分类:Template using ParserFunctions	Category:条件文
分类:岛	Category:島
分类:广平省	Category:クアンビン省
分类:User sk-N	Category:User sk-N
分类:User de	Category:User de
分类:User de-2	Category:User de-2
分类:User de-3	Category:User de-3
分类:User de-4	Category:User de-4
分类:User de-N	Category:User de-N
分类:User en-3	Category:User en-3
分类:User en-N	Category:User en-N
分类:User es	Category:User es
分类:User es-1	Category:User es-1
分类:User es-2	Category:User es-2
分类:User es-N	Category:User es-N
分类:首尔	Category:ソウル特別市
分类:日本模板	Category:日本関連のテンプレート
模板:User la-3	Template:User la-3
分类:阿德来得	Category:アデレード
分类:法国个公园	Category:フランスの公園
分类:各国个公园	Category:各国の公園
分类:各国个政治	Category:各国の政治
模板:上海行政区划	Template:上海市の行政区画
模板:Multiple image	Template:Multiple image
模板:Colorsample	Template:Color sample
分类:User it	Category:User it
分类:User it-1	Category:User it-1
分类:User ja-1	Category:User ja-1
分类:User ko	Category:User ko
分类:美国州	Category:アメリカ合衆国の州
分类:User ksh	Category:User ksh
分类:User la-1	Category:User la-1
分类:User la-3	Category:User la-3
分类:澳大利亚地理	Category:オーストラリアの地理
感谢倷	サンキュー
分类:火山	Category:火山
模板:NOR	Template:NOR
模板:Translation WIP	Template:翻訳中途
模板:He icon	Template:He icon
分类:天气	Category:気象
模板:Information	Template:Information
分类:日本个县	Category:日本の都道府県
分类:法国城市	Category:フランスの都市
模板:BRA	Template:BRA
分类:User ru-1	Category:User ru-1
Wikipedia:巴别	Wikipedia:バベル
模板:Humor	Template:ユーモア
分类:残疾人	Category:障害を持つ人物
分类:北京人	Category:北京出身の人物
分类:化学小作品	Category:化学関連のスタブ項目
分类:各国个军事	Category:各国の軍事
模板:TUN	Template:TUN
分类:日本地方	Category:日本の地域
分类:海	Category:海
地方政府	地方公共団体
分类:李氏朝鲜君主	Category:朝鮮国王
分类:泰国模板	Category:タイ関連のテンプレート
分类:工具书	Category:参考文献
分类:计算机科学	Category:計算機科学
分类:User nds	Category:User nds
分类:User nds-1	Category:User nds-1
模板:LUX	Template:LUX
模板:Red	Template:Red-text
分类:神奈川县	Category:神奈川県
分类:福岛县	Category:福島県
分类:广东省	Category:広東省
分类:安徽	Category:安徽省
分类:江西省	Category:江西省
分类:江苏省	Category:江蘇省
分类:经济	Category:経済
模板:Title without disambig	Template:Title without disambig
分类:行政区划	Category:行政区画の単位
分类:饮料	Category:飲料
分类:1980年代出生	Category:1980年代生
分类:社会科学	Category:社会科学
分类:办拉路斯	Category:ベラルーシ
分类:苏州人	Category:蘇州出身の人物
分类:中国电影	Category:中国映画
分类:澳大利亚教育	Category:オーストラリアの教育
分类:非洲国家	Category:アフリカの国
分类:各国教育	Category:各国の教育
模板:(((	Template:(((
模板:)!	Template:)!
模板:)))	Template:)))
模板:User ru-2	Template:User ru-2
分类:科幻片	Category:SF映画
模板:Column-width	Template:Column-width
分类:User ru	Category:User ru
分类:User ru-2	Category:User ru-2
分类:User ru-4	Category:User ru-4
分类:用戶軟重定向	Category:利用者ページのソフトリダイレクト
分类:User zh-yue-1	Category:User zh-yue-1
分类:User zh-yue-3	Category:User zh-yue-3
分类:User zh-yue-N	Category:User zh-yue-N
模板:En icon	Template:En icon
分类:浙江省	Category:浙江省
分类:金球奖获得者	Category:ゴールデングローブ賞受賞者
模板:!((	Template:!((
模板:))!	Template:))!
分类:港铁车站	Category:香港MTRの駅
模板:Lang	Template:Lang
分类:泰国电影	Category:タイの映画作品
分类:社会学	Category:社会学
模板:IRL	Template:IRL
分类:1981年出生	Category:1981年生
分类:1986年出生	Category:1986年生
模板:ALB	Template:ALB
模板:AND	Template:AND
模板:ARG	Template:ARG
模板:ARM	Template:ARM
模板:Africa-stub	Template:Africa-stub
模板:CopyrightByWikimedia	Template:Copyright by Wikimedia
分类:美国慈善家	Category:アメリカ合衆国の慈善家
分类:各国个电影	Category:各国の映画
Wikipedia:Template sandbox and test cases	Wikipedia:テンプレートのサンドボックスとテストケース
分类:人类	Category:人間
分类:分類名字空間模板	Category:カテゴリページ用テンプレート
模板:Australia-stub	Template:AU-stub
模板:Car-stub	Template:Car-stub
模板:Auxiliary template common notice	Template:Auxiliary template common notice
模板:BDI	Template:BDI
模板:BAH	Template:BHS
模板:BLR	Template:BLR
模板:When on basepage	Template:Basepage subpage
模板:Bhutan stub	Template:Bhutan-stub
分类:棋类	Category:抽象戦略ゲーム
模板:CIV	Template:CIV
模板:CRI	Template:CRI
模板:CHY	Template:CYP
分类:泰国交通	Category:タイの交通
模板:Fr	Template:Fr icon
模板:Ko icon	Template:Ko icon
分类:法国铁路	Category:フランスの鉄道
分类:維基百科軟重定向	Category:ソフトリダイレクト
分类:1951年个电影	Category:1951年の映画
烂柯山	爛柯
模板:物理学粒子	Template:粒子の一覧
分类:佛罗里达州	Category:フロリダ州
分类:上海个区	Category:上海市の行政区画
模板:EST	Template:EST
分类:泰国政党	Category:タイの政党
Wikipedia:Lua	Wikipedia:Lua
分类:大規模殺傷性武器	Category:大量破壊兵器
模板:QAT	Template:QAT
模板:RUS	Template:RUS
模板:AUT	Template:AUT
模板:History-stub	Template:History-stub
太平轮	太平輪沈没事故
分类:2005年个歌曲	Category:2005年の楽曲
分类:动作片	Category:アクション映画
模板:CHL	Template:CHL
模板:Round8	Template:Round8
模板:SYR	Template:SYR
模板:CHN	Template:CHN
模板:Switzerland-stub	Template:CH-stub
模板:Side box	Template:Side box
分类:世界人口	Category:各国の人口統計
分类:所有页面需要清理	Category:整理が必要な項目
模板:IRQ	Template:IRQ
模板:字单3	Template:Chset-cell3
模板:字色阿	Template:Chset-color-alpha
模板:字色数	Template:Chset-color-digit
模板:字色标	Template:Chset-color-punct
模板:字色朆	Template:Chset-color-undef
模板:字左	Template:Chset-left
模板:Citation/core	Template:Citation/core
分类:法国交通	Category:フランスの交通
分类:各国经济	Category:各国の経済
分类:各国个报纸	Category:各国の新聞
分类:各国个银行	Category:各国の銀行
分类:各国个地震	Category:各国の地震
分类:韩国政治	Category:韓国の政治
分类:澳大利亚个政治	Category:オーストラリアの政治
分类:泰国政治	Category:タイの政治
分类:越南经济	Category:ベトナムの経済
分类:朝鲜民主主义人民共和国政治	Category:朝鮮民主主義人民共和国の政治
分类:泰国经济	Category:タイの経済
模板:Infobox Language/family-color	Template:Infobox Language/family-color
分类:澳大利亚体育运动	Category:オーストラリアのスポーツ
分类:泰国体育	Category:タイのスポーツ
分类:澳大利亚足球	Category:オーストラリアのサッカー
分类:河	Category:河川
模板:User ko	Template:User ko
模板:User la-2	Template:User la-2
模板:User ru-1	Template:User ru-1
模板:User zh-1	Template:User zh-1
模板:User zh-2	Template:User zh-2
模板:User zh-3	Template:User zh-3
模板:User zh-4	Template:User zh-4
分类:韩国交通	Category:韓国の交通
分类:中国交通	Category:中国の交通
分类:世界各国个博物馆	Category:各国の博物館
分类:马来西亚经济	Category:マレーシアの経済
分类:泰国军事	Category:タイの軍事
分类:菲律宾模板	Category:フィリピン関連のテンプレート
模板:Multi-listen end	Template:Multi-listen end
分类:澳大利亚个交通	Category:オーストラリアの交通
分类:蘇聯政治家	Category:ソビエト連邦の政治家
分类:日本教育	Category:日本の教育
分类:泰国教育	Category:タイの教育
分类:韩国人	Category:韓国の人物
分类:台湾人	Category:台湾の人物
Wikipedia:Picture of the day	Wikipedia:今日の一枚
分类:菲律宾	Category:フィリピン
分类:各行业澳大利亚人	Category:オーストラリアの人物 (職業別)
分类:马来西亚歌手	Category:マレーシアの歌手
分类:泰国歌星	Category:タイの歌手
分类:User nl	Category:User nl
分类:User zh-1	Category:User zh-1
分类:User zh-4	Category:User zh-4
分类:User zh-3	Category:User zh-3
分类:User zh-2	Category:User zh-2
分类:泰国国王	Category:タイの君主
分类:力学	Category:力学
分类:节气	Category:節気
分类:不丹	Category:ブータン
分类:澳大利亚跳水运动员	Category:オーストラリアの飛込競技選手
分类:印度模特	Category:インドのモデル
分类:印度科学技术	Category:インドの科学技術
分类:泰国旅游	Category:タイの観光
分类:中国演员	Category:中国の俳優
分类:泰国演员	Category:タイの俳優
分类:澳大利亚游泳运动员	Category:オーストラリアの競泳選手
分类:电视	Category:テレビ
分类:中国诗人	Category:中国の詩人
分类:凯撒奖获得者	Category:セザール賞受賞者
分类:世紀	Category:世紀
分类:印度演员	Category:インドの俳優
分类:中国田径运动员	Category:中国の陸上競技選手
分类:澳大利亚脚踏车运动员	Category:オーストラリアの自転車選手
分类:泰国运动员	Category:タイのスポーツ選手
分类:中国运动员	Category:中国のスポーツ選手
分类:泰国府	Category:タイの県
分类:海滩	Category:砂浜
分类:泰国个海滩	Category:タイの砂浜
分类:柬埔寨人	Category:カンボジアの人物
分类:泰国政治人物	Category:タイの政治家
分类:香港人	Category:香港の人物
分类:泰国人	Category:タイの人物
分类:泰国华人	Category:中国系タイ人
分类:曼谷街道	Category:バンコクの道路
分类:泰国个公路	Category:タイの道路
分类:东海	Category:東シナ海
分类:意大利个湖	Category:イタリアの湖
分类:光学仪器	Category:光学機器
分类:机场	Category:空港
分类:泰国机场	Category:タイの空港
分类:日本个机场	Category:日本の空港
分类:泰国个银行	Category:タイの銀行
分类:化学元素	Category:元素
分类:澳大利亚运动员	Category:オーストラリアのスポーツ選手
分类:香港演员	Category:香港の俳優
分类:环球小姐	Category:ミス・ユニバース
分类:澳大利亚总理	Category:オーストラリアの首相
分类:泰国总理	Category:タイの首相
分类:地理小作品	Category:世界地理関連のスタブ項目
分类:饮食小作品	Category:食文化関連のスタブ項目
分类:朝鲜	Category:朝鮮民主主義人民共和国
分类:柬埔寨	Category:カンボジア
分类:澳大利亚人	Category:オーストラリアの人物
分类:中国人	Category:中国の人物
分类:台湾歌手	Category:台湾の歌手
分类:韩国演员	Category:韓国の俳優
分类:中国历史	Category:中国の歴史
分类:不丹国王	Category:ブータンの君主
分类:老挝	Category:ラオス
分类:缅甸	Category:ミャンマー
分类:台湾	Category:台湾
分类:法国演员	Category:フランスの俳優
分类:電影模板	Category:映画のテンプレート
分类:爱尔兰模板	Category:アイルランド関連のテンプレート
分类:伊朗模板	Category:イラン関連のテンプレート
分类:英国模板	Category:イギリス関連のテンプレート
分类:美国模板	Category:アメリカ合衆国関連のテンプレート
分类:中国古代朝代	Category:中国の王朝
分类:多語言支援模板	Category:多言語支援テンプレート
分类:新加坡模板	Category:シンガポール関連のテンプレート
分类:法国模板	Category:フランス関連のテンプレート
分类:越南模板	Category:ベトナム関連のテンプレート
分类:加拿大模板	Category:カナダ関連のテンプレート
分类:马来西亚模板	Category:マレーシア関連のテンプレート
分类:精密模板	Category:複雑なテンプレート
分类:維基百科工具模板	Category:ユーティリティテンプレート
分类:模板名字空間模板	Category:テンプレート用テンプレート
分类:香港模板	Category:香港関連のテンプレート
分类:泰国个公司	Category:タイの企業
分类:马来西亚公司	Category:マレーシアの企業
分类:常州人	Category:常州出身の人物
分类:陕西人	Category:陝西省出身の人物
分类:安徽人	Category:安徽省出身の人物
分类:云南人	Category:雲南省出身の人物
分类:江苏人	Category:江蘇省出身の人物
分类:浙江人	Category:浙江省出身の人物
分类:上海人	Category:上海出身の人物
分类:出生	Category:生年
分类:朝鮮人	Category:朝鮮時代の人物
分类:法国总统	Category:フランスの大統領
分类:亚洲历史	Category:アジア史
分类:约旦	Category:ヨルダン
分类:大洋洲国家	Category:オセアニアの国
分类:鱼类	Category:魚類
分类:北京	Category:北京
分类:国家足球队	Category:サッカーのナショナルチーム
分类:泰国灾难	Category:タイの災害
分类:日本关东地方	Category:関東地方
分类:剧情片	Category:ドラマ映画
分类:1971年个电影	Category:1971年の映画
分类:2003年个电影	Category:2003年の映画
分类:1994年个电影	Category:1994年の映画
分类:2004年个电影	Category:2004年の映画
分类:2005年个电影	Category:2005年の映画
分类:2007年个电影	Category:2007年の映画
分类:2008年个电影	Category:2008年の映画
分类:香港电影	Category:香港の映画
分类:法国电影	Category:フランスの映画
分类:公用领域媒体	Category:パブリックドメイン画像
分类:阿拉伯语	Category:アラビア語
分类:印度言话	Category:インドの言語
分类:東南亚言话	Category:東南アジアの言語
分类:人类学	Category:人類学
分类:抗生素	Category:抗生物質
分类:五代十国	Category:五代十国
分类:操作系统	Category:オペレーティングシステム
分类:昆士兰州	Category:クイーンズランド州
分类:泰国政府	Category:タイの行政
分类:维克多利亚州	Category:ビクトリア州
分类:电影奖	Category:映画の賞
分类:奥斯卡金像奖	Category:アカデミー賞
分类:金球奖	Category:ゴールデングローブ賞
分类:清朝	Category:清朝
分类:宋朝	Category:宋朝
分类:明朝	Category:明朝
分类:汉朝	Category:漢朝
分类:里昂	Category:リヨン
模板:Incubator	Template:Incubator
分类:中国文化	Category:中国の文化
分类:法国文化	Category:フランスの文化
分类:越南文化	Category:ベトナムの文化
分类:韩国文化	Category:韓国の文化
分类:维基百科指南	Category:ウィキペディアの手引き書
分类:電子工程	Category:電子工学
分类:网络语言	Category:インターネットスラング
模板:ESP	Template:ESP
分类:动物	Category:動物
分类:泰国航空公司	Category:タイの航空会社
分类:製造品	Category:製品
分类:泰国政府部门	Category:タイの中央省庁
分类:国际象棋	Category:チェス
分类:武器	Category:武器
分类:核武器	Category:核兵器
分类:马来西亚个银行	Category:マレーシアの銀行
瀑瑶兰	ボジョレー
分类:物理量	Category:物理量
Wikipedia:Soft redirect	Help:ソフトリダイレクト
分类:温标	Category:温度の単位
模板:元素色例	Template:周期表/周期別 凡例
分类:汉字	Category:漢字
分类:热力学	Category:熱力学
分类:气象学	Category:気象学
分类:泰国个公园	Category:タイの公園
分类:航空事故	Category:航空事故
分类:香港	Category:香港
分类:菲律宾群岛	Category:フィリピンの島
分类:大西洋岛屿	Category:大西洋の島
分类:上海	Category:上海
分类:节日	Category:祭
分类:印度城市	Category:インドの都市
分类:俄罗斯城市	Category:ロシアの都市
分类:Web 2.0	Category:Web 2.0
分类:事体	Category:事件
分类:西亚	Category:西アジア
分类:電信	Category:電気通信
分类:流感病毒	Category:インフルエンザ
分类:交通	Category:交通
分类:选美	Category:美人コンテスト
分类:性行为	Category:性行為
分类:北美洲	Category:北アメリカ
分类:歌手	Category:歌手
分类:亚洲个湖泊	Category:アジアの湖
分类:欧洲个湖泊	Category:ヨーロッパの湖
分类:湖泊	Category:湖
分类:大韩民国机场	Category:韓国の空港
分类:围棋棋手	Category:囲碁棋士
模板:Infobox Language	Template:Infobox Language
分类:大洋洲	Category:オセアニア
分类:中国城市	Category:中華人民共和国の都市
分类:瀑布	Category:滝
分类:自然灾害	Category:自然災害
分类:日本九州	Category:九州地方
分类:1998年个电影	Category:1998年の映画
分类:2006年个电影	Category:2006年の映画
分类:恐怖片	Category:ホラー映画
分类:美国电影	Category:アメリカ合衆国の映画
分类:汉语	Category:中国語
分类:泰国言话	Category:タイの言語
分类:新南威尔士州	Category:ニューサウスウェールズ州
年三十夜	大晦日
分类:澳大利亚文化	Category:オーストラリアの文化
分类:泰国文化	Category:タイの文化
分类:越南城市	Category:ベトナムの都市
分类:澳大利亚城市	Category:オーストラリアの都市
分类:泰国城市	Category:タイの都市
分类:泰国个岛	Category:タイの島
分类:印度文化	Category:インドの文化
分类:印度尼西亚个岛	Category:インドネシアの島
分类:澳大利亚旅游	Category:オーストラリアの観光
模块:URL	モジュール:URL
分类:中国个公园	Category:中国の公園
分类:无锡	Category:無錫
分类:银行	Category:銀行
分类:霍巴特	Category:ホバート
Wikipedia:模板文檔	Help:テンプレートの説明文
安藤沙耶香	安藤沙耶香
分类:中华人民共和国	Category:中華人民共和国
分类:维基百科媒体文件版权	Category:著作権の状態別の画像
分类:南欧	Category:南欧
分类:維基百科名字空間模板	Category:名前空間別のテンプレート
分类:澳大利亚运动场	Category:オーストラリアの競技場
模板:FULLROOTPAGENAME	Template:FULLROOTPAGENAME
东京	東京
模板:Incorrect namespace	Template:Incorrect namespace
模板:Single namespace	Template:Single namespace
分类:学堂	Category:学校
分类:澳大利亚风光	Category:オーストラリアの観光地
分类:越南航空	Category:ベトナムの航空会社
分类:中国地铁	Category:中華人民共和国の地下鉄
模板:Geo stub	Template:World-stub
模板:UGA	Template:UGA
模板:UZB	Template:UZB
模板:Comment	Template:コメント
模板:解剖学治疗学及化学分类系统	Template:Major drug groups
分类:香港交通	Category:香港の交通
中国	チャイナ
Portal:数学	Portal:数学
分类:纪元	Category:紀年法
模板:Greece-stub	Template:Greece-stub
厕所	便所
分类:吴越国	Category:呉越
分类:User wuu-3	Category:User zh-wuu-3
分类:朝鲜国家元首	Category:朝鮮民主主義人民共和国の国家元首
方腊起义	方臘の乱
分类:亚洲国家	Category:アジアの国
韻鏡	韻鏡
周庄镇	周荘鎮 (曖昧さ回避)
模板:Mexico-stub	Template:Mexico-stub
模板:Zh-hans icon	Template:Zh-smpl icon
模板:User zh-yue-2	Template:User zh-yue-2
分类:維基百科幽默	Category:ウィキペディアにおけるユーモア
模板:RWA	Template:RWA
模板:MLT	Template:MLT
模板:KEN	Template:KEN
模板:JAM	Template:JAM
模板:CXR	Template:CXR
分类:1976年个地震	Category:1976年の地震
模板:Sister project	Template:Sister
分类:清理模板	Category:修正テンプレート
分类:事故	Category:事故
海南	海南
分类:香港机场	Category:香港の空港
分类:User wuu-2	Category:User zh-wuu-2
分类:User wuu-1	Category:User zh-wuu-1
分类:香港个地方	Category:香港の地域
模板:No redirect	Template:非転送
分类:澳大利亚模板	Category:オーストラリア関連のテンプレート
分类:澳大利亚华人	Category:中国系オーストラリア人
分类:AutoWikiBrowser	Category:AutoWikiBrowser
分类:大桥	Category:橋
分类:布里司班	Category:ブリスベン
分类:柬埔寨个歌手	Category:カンボジアの歌手
分类:戏曲	Category:戯曲 (中国)
分类:地震	Category:地震
分类:中国地震	Category:中国の地震
分类:香港教育	Category:香港の教育
分类:环境	Category:環境
分类:凯撒奖	Category:セザール賞
分类:泰国个节日	Category:タイの祭
分类:维基媒体基金会版权	Category:ウィキメディア財団が著作権を持つ画像
模板:IAST	Template:IAST
分类:中国水灾	Category:中国の洪水
模块:Sidebar	モジュール:Sidebar
分类:杭州	Category:杭州
分类:香港文化	Category:香港の文化
分类:日本本州	Category:本州
分类:澳大利亚赛马	Category:オーストラリアの競馬
分类:新竹市	Category:新竹市
分类:印度小作品	Category:インド関連のスタブ項目
分类:爱尔兰	Category:アイルランド島
模板:India-stub	Template:India-stub
分类:苏州	Category:蘇州
分类:中华民国	Category:中華民国
模板:Listen	Template:試聴
分类:香港个街道	Category:香港の道路
分类:泰国报纸	Category:タイの新聞
分类:香港中学	Category:香港の中学校
分类:性学	Category:性の研究
模板:MNG	Template:MNG
分类:无锡人	Category:無錫出身の人物
分类:澳大利亚足球场	Category:オーストラリアのサッカー競技施設
分类:相态	Category:物質の相
分类:南澳大利亚州	Category:南オーストラリア州
模板:BEL	Template:BEL
分类:韩国模板	Category:韓国関連のテンプレート
分类:广东人	Category:広東省出身の人物
分类:东南亚国家联盟	Category:東南アジア諸国連合
分类:墨尔本	Category:メルボルン
分类:方向	Category:方向
分类:勒翻译个文章	Category:翻訳中途
分类:電話號碼	Category:電話番号
分类:電話	Category:電話
分类:温度	Category:温度
分类:上海交通	Category:上海の交通
分类:悉尼	Category:シドニー
分类:朝鲜模板	Category:北朝鮮関連のテンプレート
分类:热带气旋	Category:熱帯低気圧
分类:澳大利亚个公园	Category:オーストラリアの公園
分类:应用科学	Category:応用科学
分类:字典	Category:字書
分类:泰国个商场	Category:タイのショッピングセンター
分类:法国个报纸	Category:フランスの新聞
模板:Image label begin	Template:Image label begin
分类:澳大利亚大学	Category:オーストラリアの大学
分类:中国个银行	Category:中国の銀行
分类:中国个报纸	Category:中国の新聞
分类:高分子化学	Category:高分子化学
分类:日本大学	Category:日本の大学
杉原杏璃	杉原杏璃
分类:宁波	Category:寧波
甲型流感病毒H7N9亚型	H7N9亜型
模板:Babels	Template:Babels
分类:天津	Category:天津
分类:巴黎交通	Category:パリの交通
分类:非洲国家模板	Category:アフリカ関連のテンプレート
模板:HUN	Template:HUN
模板:Ns has subpages	Template:Ns has subpages
分类:生活	Category:生活
模板:Infobox Language/statesregion	Template:Infobox Language/statesregion
分类:90年代个歌曲	Category:1990年代の楽曲
分类:User zh-hu	Category:User zh-hu
分类:User zh-hu-1	Category:User zh-hu-1
分类:User zh-hu-3	Category:User zh-hu-3
分类:User zh-hu-N	Category:User zh-hu-N
分类:女性	Category:女性
分类:柬埔寨文化	Category:カンボジアの文化
模板:Infobox Language/rank	Template:Infobox Language/rank
模板:Infobox Language/IPA notice	Template:Infobox Language/IPA notice
分类:各年个地震	Category:各年の地震
分类:User en-1	Category:User en-1
分类:User de-1	Category:User de-1
分类:User wuu-0	Template:User zh-wuu-0
分类:亚洲个台风	Category:アジアの熱帯低気圧
分类:法国省份	Category:フランスの県
分类:工具	Category:道具
分类:德国城市	Category:ドイツの主要都市
分类:美国演员	Category:アメリカ合衆国の俳優
模板:France-stub	Template:France-stub
分类:瑞典贵族	Category:スウェーデンの貴族
分类:电影人	Category:映画関連の人物
分类:人物模板	Category:人物の一覧テンプレート
分类:古巴拳击运动员	Category:キューバのボクサー
模板:Infobox Language/official	Template:Infobox Language/official
模板:Asbox	Template:Asbox
模板:Lua	Template:Lua
Wikipedia:弗要犯常见个错误	Wikipedia:ウィキペディアでやってはいけないこと
Wikipedia:How to read a taxobox	Wikipedia:生物分類表の見方
Wikipedia:Media help	Help:音声・動画の再生
模块:Error	モジュール:Error
模板:Italy-stub	Template:Italia-stub
模板:OIC	Template:OIC
模板:Testcases notice	Template:Template test cases notice
刘宗周	劉宗周
模板:Start date	Template:Start date
姜義錫	カン・イソク
两浙路	両浙路
模板:希臘字母	Template:ギリシャ文字
刘牢之	劉牢之
琉球群岛	琉球諸島
模板:Bio-stub	Template:People-stub
模板:User wuu	Template:User zh-wuu
模板:Indonesia stub	Template:Indonesia-stub
模板:港铁路线及服务	Template:香港MTR
模板:Infobox Thailand province	Template:Infobox Thai Province
模板:Malaysia-stub	Template:Malaysia-stub
模板:Wayback	Template:Wayback
模板:Larger	Template:Larger
模板:Philippines-stub	Template:Philippines-stub
徐阶	徐階
模板:海南省行政区划	Template:海南省の行政区画
朱舜水	朱舜水
松江府	松江府
水 (消歧义)	水 (曖昧さ回避)
沈德潜	沈徳潜
沛郡	沛郡
Wikipedia:VisualEditor	Wikipedia:ビジュアルエディター
模板:Infobox Language/terminological	Template:Infobox Language/terminological
勾吴	句呉
文玉珠	文玉珠
池田夏希	池田夏希
模板:SUBJECTSPACE formatted	Template:SUBJECTSPACE ja ex
胡雪岩	胡雪巌
陶成章	陶成章
饭岛恋	飯島恋
高崎圣子	高崎聖子
於之莹	於之瑩
模板:Tlg	Template:Tlg
模板:扩充	Template:加筆
模板:IPA notice	Template:IPA notice
模板:Contains special characters	Template:特殊文字
模板:Spoken Wikipedia boilerplate	Template:Spoken Wikipedia boilerplate
Wikipedia:CC-BY-SA-3.0协议文本	Wikipedia:Text of Creative Commons Attribution-ShareAlike 3.0 Unported License
模板:Multi-listen item	Template:Multi-listen item
模板:Documentation/template page	Template:Documentation/template page
曼谷枪手 2	バンコック・デンジャラス
模板:User zh-yue-0	Template:User zh-yue-0
模块:StringReplace	モジュール:StringReplace
模板:Vtext	Template:Vtext
元宵	小正月
模板:Markup	Template:Markup
模板:Unihan	Template:Unihan
模板:Infobox Language/genetic2	Template:Infobox Language/genetic
模板:Sinaweibo	Template:Weibo
模板:Vietnam stub	Template:Vietnam-stub
模块:Documentation	モジュール:Documentation
模板:No documentation	Template:No documentation
模板:User wuu-1	Template:User zh-wuu-1
模板:Brackets	Template:Brackets
模板:HKG stub	Template:Hongkong-stub
白坦群岛 (菲律宾)	バタン諸島
模板:Alphabet fr	Template:フランス語アルファベット
模板:TemplateDataHeader	Template:TemplateDataHeader
国王	国王
模块:Yesno	モジュール:Yesno
模块:Message box	モジュール:Message box
模块:Category handler	モジュール:Category handler
模块:Message box/configuration	モジュール:Message box/configuration
惡病質	悪液質
模块:Unsubst	モジュール:Unsubst
模块:Arguments	モジュール:Arguments
特殊:最近更改	特別:最近の更新
模块:TableTools	モジュール:TableTools
模块:List	モジュール:List
模块:Namespace detect	モジュール:Namespace detect
模块:Bananas	モジュール:Bananas
模块:HtmlBuilder	モジュール:HtmlBuilder
模块:String	モジュール:String
模块:InfoboxImage	モジュール:InfoboxImage
模块:Navbar	モジュール:Navbar
模块:Navbox	モジュール:Navbox
模块:Infobox	モジュール:Infobox
模板:Personal announcement	Template:Personal announcement
寶山區	宝山区
Wikipedia:VisualEditor/TemplateData	Wikipedia:ビジュアルエディター/TemplateData
模块:Namespace detect/data	モジュール:Namespace detect/data
模块:Namespace detect/config	モジュール:Namespace detect/config
模板:95%	Template:95%
模板:Aligned table	Template:Aligned table
模块:Aligned table	モジュール:Aligned table
模块:No globals	モジュール:No globals
模块:Listen	モジュール:Listen
模块:Side box	モジュール:Side box
模块:File link	モジュール:File link
模块:Lua banner	モジュール:Lua banner
妓女	娼婦
馬來西亞航空17號班機空难	マレーシア航空17便撃墜事件
黃大仙祠 (廣州)	黄大仙祠 (広州)
黃大仙祠	黄大仙祠
模板:User wikEd	Template:User wikEd
雨傘運動	2014年香港反政府デモ
模板:IPA fonts	Template:IPA fonts
飞行员	パイロット (航空)
